ord,statn,state,county,demv00,repv00,totv00,demsh00,repsh00,demv16,repv16,totv16,demsh16,repsh16,demv20,repv20,totv20,demsh20,repsh20,rep2sh00,rep2sh16,rep2sh20,tot2pty00,tot2pty16,tot2pty20
2,1,ALABAMA,AUTAUGA,4942,11993,17208,28.71920037192%,69.6943282194328%,5936,18172,24973,23.7696712449445%,72.7665879149482%,7503,19838,27770,27.0183651422398%,71.4368023046453%,0.708178328904635,0.753774680603949,0.725576972312644,16935,24108,27341
3,1,ALABAMA,BALDWIN,13997,40872,56480,24.782223796034%,72.3654390934844%,18458,72883,95215,19.3856010082445%,76.5457123352413%,24578,83544,109679,22.409029987509%,76.1713728243328%,0.744901492646121,0.797922072234812,0.77268271027173,54869,91341,108122
4,1,ALABAMA,BARBOUR,5188,5096,10395,49.9086099086099%,49.023569023569%,4871,5454,10469,46.5278441111854%,52.0966663482663%,4816,5622,10518,45.7881726563986%,53.4512264689104%,0.495527032283158,0.528232445520581,0.538608928913585,10284,10325,10438
5,1,ALABAMA,BIBB,2710,4273,7101,38.1636389240952%,60.174623292494%,1874,6738,8819,21.2495747817213%,76.4032203197642%,1986,7525,9595,20.6982803543512%,78.4262636789995%,0.611914649863955,0.782396655829076,0.791189149405951,6983,8612,9511
6,1,ALABAMA,BLOUNT,4977,12667,17973,27.6915373059589%,70.4779391309186%,2156,22859,25588,8.42582460528373%,89.3348444583399%,2640,24711,27588,9.56937799043062%,89.5715528490648%,0.717921106325096,0.913811712972217,0.903477020949874,17644,25015,27351
7,1,ALABAMA,BULLOCK,3395,1433,4904,69.2292006525286%,29.221044045677%,3530,1140,4710,74.9469214437367%,24.203821656051%,3446,1146,4613,74.7019293301539%,24.8428354649902%,0.296810273405137,0.244111349036403,0.249564459930314,4828,4670,4592
8,1,ALABAMA,BUTLER,3606,4127,7803,46.2129950019223%,52.8899141355889%,3726,4901,8732,42.6706367384334%,56.1268896014659%,3965,5458,9488,41.789629005059%,57.5252951096121%,0.533686796844692,0.568100150689695,0.579221054865754,7733,8627,9423
9,1,ALABAMA,CALHOUN,15781,22306,38909,40.5587396232234%,57.3286386183145%,13242,32865,47864,27.6658866789236%,68.6632960053485%,15216,35101,50983,29.8452425318243%,68.8484396759704%,0.585659148790926,0.712798490467825,0.69759723353936,38087,46107,50317
10,1,ALABAMA,CHAMBERS,5616,6037,11834,47.4564813249958%,51.0140273787392%,5784,7843,13900,41.6115107913669%,56.4244604316547%,6365,8753,15284,41.6448573671814%,57.2690395184507%,0.518064017849481,0.575548543333089,0.578978700886361,11653,13627,15118
11,1,ALABAMA,CHEROKEE,3497,4154,7823,44.7015211555669%,53.0998338233414%,1547,8953,10733,14.4134911022081%,83.4156340259014%,1624,10583,12301,13.2021786846598%,86.0336558003414%,0.542935563978565,0.852666666666667,0.866961579421643,7651,10500,12207
12,1,ALABAMA,CHILTON,4806,10066,15092,31.8446859263186%,66.6975881261596%,2911,15081,18369,15.8473515161413%,82.1002776416789%,3073,16085,19310,15.9140341791818%,83.2988089073019%,0.67684238838085,0.838205869275233,0.839597035181125,14872,17992,19158
13,1,ALABAMA,CHOCTAW,3707,3600,7374,50.2712232167074%,48.820179007323%,3109,4106,7292,42.6357652221613%,56.3082830499177%,3127,4296,7464,41.8944265809218%,57.556270096463%,0.492678253729301,0.569092169092169,0.578741748619157,7307,7215,7423
14,1,ALABAMA,CLARKE,4679,5988,10752,43.5174851190476%,55.6919642857143%,5749,7140,13031,44.1178727649451%,54.7924180799632%,5755,7324,13135,43.8142367719833%,55.7594213932242%,0.561357457579451,0.553960741717744,0.55998164997324,10667,12889,13079
15,1,ALABAMA,CLAY,2045,3719,5883,34.7611762706102%,63.2160462349142%,1237,5245,6624,18.6745169082126%,79.1817632850241%,1267,5601,6930,18.2828282828283%,80.8225108225108%,0.645211658570437,0.809163838321506,0.815521258008154,5764,6482,6868
16,1,ALABAMA,CLEBURNE,1664,3333,5092,32.6787117046347%,65.4556166535742%,684,5764,6593,10.3746397694525%,87.4260579402396%,675,6484,7227,9.33997509339975%,89.7191088971911%,0.667000200120072,0.893920595533499,0.90571308842017,4997,6448,7159
17,1,ALABAMA,COFFEE,5220,9938,15434,33.8214331994298%,64.3903071141635%,4221,15875,20767,20.3255164443588%,76.4433957721385%,5076,16899,22275,22.7878787878788%,75.8653198653199%,0.655627391476448,0.789958200636943,0.76901023890785,15158,20096,21975
18,1,ALABAMA,COLBERT,10543,10518,21532,48.9643321567899%,48.8482258963403%,7312,16746,24915,29.3477824603652%,67.212522576761%,8343,19203,27886,29.9182385426379%,68.8625116545937%,0.499406485921846,0.696067836062848,0.697124809409715,21061,24058,27546
19,1,ALABAMA,CONECUH,2783,2699,5551,50.1351107908485%,48.6218699333453%,3080,3420,6585,46.7729688686409%,51.9362186788155%,2966,3442,6441,46.0487501940692%,53.4389070020183%,0.492338562568406,0.526153846153846,0.537141073657928,5482,6500,6408
20,1,ALABAMA,COOSA,2104,2382,4567,46.069629954018%,52.1567768776002%,1782,3381,5252,33.9299314546839%,64.3754760091394%,1796,3631,5479,32.7797043256069%,66.2712173754335%,0.530985287561302,0.654851830331203,0.669062096922793,4486,5163,5427
21,1,ALABAMA,COVINGTON,4440,8961,13613,32.615881877617%,65.8267832219202%,2387,13267,15940,14.9749058971142%,83.2308657465496%,2721,14586,17430,15.6110154905336%,83.6833046471601%,0.668681441683456,0.847515012137473,0.842780377881782,13401,15654,17307
22,1,ALABAMA,CRENSHAW,1934,2793,4795,40.3336809176225%,58.2481751824818%,1664,4513,6267,26.5517791606829%,72.0121270145205%,1700,4864,6617,25.6914009369805%,73.5076318573372%,0.590861011212185,0.730613566456209,0.741011578305911,4727,6177,6564
23,1,ALABAMA,CULLMAN,9758,19157,29525,33.0499576629975%,64.8839966130398%,3798,32989,37873,10.028252316954%,87.1042695323846%,4478,36880,41851,10.6998638025376%,88.1221476189338%,0.662528099602283,0.896757006551227,0.891725905508003,28915,36787,41358
24,1,ALABAMA,DALE,4906,10593,15806,31.0388460078451%,67.0188535998988%,4413,13808,18749,23.5372553202837%,73.6465944850392%,5170,14303,19738,26.1931300030398%,72.4642820954504%,0.683463449254791,0.75780692607431,0.734504185282186,15499,18221,19473
25,1,ALABAMA,DALLAS,10967,7360,18464,59.3966637781629%,39.8613518197574%,12836,5789,18792,68.3056619838229%,30.8056619838229%,12230,5524,17864,68.46171070309%,30.922525750112%,0.401593277677743,0.310818791946309,0.31114115128985,18327,18625,17754
26,1,ALABAMA,DEKALB,7056,12827,20285,34.7843233916687%,63.2339166872073%,3622,21405,25826,14.0246263455433%,82.8815921939131%,4281,24767,29356,14.5830494617795%,84.3677612753781%,0.645123975255243,0.855276301594278,0.852623244285321,19883,25027,29048
27,1,ALABAMA,ELMORE,6652,16777,23804,27.9448832129054%,70.4797513023021%,8443,27634,37260,22.6596886741814%,74.1653247450349%,10367,30164,41030,25.2668778942237%,73.5169388252498%,0.716078364420163,0.765972780441833,0.744220473218031,23429,36077,40531
28,1,ALABAMA,ESCAMBIA,4523,6975,11660,38.7907375643225%,59.819897084048%,4605,9935,14845,31.020545638262%,66.9248905355339%,4918,10869,15910,30.9113764927718%,68.3155248271527%,0.606627239519916,0.683287482806052,0.68847786153164,11498,14540,15787
29,1,ALABAMA,ETOWAH,17433,21087,39348,44.3046660567246%,53.5910338517841%,10442,32353,44164,23.6436916945929%,73.2564985055702%,11567,35528,47728,24.2352497485753%,74.4384847468991%,0.547429906542056,0.755999532655684,0.754390062639346,38520,42795,47095
30,1,ALABAMA,FAYETTE,3064,4582,7808,39.2418032786885%,58.6834016393443%,1362,6712,8249,16.5110922536065%,81.3674384773912%,1395,7300,8766,15.9137577002053%,83.2762947752681%,0.599267590897201,0.831310378994303,0.839562967222542,7646,8074,8695
31,1,ALABAMA,FRANKLIN,4793,6119,11103,43.1685130145006%,55.1112311987751%,2197,9466,12040,18.2475083056478%,78.6212624584718%,2086,10376,12578,16.5845126411194%,82.4932421688663%,0.560758797653959,0.811626511189231,0.832611137859092,10912,11663,12462
32,1,ALABAMA,GENEVA,2769,6588,9559,28.9674652160268%,68.9193430275133%,1525,9994,11758,12.9698928389182%,84.997448545671%,1595,10848,12545,12.7142287764049%,86.4726982861698%,0.704071817890349,0.867610035593367,0.871815478582335,9357,11519,12443
33,1,ALABAMA,GREENE,3504,850,4396,79.7088262056415%,19.3357597816197%,4013,838,4880,82.233606557377%,17.172131147541%,3884,875,4775,81.3403141361257%,18.3246073298429%,0.195222783647221,0.172747887033601,0.183862155915108,4354,4851,4759
34,1,ALABAMA,HALE,4652,2984,7731,60.1733281593584%,38.5978528004139%,4775,3173,8040,59.3905472636816%,39.4651741293532%,4663,3192,7900,59.0253164556962%,40.4050632911392%,0.390780513357779,0.399219929542023,0.406365372374284,7636,7948,7855
35,1,ALABAMA,HENRY,2782,4054,6932,40.132717830352%,58.4824004616272%,2292,5632,8072,28.394449950446%,69.7720515361744%,2606,6607,9298,28.0275328027533%,71.0582921058292%,0.593036863662961,0.710752145381121,0.71713882557256,6836,7924,9213
36,1,ALABAMA,HOUSTON,9412,22150,32057,29.3602021399382%,69.0956733318776%,10664,30728,42639,25.0099674007364%,72.0654799596613%,12917,32618,46173,27.9752236155329%,70.6430164814935%,0.701793295735378,0.742365674526478,0.716328099264302,31562,41392,45535
37,1,ALABAMA,JACKSON,9066,8475,17906,50.6310733832235%,47.3305037417625%,3673,16672,20984,17.503812428517%,79.451010293557%,3717,19670,23636,15.7260111694026%,83.2205110847859%,0.483153754061912,0.819464241828459,0.841065549236756,17541,20345,23387
38,1,ALABAMA,JEFFERSON,129889,138491,273763,47.4457833965876%,50.5879172861197%,156873,134768,304191,51.5705592867639%,44.3037433717631%,181688,138843,325848,55.7585131717856%,42.6097444207115%,0.516025784335644,0.462102379295092,0.433165590847687,268380,291641,320531
39,1,ALABAMA,LAMAR,2653,4470,7249,36.5981514691682%,61.663677748655%,1036,5823,6966,14.8722365776629%,83.5917312661499%,978,6174,7193,13.5965522035312%,85.8334491867093%,0.627544573915485,0.848957573990378,0.863255033557047,7123,6859,7152
40,1,ALABAMA,LAUDERDALE,13875,17478,32137,43.1745340262003%,54.3859103214364%,9952,27899,39525,25.1790006325111%,70.5857052498419%,11915,31721,44339,26.8725050181556%,71.541983355511%,0.557458616400344,0.737074317719479,0.726945641213677,31353,37851,43636
41,1,ALABAMA,LAWRENCE,6296,5671,12185,51.6700861715224%,46.540828887977%,3627,10833,14829,24.4588306696338%,73.0528019421404%,3562,12322,16031,22.2194498159815%,76.8635768199114%,0.473886521266817,0.749170124481328,0.775749181566356,11967,14460,15884
42,1,ALABAMA,LEE,14574,22433,38264,38.0880200710851%,58.6269077984529%,21230,34617,59191,35.8669392306263%,58.4835532428917%,27860,42221,71449,38.992848045459%,59.0924995451301%,0.606182614100035,0.619854244632657,0.60246001055921,37007,55847,70081
43,1,ALABAMA,LIMESTONE,8992,14204,23634,38.046881611238%,60.0998561394601%,9468,29067,40294,23.4972948826128%,72.1372909117983%,13672,34640,49235,27.7688636132832%,70.3564537422565%,0.612346956371788,0.754301284546516,0.717006126842192,23196,38535,48312
44,1,ALABAMA,LOWNDES,4557,1638,6243,72.9937530033638%,26.2373858721768%,4883,1751,6684,73.0550568521843%,26.1968880909635%,4972,1836,6835,72.7432333577176%,26.861741038771%,0.264406779661017,0.263943322279168,0.269682726204465,6195,6634,6808
45,1,ALABAMA,MACON,7665,1091,8831,86.7965122862643%,12.3542067716%,7566,1431,9140,82.7789934354486%,15.6564551422319%,7108,1541,8723,81.4857273873667%,17.6659406167603%,0.124600274097762,0.159053017672558,0.178170886807723,8756,8997,8649
46,1,ALABAMA,MADISON,48199,62151,113318,42.534284050195%,54.8465380610318%,62822,89520,163389,38.4493448151344%,54.7894901125535%,87286,102780,194767,44.815600178675%,52.7707465843803%,0.563217036701405,0.587625211694739,0.540759525638462,110350,152342,190066
47,1,ALABAMA,MARENGO,4841,4690,9608,50.3850957535387%,48.8134887593672%,5615,5233,10994,51.0733127160269%,47.5986901946516%,5488,5343,10900,50.348623853211%,49.0183486238532%,0.492078480747036,0.482393067846608,0.493306250577047,9531,10848,10831
48,1,ALABAMA,MARION,4600,6910,11756,39.128955427016%,58.7784960871045%,1432,11274,12984,11.0289587184227%,86.8299445471349%,1463,12205,13807,10.5960744549866%,88.397189831245%,0.600347523892268,0.887297339839446,0.892961662276851,11510,12706,13668
49,1,ALABAMA,MARSHALL,10381,17084,27989,37.0895709028547%,61.0382650326914%,4917,29233,35316,13.9228678219504%,82.7755125155737%,5943,33191,39655,14.9867608120035%,83.6994073887278%,0.622028035681777,0.85601756954612,0.848137169724536,27465,34150,39134
50,1,ALABAMA,MOBILE,58640,78162,139745,41.962145336148%,55.9318759168485%,72186,95116,172737,41.7895413258306%,55.0640569188998%,79474,101243,183164,43.3895306938045%,55.2745080911096%,0.571351296033684,0.568528768335107,0.56022953014935,136802,167302,180717
51,1,ALABAMA,MONROE,3741,5153,8951,41.794212937102%,57.568986705396%,4332,5795,10271,42.1770032129296%,56.4209911401032%,4455,6147,10668,41.7604049493813%,57.6209223847019%,0.5793793568698,0.572232645403377,0.579796264855688,8894,10127,10602
52,1,ALABAMA,MONTGOMERY,40371,38827,80328,50.257693456827%,48.3355741460014%,58916,34003,95878,61.448924675108%,35.4648615949436%,64529,33311,99139,65.0894199053854%,33.6002985706937%,0.490252279097957,0.365942379922298,0.340464022894522,79198,92919,97840
53,1,ALABAMA,MORGAN,16060,25774,42681,37.6279843490078%,60.3875260654624%,11254,37486,50644,22.221783429429%,74.018639917858%,13234,39664,53722,24.634228062991%,73.8319496668032%,0.616101735430511,0.769101354123923,0.749820409089191,41834,48740,52898
54,1,ALABAMA,PERRY,4020,1732,5787,69.4660445826853%,29.9291515465699%,3824,1407,5278,72.4516862447897%,26.657824933687%,3860,1339,5230,73.8049713193117%,25.6022944550669%,0.301112656467316,0.268973427642898,0.25754952875553,5752,5231,5199
55,1,ALABAMA,PICKENS,4143,4306,8540,48.5128805620609%,50.4215456674473%,3972,5456,9542,41.6264933976106%,57.1787885139384%,4022,5594,9668,41.6011584609019%,57.8609846917666%,0.509646111965913,0.578701739499364,0.581738768718802,8449,9428,9616
56,1,ALABAMA,PIKE,4357,6058,10544,41.3220789074355%,57.4544764795144%,5056,7693,13168,38.3961117861482%,58.4219319562576%,5636,8042,13841,40.7196011848855%,58.1027382414565%,0.581661065770523,0.603419876068711,0.587951454891066,10415,12749,13678
57,1,ALABAMA,RANDOLPH,3094,4666,7919,39.0705897209244%,58.921581007703%,2291,7705,10187,22.4894473348385%,75.6356140178659%,2203,8559,10837,20.3285041985789%,78.9794223493587%,0.601288659793814,0.770808323329332,0.795298271696711,7760,9996,10762
58,1,ALABAMA,RUSSELL,8396,6198,14775,56.8257191201354%,41.9492385786802%,9579,9210,19256,49.7455338595762%,47.8292480265891%,11228,9864,21329,52.6419428946505%,46.2468939003235%,0.424695080169933,0.49018042471659,0.467665465579367,14594,18789,21092
59,1,ALABAMA,SHELBY,13183,47651,62128,21.2190960597476%,76.6981071336596%,22977,73020,101254,22.6924368420013%,72.1156695044146%,33268,79700,114950,28.9412788168769%,69.3344932579382%,0.783295525528487,0.760648770274071,0.705509524821188,60834,95997,112968
60,1,ALABAMA,ST. CLAIR,6485,17117,24090,26.9198837691988%,71.0543794105438%,5589,31651,38400,14.5546875%,82.4244791666667%,7744,36166,44441,17.425350464661%,81.3798069350375%,0.725235149563596,0.849919441460795,0.823639262127078,23602,37240,43910
61,1,ALABAMA,SUMTER,4415,1629,6088,72.5197109067017%,26.757555847569%,4746,1581,6411,74.0290126345344%,24.6607393542349%,4648,1598,6291,73.8833253854713%,25.4013670322683%,0.269523494374586,0.249881460407776,0.255843739993596,6044,6327,6246
62,1,ALABAMA,TALLADEGA,11264,13807,25451,44.2575930218852%,54.249341872618%,12121,20614,33407,36.2828149788966%,61.7056305564702%,13138,22235,35663,36.8393012365757%,62.3475310545944%,0.550715966654701,0.629723537498091,0.628586775224041,25071,32735,35373
63,1,ALABAMA,TALLAPOOSA,6183,9805,16253,38.0422075924445%,60.3273241863041%,5519,13594,19486,28.3228984912245%,69.7629067022478%,5859,14963,20991,27.9119622695441%,71.282930779858%,0.613272454340756,0.711243656150264,0.718614926520027,15988,19113,20822
64,1,ALABAMA,TUSCALOOSA,24614,34003,60114,40.9455368133879%,56.5641946967429%,31762,47723,82700,38.4062877871826%,57.7061668681983%,37765,51117,90172,41.8810717295835%,56.6883289712993%,0.580087687872119,0.600402591683965,0.575110821088634,58617,79485,88882
65,1,ALABAMA,WALKER,11621,13486,25641,45.3219453219453%,52.5954525954526%,4497,24266,29472,15.2585504885994%,82.335776330076%,4834,26002,31170,15.5085017645172%,83.4199550850176%,0.537141036364361,0.843653304592706,0.843235179660137,25107,28763,30836
66,1,ALABAMA,WASHINGTON,3386,4117,7596,44.5760926803581%,54.1995787256451%,2374,6042,8533,27.8213992734091%,70.8074534161491%,2258,6564,8876,25.4393871113114%,73.9522307345651%,0.548713847794216,0.71791825095057,0.744048968487871,7503,8416,8822
67,1,ALABAMA,WILCOX,3444,1661,5126,67.186890362856%,32.4034334763949%,4339,1737,6118,70.9218698921216%,28.3916312520432%,4048,1833,5903,68.5753006945621%,31.052007453837%,0.325367286973555,0.285878867676103,0.311681686787961,5105,6076,5881
68,1,ALABAMA,WINSTON,2692,6413,9318,28.8903198111183%,68.8237819274522%,872,9228,10313,8.45534761950936%,89.4792979734316%,974,10195,11284,8.63169088975541%,90.3491669620702%,0.704338275672707,0.913663366336634,0.912794341480885,9105,10100,11169
70,2,ALASKA,DISTRICT 1,1284,4681,6656,19.2908653846154%,70.3275240384616%,2573,3180,6638,38.7616752033745%,47.905995781862%,3477,3511,7314,47.5389663658737%,48.003828274542%,0.784744341994971,0.552755084303841,0.50243274184316,5965,5753,6988
71,2,ALASKA,DISTRICT 10,2194,5673,8884,24.6960828455651%,63.8563710040522%,1808,6255,9040,20%,69.1924778761062%,2727,8081,11205,24.3373493975904%,72.1195894689871%,0.721113512139316,0.775765843978668,0.747686898593634,7867,8063,10808
72,2,ALASKA,DISTRICT 11,2043,3960,6980,29.269340974212%,56.7335243553009%,2142,6444,9689,22.1075446382496%,66.5084116007844%,3130,7096,10628,29.4505080918329%,66.76703048551%,0.659670164917541,0.750524109014675,0.693917465284569,6003,8586,10226
73,2,ALASKA,DISTRICT 12,2051,4626,7601,26.9832916721484%,60.860413103539%,1928,6629,9543,20.2032903699046%,69.4645289741172%,2957,7893,11238,26.3125111229756%,70.2349172450614%,0.692826119514752,0.774687390440575,0.727465437788018,6677,8557,10850
74,2,ALASKA,DISTRICT 13,2661,3853,7943,33.5011960216543%,48.5081203575475%,1684,4028,6533,25.776825348232%,61.6562069493341%,2666,4652,7713,34.5650200959419%,60.3137559963698%,0.591495241019343,0.705182072829132,0.635692812243782,6514,5712,7318
75,2,ALASKA,DISTRICT 14,1626,3750,5868,27.7096114519427%,63.9059304703476%,3043,5978,10420,29.2034548944338%,57.3704414587332%,4261,6714,11443,37.2367386174954%,58.6734248011885%,0.697544642857143,0.662675978272919,0.611753986332574,5376,9021,10975
76,2,ALASKA,DISTRICT 15,2106,2453,5870,35.8773424190801%,41.7887563884157%,1828,2525,4982,36.6920915295062%,50.6824568446407%,2622,2671,5559,47.1667566109012%,48.048210109732%,0.538056591357754,0.580059728922582,0.50462875495938,4559,4353,5293
77,2,ALASKA,DISTRICT 16,1969,1980,4685,42.0277481323372%,42.2625400213447%,3294,3203,7436,44.2980096826251%,43.0742334588488%,4274,3516,8118,52.6484355752648%,43.3111603843311%,0.501392757660167,0.492996767738956,0.451347881899872,3949,6497,7790
78,2,ALASKA,DISTRICT 17,2230,4564,7704,28.9460020768432%,59.2419522326065%,3290,2618,6788,48.4678845020625%,38.5680612846199%,4136,2810,7239,57.1349633927338%,38.8175162315237%,0.671769208124816,0.443127962085308,0.40454938093867,6794,5908,6946
79,2,ALASKA,DISTRICT 18,2739,5421,9882,27.7170613236187%,54.8573163327262%,3909,2684,7402,52.8100513374764%,36.2604701432045%,4681,2760,7720,60.6347150259067%,35.7512953367876%,0.664338235294118,0.407098437736994,0.370917887380728,8160,6593,7441
80,2,ALASKA,DISTRICT 19,2350,4619,7951,29.5560306879638%,58.093321594768%,2669,1636,4792,55.6969949916528%,34.1402337228715%,3118,1975,5301,58.8190907375967%,37.2571212978683%,0.662792366193141,0.380023228803717,0.387787158845474,6969,4305,5093
81,2,ALASKA,DISTRICT 2,2081,4235,7388,28.1672983216026%,57.3226854358419%,1585,3188,5492,28.8601602330663%,58.0480699198835%,2104,3674,6136,34.2894393741851%,59.8761408083442%,0.670519316022799,0.66792373769118,0.635860159224645,6316,4773,5778
82,2,ALASKA,DISTRICT 20,2259,3648,6963,32.4429125376993%,52.3912106850496%,4151,2187,7140,58.1372549019608%,30.6302521008403%,4881,2383,7497,65.1060424169668%,31.7860477524343%,0.617572371762316,0.345061533606816,0.328056167400881,5907,6338,7264
83,2,ALASKA,DISTRICT 21,2309,3263,6629,34.8317996681249%,49.2231105747473%,4224,3479,8647,48.849311900081%,40.2336070313404%,5414,3690,9429,57.4186021847492%,39.1345847916004%,0.585606604450826,0.451642217317928,0.405316344463972,5572,7703,9104
84,2,ALASKA,DISTRICT 22,2656,4910,8525,31.1554252199414%,57.5953079178886%,3270,4203,8372,39.0587673196369%,50.2030578117535%,4553,4684,9520,47.8256302521008%,49.2016806722689%,0.648955855141422,0.562424729024488,0.507091046876692,7566,7473,9237
85,2,ALASKA,DISTRICT 23,1282,2961,4630,27.6889848812095%,63.9524838012959%,2894,3246,6924,41.7966493356441%,46.8804159445407%,3810,3655,7739,49.2311668174183%,47.2283240728776%,0.697855291067641,0.528664495114006,0.489618218352311,4243,6140,7465
86,2,ALASKA,DISTRICT 24,1985,5063,7915,25.0789639924195%,63.9671509791535%,3578,4709,9080,39.4052863436123%,51.8612334801762%,4736,5378,10428,45.4161871883391%,51.5726889144611%,0.718359818388195,0.56823941112586,0.531738184694483,7048,8287,10114
87,2,ALASKA,DISTRICT 25,1697,5489,8201,20.692598463602%,66.930862089989%,3378,3816,8127,41.5651531930602%,46.9545957918051%,4600,4407,9325,49.3297587131367%,47.260053619303%,0.763846367937657,0.530442035029191,0.489286110802709,7186,7194,9007
88,2,ALASKA,DISTRICT 26,1608,5869,8590,18.7194412107101%,68.3236321303842%,3374,4548,8905,37.8888265019652%,51.0724312184166%,4558,5243,10111,45.0796162595193%,51.8544159825932%,0.784940484151398,0.574097450138854,0.534945413733293,7477,7922,9801
89,2,ALASKA,DISTRICT 27,2199,6714,10438,21.0672542632688%,64.3226671776202%,3729,4085,8783,42.457019241717%,46.5103039963566%,4844,4324,9506,50.9572901325479%,45.4870608037029%,0.75328172332548,0.522779626311748,0.471640488656195,8913,7814,9168
90,2,ALASKA,DISTRICT 28,2116,7113,11040,19.1666666666667%,64.429347826087%,4749,5423,11427,41.5594644263586%,47.4577754441236%,6264,6162,12749,49.1332653541454%,48.3332026041258%,0.770722721855022,0.533130161226897,0.49589570255915,9229,10172,12426
91,2,ALASKA,DISTRICT 29,2806,4054,8823,31.803241527825%,45.9480902187465%,2101,6347,9394,22.3653395784543%,67.5644028103045%,2985,7464,10747,27.7751930771378%,69.4519400763004%,0.590962099125364,0.751302083333333,0.714326729830606,6860,8448,10449
92,2,ALASKA,DISTRICT 3,3693,3135,8225,44.8996960486322%,38.1155015197568%,1241,5403,7613,16.3010639695258%,70.9707079994746%,1903,6076,8385,22.6952892069171%,72.4627310673822%,0.459138840070299,0.8132149307646,0.761498934703597,6828,6644,7979
93,2,ALASKA,DISTRICT 30,1698,3622,6083,27.9138582936051%,59.5429886569127%,1816,6194,8950,20.2905027932961%,69.2067039106145%,2638,7180,10176,25.9237421383648%,70.5581761006289%,0.680827067669173,0.773283395755306,0.731309839071094,5320,8010,9818
94,2,ALASKA,DISTRICT 31,1831,3326,5965,30.6957250628667%,55.7585917854149%,3466,5617,10182,34.0404635631507%,55.1659791789432%,5037,6971,12410,40.5882352941176%,56.1724415793715%,0.644948613535001,0.618408014973027,0.580529646902065,5157,9083,12008
95,2,ALASKA,DISTRICT 32,1389,4178,6033,23.0233714569866%,69.2524448864578%,2701,3764,7472,36.1482869379015%,50.3747323340471%,3506,4440,8335,42.0635872825435%,53.2693461307738%,0.750493982396264,0.582211910286156,0.558771709035993,5567,6465,7946
96,2,ALASKA,DISTRICT 33,1765,5804,8712,20.2594123048668%,66.6207529843894%,5978,2732,9934,60.1771693174955%,27.5015099657741%,7535,3059,10955,68.7813783660429%,27.9233226837061%,0.7668119963007,0.313662456946039,0.288748348121578,7569,8710,10594
97,2,ALASKA,DISTRICT 34,1300,5243,7154,18.1716522225328%,73.2876712328767%,4220,3955,9431,44.7460502597816%,41.9361679567384%,5763,4543,10729,53.7142324540964%,42.3431820300121%,0.801314381782057,0.483792048929664,0.44081117795459,6543,8175,10306
98,2,ALASKA,DISTRICT 35,1208,4278,6382,18.9282356628016%,67.03227828267%,3749,4105,9042,41.4620659146207%,45.3992479539925%,5011,4769,10102,49.6040388041972%,47.2084735695902%,0.779803135253372,0.522663610898905,0.487627811860941,5486,7854,9780
99,2,ALASKA,DISTRICT 36,1945,3007,5577,34.8753810292272%,53.9178769948001%,2693,4460,8264,32.5871248789932%,53.9690222652469%,3796,5114,9292,40.8523461041756%,55.0365906155833%,0.607229402261712,0.623514609254858,0.573961840628507,4952,7153,8910
100,2,ALASKA,DISTRICT 37,1821,2725,5028,36.2171837708831%,54.1964996022275%,2421,1938,5062,47.8269458711972%,38.2852627419992%,2560,2358,5142,49.7860754570206%,45.8576429404901%,0.599428068631764,0.444597384721266,0.479463196421309,4546,4359,4918
101,2,ALASKA,DISTRICT 38,2015,2467,4976,40.4943729903537%,49.5779742765273%,2758,1143,5095,54.1315014720314%,22.4337585868499%,3202,1737,5299,60.426495565201%,32.7797697678807%,0.550423917893797,0.293001794411689,0.351690625632719,4482,3901,4939
102,2,ALASKA,DISTRICT 39,2282,2321,5188,43.9861218195837%,44.7378565921357%,3142,1405,5639,55.7190991310516%,24.9157652065969%,3580,1939,5891,60.7706671193346%,32.9146155151927%,0.504236367586357,0.308994941719815,0.351331763000544,4603,4547,5519
103,2,ALASKA,DISTRICT 4,2715,4127,7823,34.7053560015339%,52.7546976863096%,4162,4070,9521,43.7138955992018%,42.7476105451108%,5345,4690,10511,50.8514889163733%,44.6199219864903%,0.603186202864659,0.4944120505345,0.467364225211759,6842,8232,10035
104,2,ALASKA,DISTRICT 40,1024,1831,3226,31.7420954742715%,56.7575945443273%,2338,1377,4610,50.7158351409978%,29.8698481561822%,2318,1994,4603,50.3584618726917%,43.3195741907452%,0.641330998248687,0.370659488559892,0.462430426716141,2855,3715,4312
105,2,ALASKA,DISTRICT 5,1931,3545,6437,29.9984464812801%,55.0722386204754%,3187,3683,7906,40.3111560839868%,46.5848722489249%,4204,4077,8654,48.5786919343656%,47.1111624682228%,0.647370343316289,0.536098981077147,0.492331843980196,5476,6870,8281
106,2,ALASKA,DISTRICT 6,1542,3862,6100,25.2786885245902%,63.3114754098361%,2536,4929,8460,29.9763593380615%,58.2624113475177%,3272,5770,9460,34.5877378435518%,60.9936575052854%,0.714655810510733,0.660281312793034,0.638133156381332,5404,7465,9042
107,2,ALASKA,DISTRICT 7,1893,4868,8677,21.8162959548231%,56.1023395182667%,1510,5935,8294,18.2059319990354%,71.5577525922353%,2215,7027,9622,23.0201621284556%,73.030554978175%,0.720011832569147,0.797179314976494,0.760333261198875,6761,7445,9242
108,2,ALASKA,DISTRICT 8,1498,5371,7978,18.7766357483078%,67.3226372524442%,1218,6126,8073,15.0873281308064%,75.8825715347455%,1953,7618,9912,19.7033898305085%,76.8563357546408%,0.781918765468045,0.834150326797386,0.79594608713823,6869,7344,9571
109,2,ALASKA,DISTRICT 9,1203,4789,6800,17.6911764705882%,70.4264705882353%,1843,6100,8954,20.5829796738888%,68.1259772168863%,2769,7787,10993,25.1887564813973%,70.8359865368871%,0.799232309746328,0.767971799068362,0.737684729064039,5992,7943,10556
110,2,ALASKA,DISTRICT 99,0,0,0,#DIV/0!,#DIV/0!,274,40,342,80.1169590643275%,11.6959064327485%,373,59,433,86.1431870669746%,13.6258660508083%,#DIV/0!,0.127388535031847,0.136574074074074,0,314,432
112,3,ARIZONA,APACHE,13025,5947,19456,66.9459292763158%,30.56640625%,17083,8240,27661,61.7584324500199%,29.7892339394816%,23293,11442,35172,66.2259752075515%,32.5315591948141%,0.313461943917352,0.325395885163685,0.329408377717,18972,25323,34735
113,3,ARIZONA,COCHISE,13360,18180,33241,40.1913299840558%,54.6914954423754%,17450,28092,50015,34.889533140058%,56.1671498550435%,23732,35557,60442,39.2640878859072%,58.8282982032362%,0.576410906785035,0.616837205217162,0.599723388824234,31540,45542,59289
114,3,ARIZONA,COCONINO,20280,17562,40883,49.6049702810459%,42.9567301812489%,32404,21108,59784,54.2017931219055%,35.3071055800883%,44698,27052,73272,61.0028387378535%,36.919969428977%,0.464087521801173,0.394453580505307,0.377031358885017,37842,53512,71750
115,3,ARIZONA,GILA,7700,9158,17736,43.4145241317095%,51.6350924672982%,7003,14182,22312,31.3866977411258%,63.5622086769451%,8943,18377,27662,32.3295495625768%,66.4340973176198%,0.543243563886582,0.669435921642672,0.672657393850659,16858,21185,27320
116,3,ARIZONA,GRAHAM,3355,6007,9664,34.7164735099338%,62.1585264900662%,3301,8025,12134,27.2045492005934%,66.1364760178012%,4034,10749,14995,26.9023007669223%,71.6838946315438%,0.641636402478103,0.708546706692566,0.727118988026788,9362,11326,14783
117,3,ARIZONA,GREENLEE,1216,1619,2960,41.0810810810811%,54.695945945946%,1092,1892,3270,33.394495412844%,57.8593272171254%,1182,2433,3685,32.0759837177748%,66.0244233378562%,0.571075837742504,0.634048257372654,0.673029045643154,2835,2984,3615
118,3,ARIZONA,LA PAZ,1769,2543,4483,39.4601829132277%,56.7254070934642%,1575,4003,5951,26.4661401445135%,67.2660057133255%,2236,5129,7458,29.9812282113167%,68.7717886832931%,0.589749536178108,0.717640731444962,0.696401900882553,4312,5578,7365
119,3,ARIZONA,MARICOPA,386683,479967,901699,42.8838226503523%,53.2291818001351%,702907,747361,1567834,44.8329989016694%,47.668375606091%,1040774,995665,2068144,50.3240586728971%,48.1429242838023%,0.553818727283217,0.515326132825105,0.488924539355218,866650,1450268,2036439
120,3,ARIZONA,MOHAVE,17470,24386,44141,39.5777168618744%,55.2456899481208%,17455,58282,79943,21.8343069436974%,72.9044444166469%,24831,78535,104668,23.7235831390683%,75.0324836626285%,0.582616590214067,0.769531404729525,0.759775941799044,41856,75737,103366
121,3,ARIZONA,NAVAJO,11794,12386,25147,46.9002266671969%,49.2543842207818%,16459,20577,40294,40.8472725467812%,51.0671564004567%,23383,27657,51767,45.1697027063573%,53.4259277145672%,0.512241521918941,0.555594556647586,0.541869122257053,24180,37036,51040
122,3,ARIZONA,PIMA,147688,124579,287640,51.3447364761507%,43.3107356417744%,224661,167428,421640,53.2826581918224%,39.7087562849824%,304981,207758,520397,58.6054493012066%,39.9229818772975%,0.457561878597112,0.427015294996799,0.405192505348725,272267,392089,512739
123,3,ARIZONA,PINAL,19650,20122,41290,47.590215548559%,48.7333494792928%,47892,72819,129546,36.9691074984947%,56.2109212171738%,75106,107077,184974,40.6035442818991%,57.8875950133532%,0.505933822789902,0.603250739369237,0.587744191280196,39772,120711,182183
124,3,ARIZONA,SANTA CRUZ,5233,3344,8893,58.8440346339818%,37.602608793433%,11690,3897,16433,71.1373455851031%,23.7144769670784%,13138,6194,19556,67.1814276948251%,31.6731437921865%,0.389879911390929,0.250016039006865,0.320401406993586,8577,15587,19332
125,3,ARIZONA,YAVAPAI,24063,40144,68228,35.26851146157%,58.8380137187079%,35590,71330,114450,31.0965487112276%,62.3241590214067%,49602,91527,143221,34.6331892669371%,63.9061310841287%,0.625227778902612,0.667134306023195,0.648534319664987,64207,106920,141129
126,3,ARIZONA,YUMA,12055,15708,28652,42.0738517380986%,54.8233980175904%,24605,25165,53010,46.415770609319%,47.4721750613092%,32210,36534,69881,46.0926432077389%,52.2803050900817%,0.565788999747866,0.505625879043601,0.531450017456069,27763,49770,68744
128,4,ARKANSAS,ARKANSAS,2877,3353,6372,45.15065913371%,52.6208411801632%,1939,3826,6212,31.2137797810689%,61.5904700579524%,1818,4304,6292,28.893833439288%,68.4043229497775%,0.538202247191011,0.663660017346054,0.703038222803006,6230,5765,6122
129,4,ARKANSAS,ASHLEY,4253,3876,8271,51.4206262846089%,46.8625317373957%,2408,5338,8083,29.7909192131634%,66.0398366942967%,2125,5548,7926,26.810497098158%,69.9974766590966%,0.476811415918317,0.689129873483088,0.723054867717972,8129,7746,7673
130,4,ARKANSAS,BAXTER,6516,9538,16708,38.9992817811827%,57.0864256643524%,4169,14682,19766,21.091773752909%,74.2790650612162%,4635,15836,21007,22.0640738801352%,75.3843956776313%,0.594119845521365,0.778844623627394,0.773582140589126,16054,18851,20471
131,4,ARKANSAS,BENTON,17277,34838,53646,32.2055698467733%,64.9405361070723%,28005,60871,96824,28.923613980005%,62.8676774353466%,42249,73965,119912,35.2333377810394%,61.682734004937%,0.66848316223736,0.684898060218732,0.636455160307708,52115,88876,116214
132,4,ARKANSAS,BOONE,4493,8569,13635,32.951961862853%,62.8456178951228%,2926,12235,16111,18.1615045621004%,75.9419030476072%,3064,13652,17114,17.903470842585%,79.7709477620661%,0.656025111009034,0.807004814985819,0.816702560421153,13062,15161,16716
133,4,ARKANSAS,BRADLEY,2122,1793,3979,53.3299824076401%,45.061573259613%,1317,2164,3653,36.052559540104%,59.2389816589105%,1214,2335,3654,33.223864258347%,63.9025725232622%,0.457982120051086,0.621660442401609,0.657931811777966,3915,3481,3549
134,4,ARKANSAS,CALHOUN,1017,1128,2185,46.5446224256293%,51.6247139588101%,639,1556,2269,28.1621859850154%,68.5764654032613%,479,1636,2182,21.9523373052246%,74.9770852428964%,0.525874125874126,0.708883826879271,0.773522458628842,2145,2195,2115
135,4,ARKANSAS,CARROLL,3595,5556,9590,37.4869655891554%,57.9353493222106%,3342,6786,10758,31.0652537646403%,63.0786391522588%,4023,7424,11797,34.101890311096%,62.93125370857%,0.607146759916949,0.670023696682464,0.648554206342273,9151,10128,11447
136,4,ARKANSAS,CHICOT,2820,1564,4452,63.3423180592992%,35.1302785265049%,2350,1716,4176,56.2739463601533%,41.0919540229885%,2260,1752,4103,55.0816475749452%,42.7004630757982%,0.356751824817518,0.422036399409739,0.436689930209372,4384,4066,4012
137,4,ARKANSAS,CLARK,4661,3776,8626,54.034314862045%,43.7746348249478%,3620,4404,8526,42.458362655407%,51.6537649542576%,3438,4616,8395,40.9529481834425%,54.9851101846337%,0.447552447552448,0.548853439680957,0.57313136329774,8437,8024,8054
138,4,ARKANSAS,CLAY,3527,2254,5900,59.7796610169492%,38.2033898305085%,1199,3781,5200,23.0576923076923%,72.7115384615385%,962,4086,5183,18.5606791433533%,78.834651746093%,0.389897941532607,0.759236947791165,0.809429477020602,5781,4980,5048
139,4,ARKANSAS,CLEBURNE,4120,5730,10207,40.364455765651%,56.1379445478593%,2101,9458,12085,17.3851882498966%,78.2623086470832%,1988,10328,12680,15.6782334384858%,81.4511041009464%,0.581725888324873,0.818236871701704,0.838583955829815,9850,11559,12316
140,4,ARKANSAS,CLEVELAND,1414,1678,3181,44.4514303678089%,52.7507073247407%,723,2462,3354,21.5563506261181%,73.4048896839595%,651,2867,3600,18.0833333333333%,79.6388888888889%,0.542690815006468,0.772998430141287,0.814951677089255,3092,3185,3518
141,4,ARKANSAS,COLUMBIA,4003,5018,9307,43.0106371548297%,53.9164070054798%,3140,5456,8887,35.3325081579836%,61.3930460222797%,2814,5500,8616,32.6601671309192%,63.8347260909935%,0.556257621106307,0.634713820381573,0.661534760644696,9021,8596,8314
142,4,ARKANSAS,CONWAY,3496,3545,7234,48.3273431020182%,49.0047000276472%,2656,4849,7927,33.5057398763719%,61.1706824776082%,2615,5694,8685,30.1093839953944%,65.5613126079447%,0.503479619372248,0.646102598267821,0.685281020580094,7041,7505,8309
143,4,ARKANSAS,CRAIGHEAD,12376,12158,25157,49.1950550542593%,48.3284970385976%,10538,22892,35573,29.6235909257021%,64.3521772130548%,11921,25558,38511,30.9547921373114%,66.3654540261224%,0.495557185946034,0.684774154950643,0.681928546652792,24534,33430,37479
144,4,ARKANSAS,CRAWFORD,6288,10804,17625,35.6765957446809%,61.2992907801418%,4488,16686,22450,19.9910913140312%,74.3251670378619%,4959,18607,24091,20.5844506247146%,77.2363123158026%,0.63210858881348,0.788041938226126,0.78956971908682,17092,21174,23566
145,4,ARKANSAS,CRITTENDEN,7224,5857,13234,54.5866706966903%,44.2572162611455%,8410,6964,15952,52.7206619859579%,43.6559679037111%,8514,7333,16367,52.0193071424207%,44.8035681554347%,0.447748643070102,0.452972551060232,0.462737426642267,13081,15374,15847
146,4,ARKANSAS,CROSS,3096,3033,6215,49.8149637972647%,48.8012872083669%,1999,4584,6874,29.0805935408787%,66.6860634274076%,1772,4946,6942,25.5257850763469%,71.2474791126477%,0.494860499265786,0.696339055142033,0.736231021137243,6129,6583,6718
147,4,ARKANSAS,DALLAS,1710,1571,3325,51.4285714285714%,47.2481203007519%,1165,1509,2771,42.0425839047275%,54.4568747744497%,963,1573,2649,36.3533408833522%,59.3808984522461%,0.478817433709235,0.56432311144353,0.620268138801262,3281,2674,2536
148,4,ARKANSAS,DESHA,2776,1603,4495,61.7575083426029%,35.6618464961068%,2228,1919,4257,52.3373267559314%,45.0786939159032%,2016,1921,4164,48.4149855907781%,46.133525456292%,0.366065311715003,0.462744152399325,0.487934975869952,4379,4147,3937
149,4,ARKANSAS,DREW,3060,2756,5922,51.6717325227964%,46.5383316447146%,2365,3968,6595,35.8605003790751%,60.1667930250189%,2426,4349,6908,35.1187029530979%,62.9559930515345%,0.473865199449794,0.626559292594347,0.641918819188192,5816,6333,6775
150,4,ARKANSAS,FAULKNER,11950,16055,29216,40.9022453450164%,54.9527656078861%,14629,29346,47527,30.7803985103204%,61.7459549308814%,18347,34421,54428,33.7087528477989%,63.2413463658411%,0.573290483842171,0.667333712336555,0.652308217101274,28005,43975,52768
151,4,ARKANSAS,FRANKLIN,2674,3277,6140,43.5504885993485%,53.371335504886%,1376,5039,6770,20.3249630723781%,74.4313146233383%,1300,5677,7129,18.2353766306635%,79.6324870248282%,0.550663753990926,0.785502727981294,0.813673498638383,5951,6415,6977
152,4,ARKANSAS,FULTON,1976,2036,4108,48.1012658227848%,49.5618305744888%,1067,3471,4772,22.3595976529757%,72.7367979882649%,1035,3961,5119,20.2187927329557%,77.3783942176206%,0.507477567298106,0.76487439400617,0.792834267413931,4012,4538,4996
153,4,ARKANSAS,GARLAND,15840,19098,35935,44.0795881452623%,53.1459579796855%,12311,26087,40805,30.1703222644284%,63.9308908222032%,14045,29069,44199,31.7767370302495%,65.7684562999163%,0.546625450798557,0.679384342934528,0.674235747089113,34938,38398,43114
154,4,ARKANSAS,GRANT,2535,3285,6013,42.1586562448029%,54.6316314651588%,1373,5725,7445,18.4419073203492%,76.8972464741437%,1268,6794,8200,15.4634146341463%,82.8536585365854%,0.564432989690722,0.806565229642153,0.842718928305631,5820,7098,8062
155,4,ARKANSAS,GREENE,6319,5831,12484,50.6167894905479%,46.7077859660365%,3071,10720,14600,21.0342465753425%,73.4246575342466%,3058,12670,16100,18.9937888198758%,78.695652173913%,0.479917695473251,0.777318541077514,0.805569684638861,12150,13791,15728
156,4,ARKANSAS,HEMPSTEAD,3937,3257,7289,54.0128961448758%,44.6837700644807%,2377,4401,7049,33.7210951908072%,62.4343878564335%,2138,4470,6848,31.2207943925234%,65.2745327102804%,0.452738393105366,0.649306580112128,0.676452784503632,7194,6778,6608
157,4,ARKANSAS,HOT SPRING,5527,5042,10981,50.3323923139969%,45.9156725252709%,3149,8172,11944,26.3647019423979%,68.4192900200938%,3082,9202,12557,24.5440789997611%,73.2818348331608%,0.477055539786167,0.721844360038866,0.74910452621296,10569,11321,12284
158,4,ARKANSAS,HOWARD,2063,2326,4459,46.2659789190401%,52.164162368244%,1351,3157,4674,28.9045785194694%,67.5438596491228%,1340,3367,4834,27.7203144393877%,69.6524617294166%,0.529961266803372,0.700310559006211,0.715317612067134,4389,4508,4707
159,4,ARKANSAS,INDEPENDENCE,5146,6145,11594,44.3850267379679%,53.0015525271692%,2881,9936,13614,21.1620390774203%,72.9836932569414%,2806,11250,14512,19.3357221609702%,77.5220507166483%,0.544238774244974,0.775220410392447,0.800369948776323,11291,12817,14056
160,4,ARKANSAS,IZARD,2587,2301,5032,51.4109697933227%,45.7273449920509%,1113,4042,5448,20.4295154185022%,74.1923641703377%,1021,4631,5810,17.5731497418244%,79.7074010327022%,0.470744680851064,0.784093113482056,0.819355980184006,4888,5155,5652
161,4,ARKANSAS,JACKSON,3651,2280,6072,60.1284584980237%,37.5494071146245%,1583,3267,5156,30.7020946470132%,63.3630721489527%,1365,3593,5091,26.8120212139069%,70.5755254370458%,0.384420839656044,0.67360824742268,0.724687373941105,5931,4850,4958
162,4,ARKANSAS,JEFFERSON,17716,8765,27201,65.1299584574097%,32.2230800338223%,15772,9250,25894,60.9098632887928%,35.7225612110914%,14981,9521,25158,59.5476587964067%,37.8448207329676%,0.33099203202296,0.369674686276077,0.388580524038854,26481,25022,24502
163,4,ARKANSAS,JOHNSON,3270,3657,7161,45.6640134059489%,51.0682865521575%,2427,6091,9112,26.6352063213345%,66.8459174714662%,2283,6938,9498,24.0366392924826%,73.0469572541588%,0.527934170636639,0.715073961023714,0.752412970393667,6927,8518,9221
164,4,ARKANSAS,LAFAYETTE,1806,1538,3383,53.3845699083654%,45.4626071534141%,1032,1758,2860,36.0839160839161%,61.4685314685315%,839,1757,2679,31.317655841732%,65.5841731989548%,0.459928229665072,0.63010752688172,0.676810477657935,3344,2790,2596
165,4,ARKANSAS,LAWRENCE,3255,2626,6040,53.8907284768212%,43.476821192053%,1263,4064,5685,22.2163588390501%,71.4863676341249%,1080,4569,5857,18.4394741335155%,78.0092197370668%,0.446522700221051,0.762905950816595,0.808815719596389,5881,5327,5649
166,4,ARKANSAS,LEE,2727,1351,4121,66.1732589177384%,32.7833050230527%,1735,1229,3026,57.3364177131527%,40.6146728354263%,1423,1286,2848,49.9648876404494%,45.1544943820225%,0.331289847964689,0.414642375168691,0.474713916574382,4078,2964,2709
167,4,ARKANSAS,LINCOLN,1957,1526,3546,55.1889452904681%,43.034404963339%,1252,2455,3826,32.723470987977%,64.1662310507057%,1032,2729,3875,26.6322580645161%,70.4258064516129%,0.438128050531151,0.662260588076612,0.725604892315873,3483,3707,3761
168,4,ARKANSAS,LITTLE RIVER,2883,2283,5263,54.7786433593008%,43.3783013490405%,1397,3605,5227,26.7266118232256%,68.9688157643008%,1226,3715,5177,23.6816689202241%,71.7597063936643%,0.441927990708478,0.720711715313874,0.751872090669905,5166,5002,4941
169,4,ARKANSAS,LOGAN,3283,4487,8096,40.5508893280632%,55.4224308300395%,1715,5746,7921,21.6513066532004%,72.541345789673%,1544,6441,8225,18.7720364741641%,78.3100303951368%,0.577477477477477,0.770138051199571,0.806637445209768,7770,7461,7985
170,4,ARKANSAS,LONOKE,6851,10606,17943,38.1820208437831%,59.109401995207%,5664,19958,27100,20.90036900369%,73.6457564575646%,6686,22884,30662,21.8054921401083%,74.6330963407475%,0.607549979950736,0.778939973460308,0.773892458572878,17457,25622,29570
171,4,ARKANSAS,MADISON,2055,3387,5628,36.5138592750533%,60.181236673774%,1588,4928,6841,23.2129805583979%,72.0362520099401%,1563,5658,7351,21.2624132771052%,76.9691198476398%,0.622381477398015,0.756292203806016,0.783547985043623,5442,6516,7221
172,4,ARKANSAS,MARION,2233,3402,6015,37.1238570241064%,56.5586034912718%,1434,5336,7107,20.1772899957788%,75.0809061488673%,1531,5783,7503,20.4051712648274%,77.0758363321338%,0.603726708074534,0.788183161004431,0.790675417008477,5635,6770,7314
173,4,ARKANSAS,MILLER,6278,7276,13745,45.6747908330302%,52.9356129501637%,4273,11294,16091,26.5552172021627%,70.1883040208813%,4245,11920,16529,25.6821344303951%,72.1156754794603%,0.536815700162314,0.725509089741119,0.737395607794618,13554,15567,16165
174,4,ARKANSAS,MISSISSIPPI,7107,5199,12586,56.4675035754012%,41.3078023200381%,5670,7061,13204,42.9415328688276%,53.4762193274765%,4558,7296,12342,36.9308053800032%,59.1152163344677%,0.422476840565578,0.554630429659885,0.615488442719757,12306,12731,11854
175,4,ARKANSAS,MONROE,1910,1329,3293,58.0018220467659%,40.3583358639538%,1312,1489,2884,45.4923717059639%,51.629680998613%,1147,1545,2816,40.7315340909091%,54.8650568181818%,0.410311824637234,0.531595858621921,0.573922734026746,3239,2801,2692
176,4,ARKANSAS,MONTGOMERY,1438,2128,3739,38.4594811446911%,56.913613265579%,748,2643,3559,21.017139645968%,74.2624332677718%,731,3046,3873,18.8742576813839%,78.6470436354247%,0.596747055524397,0.779416101445001,0.806460153561027,3566,3391,3777
177,4,ARKANSAS,NEVADA,1867,1796,3738,49.9464954521134%,48.0470840021402%,1157,2000,3246,35.6438693776956%,61.6142945163278%,1076,2133,3358,32.0428826682549%,63.5199523525908%,0.49030849030849,0.63351282863478,0.66469305079464,3663,3157,3209
178,4,ARKANSAS,NEWTON,1205,2529,3927,30.6850012732366%,64.4003055767762%,699,2875,3753,18.625099920064%,76.605382360778%,709,3192,3998,17.7338669334667%,79.83991995998%,0.677289769683985,0.804420817011751,0.818251730325557,3734,3574,3901
179,4,ARKANSAS,OUACHITA,5464,4739,10395,52.5637325637326%,45.5892255892256%,4321,5351,9935,43.4927025666834%,53.8600905888274%,3995,5294,9629,41.4892512202721%,54.979748675875%,0.464471233950799,0.553246484698098,0.569921412423296,10203,9672,9289
180,4,ARKANSAS,PERRY,1648,2114,4007,41.1280259545795%,52.7576740703768%,1049,3008,4306,24.3613562470971%,69.8560148629819%,1012,3479,4627,21.8716230819105%,75.1891074130106%,0.561935140882509,0.741434557554843,0.774660431975061,3762,4057,4491
181,4,ARKANSAS,PHILLIPS,6018,3154,9313,64.6193492966821%,33.8666380328573%,4310,2446,6953,61.9876312383144%,35.1790593988207%,3623,2417,6242,58.0422941364947%,38.7215636014098%,0.343872655909289,0.362048549437537,0.400165562913907,9172,6756,6040
182,4,ARKANSAS,PIKE,1604,2275,3971,40.3928481490808%,57.2903550742886%,685,3150,3981,17.2067319768902%,79.1258477769405%,644,3519,4246,15.1672162034856%,82.8780028261894%,0.586491363753545,0.821382007822686,0.845303867403315,3879,3835,4163
183,4,ARKANSAS,POINSETT,4102,2988,7235,56.6966136834831%,41.2992398064962%,1880,5502,7722,24.3460243460243%,71.2509712509713%,1424,5918,7521,18.9336524398351%,78.686344900944%,0.421438645980254,0.745326469791384,0.806047398529011,7090,7382,7342
184,4,ARKANSAS,POLK,2315,4600,7193,32.184067843737%,63.9510635339914%,1212,6618,8231,14.7248207994168%,80.4033531770137%,1246,7035,8490,14.6760895170789%,82.8621908127209%,0.665220535068691,0.845210727969349,0.849535080304311,6915,7830,8281
185,4,ARKANSAS,POPE,6669,11244,18422,36.2012810769732%,61.0357181630659%,5000,16256,22569,22.1542824227923%,72.0280030129824%,5772,18081,24432,23.6247544204322%,74.0054027504912%,0.627700552671244,0.764772299585999,0.758017859388756,17913,21256,23853
186,4,ARKANSAS,PRAIRIE,1563,1862,3507,44.5680068434559%,53.0938123752495%,814,2505,3444,23.6353077816492%,72.7351916376307%,654,2786,3495,18.7124463519313%,79.7138769670959%,0.543649635036496,0.754745405242543,0.809883720930232,3425,3319,3440
187,4,ARKANSAS,PULASKI,68320,55866,127151,53.7313902368051%,43.9367366359683%,89574,61257,159776,56.0622371319848%,38.339300020028%,101947,63687,169956,59.984348890301%,37.4726399774059%,0.449857471856731,0.406130039580723,0.384504389195455,124186,150831,165634
188,4,ARKANSAS,RANDOLPH,3019,2673,5877,51.3697464692871%,45.4823889739663%,1425,4509,6379,22.3389245963317%,70.6850603542875%,1215,5355,6812,17.8361714621257%,78.6112742219613%,0.469606465214336,0.759858442871587,0.815068493150685,5692,5934,6570
189,4,ARKANSAS,SALINE,12700,18617,32391,39.2084220925566%,57.4758420548918%,13256,35863,52100,25.4433781190019%,68.8349328214971%,16060,39556,56959,28.1957197282256%,69.4464439333556%,0.594469457483156,0.730124798957634,0.71123417721519,31317,49119,55616
190,4,ARKANSAS,SCOTT,1444,2399,3981,36.2722933936197%,60.2612408942477%,602,2731,3510,17.1509971509972%,77.8062678062678%,483,2962,3551,13.6018023092087%,83.4131230639257%,0.624251886546969,0.819381938193819,0.859796806966618,3843,3333,3445
191,4,ARKANSAS,SEARCY,1229,2610,4058,30.285855101035%,64.3173977328733%,601,2955,3728,16.1212446351931%,79.2650214592275%,588,3365,4019,14.6305051007713%,83.7272953471013%,0.67986454805939,0.830989876265467,0.851252213508728,3839,3556,3953
192,4,ARKANSAS,SEBASTIAN,15555,23483,40159,38.7335342015488%,58.4750616300207%,12300,29127,44637,27.5556152967269%,65.2530411990053%,14487,31198,47140,30.7318625371235%,66.1815867628341%,0.60154208719709,0.703092186255341,0.682893728795009,39038,41427,45685
193,4,ARKANSAS,SEVIER,2095,2111,4293,48.8003726997438%,49.1730724435127%,1075,3282,4562,23.5642262165717%,71.9421306444542%,1116,3884,5202,21.4532871972318%,74.6635909265667%,0.50190204469805,0.753270599036034,0.7768,4206,4357,5000
194,4,ARKANSAS,SHARP,3236,3698,7126,45.4111703620545%,51.8944709514454%,1472,5407,7249,20.3062491378121%,74.5895985653194%,1398,5938,7566,18.47739888977%,78.4826856991806%,0.533314104413037,0.786015409216456,0.809432933478735,6934,6879,7336
195,4,ARKANSAS,ST. FRANCIS,4986,3414,8496,58.6864406779661%,40.183615819209%,4031,3195,7430,54.2530282637954%,43.0013458950202%,3604,3242,7108,50.7034327518289%,45.6105796285875%,0.406428571428571,0.442153335178522,0.473561203622553,8400,7226,6846
196,4,ARKANSAS,STONE,2043,2623,4860,42.037037037037%,53.9711934156379%,1203,4113,5618,21.4133143467426%,73.2111071555714%,1180,4616,5938,19.8720107780397%,77.7366116537555%,0.56215173596228,0.773702031602709,0.796411318150449,4666,5316,5796
197,4,ARKANSAS,UNION,6261,8647,15609,40.1114741495291%,55.3975270677173%,5855,10456,16894,34.6572747721084%,61.8917959038712%,5584,10478,16607,33.6243752634431%,63.0938760763534%,0.580024148108398,0.641039789099381,0.652347154775246,14908,16311,16062
198,4,ARKANSAS,VAN BUREN,3202,3485,6984,45.8476517754868%,49.8997709049255%,1549,5382,7339,21.1064177680883%,73.3342417223055%,1593,6034,7807,20.404764954528%,77.2896118867683%,0.521160460595185,0.776511325926995,0.791136751016127,6687,6931,7627
199,4,ARKANSAS,WASHINGTON,21425,28231,51459,41.6350881284129%,54.8611515964166%,33366,41476,81861,40.7593359475208%,50.6663734867642%,43824,47504,94266,46.489720577939%,50.3935671397959%,0.568531496697277,0.554180807567943,0.520147161878066,49656,74842,91328
200,4,ARKANSAS,WHITE,8342,13170,22150,37.6613995485327%,59.4582392776524%,5170,21077,27219,18.9940850141445%,77.434880047026%,5978,24182,30885,19.3556742755383%,78.2969078840861%,0.6122164373373,0.803025107631348,0.801790450928382,21512,26247,30160
201,4,ARKANSAS,WOODRUFF,1699,898,2651,64.0890230101848%,33.8740098076198%,1118,1347,2571,43.4850252819914%,52.392065344224%,856,1543,2476,34.5718901453958%,62.3182552504039%,0.345783596457451,0.546450304259635,0.643184660275115,2597,2465,2399
202,4,ARKANSAS,YELL,3062,3223,6479,47.2603796882235%,49.7453310696095%,1480,4608,6439,22.9849355489983%,71.5639074390433%,1284,5226,6741,19.047619047619%,77.5255896751224%,0.512808273667462,0.756898817345598,0.802764976958525,6285,6088,6510
204,5,CALIFORNIA,ALAMEDA,342889,119279,494336,69.3635502977732%,24.1291348394614%,514842,95922,654266,78.6900129305206%,14.6610094365289%,617659,136309,770070,80.2081628942823%,17.7008583635254%,0.258085804296273,0.157052478535081,0.180788839844662,462168,610764,753968
205,5,CALIFORNIA,ALPINE,265,281,586,45.221843003413%,47.9522184300341%,334,217,602,55.4817275747508%,36.046511627907%,476,244,741,64.2375168690958%,32.9284750337382%,0.514652014652015,0.393829401088929,0.338888888888889,546,551,720
206,5,CALIFORNIA,AMADOR,5906,8766,15464,38.1919296430419%,56.6864976720124%,6004,10485,17734,33.8558700800722%,59.1237171534905%,8153,13585,22304,36.553981348637%,60.9083572453372%,0.597464558342421,0.635878464430833,0.624942497009844,14672,16489,21738
207,5,CALIFORNIA,BUTTE,31338,45584,83721,37.4314688071093%,54.4475101826304%,41567,45144,95564,43.4965049600268%,47.239546272655%,50426,48730,102066,49.4052867752239%,47.7436168753552%,0.59260029640415,0.520625987475637,0.491447819597402,76922,86711,99156
208,5,CALIFORNIA,CALAVERAS,7093,10599,18876,37.5768171222717%,56.1506675143039%,7944,13511,23136,34.3360995850622%,58.3981673582296%,10046,16518,27164,36.9827713149757%,60.8084229126786%,0.599084331901424,0.62973665812165,0.621819003162174,17692,21455,26564
209,5,CALIFORNIA,COLUSA,1745,3629,5590,31.216457960644%,64.9194991055456%,2661,3551,6632,40.1236429433052%,53.543425814234%,3239,4559,7961,40.6858434869991%,57.266675040824%,0.675288425753629,0.571635544108178,0.584637086432419,5374,6212,7798
210,5,CALIFORNIA,CONTRA COSTA,224338,141373,381478,58.807585234273%,37.0592799584773%,319287,115956,466175,68.4908028101035%,24.8739207379203%,416386,152877,581316,71.628167812343%,26.2984332101645%,0.386570269967269,0.266416691365513,0.268552496824842,365711,435243,569263
211,5,CALIFORNIA,DEL NORTE,3117,4526,8294,37.5813841331083%,54.5695683626718%,3485,5134,9558,36.4616028457836%,53.7141661435447%,4677,6461,11453,40.8364620623417%,56.4131668558456%,0.592175847180426,0.595660749506903,0.580086191416771,7643,8619,11138
212,5,CALIFORNIA,EL DORADO,26220,42045,72136,36.3480093157369%,58.2857380503493%,36404,49247,93591,38.8969024799393%,52.6193757946811%,51621,61838,116159,44.4399486910183%,53.2356511333603%,0.615908591518348,0.574972854957911,0.545025075137274,68265,85651,113459
213,5,CALIFORNIA,FRESNO,95059,117342,220835,43.0452600357733%,53.1355989766115%,141341,124049,282319,50.0642889780709%,43.9393027036792%,193025,164464,364917,52.8955899560722%,45.068878676521%,0.55245502610628,0.46742153057764,0.460053316325817,212401,265390,357489
214,5,CALIFORNIA,GLENN,2498,5795,8711,28.6763861783951%,66.5250832281024%,3065,5788,9470,32.3653643083421%,61.1193241816262%,3995,7063,11297,35.3633708064088%,62.521023280517%,0.698782105390088,0.653789675816108,0.638723096400796,8293,8853,11058
215,5,CALIFORNIA,HUMBOLDT,24851,23219,55972,44.3989852068892%,41.4832416208104%,33200,18373,59246,56.0375383992168%,31.0113762954461%,44768,21770,68843,65.029124239211%,31.6226776869108%,0.483024755564801,0.356252302561418,0.327181460218221,48070,51573,66538
216,5,CALIFORNIA,IMPERIAL,15489,12524,28937,53.5266268099665%,43.280229464008%,32667,12704,48091,67.9274708365391%,26.4165852238465%,34678,20847,56743,61.1141462383025%,36.7393334860688%,0.447078142291079,0.280002644861255,0.375452498874381,28013,45371,55525
217,5,CALIFORNIA,INYO,2652,4713,7815,33.9347408829175%,60.3071017274472%,3155,4248,8086,39.0180558990848%,52.5352461043779%,4634,4620,9484,48.8612399831295%,48.7136229439055%,0.639918533604888,0.57382142374713,0.499243570347958,7365,7403,9254
218,5,CALIFORNIA,KERN,66003,110663,182308,36.2041161111964%,60.7011211795423%,98689,129584,244163,40.4193100510724%,53.0727423893055%,133366,164484,305292,43.6847346147295%,53.8775991509768%,0.626396703383786,0.567671165665672,0.552237703542051,176666,228273,297850
219,5,CALIFORNIA,KINGS,11041,16377,28335,38.965943179813%,57.7977766013764%,13617,18093,33915,40.1503759398496%,53.3480760725343%,18699,24072,43861,42.6324069218668%,54.8824696199357%,0.597308337588446,0.570577105014191,0.562811250613734,27418,31710,42771
220,5,CALIFORNIA,LAKE,10717,8699,20919,51.2309383813758%,41.5842057459726%,11496,10599,24496,46.9301110385369%,43.268288700196%,14941,13123,28812,51.8568651950576%,45.5469943079273%,0.448032550473836,0.479701289884589,0.467609749144812,19416,22095,28064
221,5,CALIFORNIA,LASSEN,2982,7080,10586,28.1692801813716%,66.8807859436992%,2224,7574,10524,21.1326491828202%,71.9688331432915%,2799,8970,11987,23.350296154167%,74.8310669892383%,0.703637447823494,0.773014901000204,0.762171807290339,10062,9798,11769
222,5,CALIFORNIA,LOS ANGELES,1710505,871930,2695154,63.4659466583357%,32.3517691382385%,2464364,769743,3434308,71.7572215421564%,22.4133362528929%,3028885,1145530,4264365,71.0278083606821%,26.8628506237154%,0.33763870145812,0.238007895224246,0.274416894343279,2582435,3234107,4174415
223,5,CALIFORNIA,MADERA,11650,20283,33395,34.8854618954933%,60.7366372211409%,17029,23357,43112,39.4994433104472%,54.1774911857488%,23168,29378,53732,43.1176952281694%,54.6750539715626%,0.635173644818839,0.578343980587332,0.559091082099494,31933,40386,52546
224,5,CALIFORNIA,MARIN,79135,34872,123155,64.2564248304982%,28.3155373310056%,108707,21771,139273,78.0531761360781%,15.6318884493046%,128288,24612,155830,82.3256112430212%,15.7941346338959%,0.30587595498522,0.166855715139717,0.160967952910399,114007,130478,152900
225,5,CALIFORNIA,MARIPOSA,2816,4727,8074,34.8773841961853%,58.5459499628437%,3122,5185,8877,35.1695392587586%,58.4093725357666%,4088,5950,10280,39.7665369649805%,57.8793774319066%,0.626673737239825,0.624172384735765,0.592747559274756,7543,8307,10038
226,5,CALIFORNIA,MENDOCINO,16634,12272,34410,48.3405986631793%,35.6640511479221%,22079,10888,37477,58.9134669263815%,29.052485524455%,28782,13267,43340,66.4097831102907%,30.6114443931703%,0.424548536635993,0.330269663602997,0.315512854051226,28906,32967,42049
227,5,CALIFORNIA,MERCED,22726,26102,50418,45.0751715657107%,51.7711928279583%,37317,28725,70789,52.7158174292616%,40.5783384424134%,48991,39397,90554,54.1014201470946%,43.5066369238245%,0.534570328500041,0.434950486054329,0.445727926867901,48828,66042,88388
228,5,CALIFORNIA,MODOC,945,2969,4107,23.009495982469%,72.291210129048%,877,2696,3788,23.1520591341077%,71.1721224920803%,1150,3109,4343,26.479392125259%,71.5864609716786%,0.75855901890649,0.754547998880493,0.729983564216952,3914,3573,4259
229,5,CALIFORNIA,MONO,1788,2296,4371,40.9059711736445%,52.5280256234271%,2773,2111,5276,52.5587566338135%,40.0113722517058%,4013,2513,6738,59.557732264767%,37.2959335114277%,0.562193927522037,0.432227682227682,0.385075084278272,4084,4884,6526
230,5,CALIFORNIA,MONTEREY,67618,43761,117534,57.5305868940051%,37.2326305579662%,89088,34895,133408,66.7786039817702%,26.1566023027105%,113953,46299,163923,69.5161752774168%,28.2443586317966%,0.392901713967624,0.281449876192704,0.288913710905324,111379,123983,160252
231,5,CALIFORNIA,NAPA,28097,20633,51724,54.3210115226974%,39.8905730415281%,39199,17411,61372,63.8711464511504%,28.3696148080558%,49817,20676,72150,69.046431046431%,28.6569646569647%,0.423414734249949,0.307560501678149,0.293305718298271,48730,56610,70493
232,5,CALIFORNIA,NEVADA,17670,25998,47479,37.2164535900082%,54.756839866046%,26053,23365,54935,47.4251388004005%,42.5320833712569%,36359,26779,64750,56.1528957528958%,41.357528957529%,0.595355866996428,0.472803431947873,0.424134435680573,43668,49418,63138
233,5,CALIFORNIA,ORANGE,391819,541299,970905,40.3560595526854%,55.752004573053%,609961,507148,1197521,50.9353071887675%,42.3498210052266%,814009,676498,1522113,53.4788810029216%,44.4446634382598%,0.580097050962472,0.453982556760352,0.453871065348905,933118,1117109,1490507
234,5,CALIFORNIA,PLACER,42449,69835,117799,36.0351106545896%,59.2831857655837%,73509,95138,182839,40.2042233877893%,52.0337564742752%,106869,122488,235084,45.4599207091933%,52.1039288084259%,0.621949698977593,0.56412506596619,0.534049538492394,112284,168647,229357
235,5,CALIFORNIA,PLUMAS,3458,6343,10401,33.2468031920008%,60.9845207191616%,3459,5420,9676,35.7482430756511%,56.0148821827201%,4561,6445,11260,40.50621669627%,57.2380106571936%,0.647178859300071,0.610429102376394,0.58558967835726,9801,8879,11006
236,5,CALIFORNIA,RIVERSIDE,202576,231955,451127,44.9044282430446%,51.4167850738262%,373695,333243,751391,49.7337604522812%,44.3501452639172%,528340,449144,997156,52.9846884539631%,45.0425008724813%,0.533805413192615,0.471389287320812,0.459489874003053,434531,706938,977484
237,5,CALIFORNIA,SACRAMENTO,212792,195619,431550,49.3087707102306%,45.3293940447225%,326023,189789,559330,58.2881304417785%,33.9314894606047%,440808,259405,718440,61.3562719224988%,36.1067034129503%,0.478975835616573,0.367942195993889,0.370465843964622,408411,515812,700213
238,5,CALIFORNIA,SAN BENITO,9131,7015,16831,54.2510843087161%,41.6790446200463%,12521,7841,21924,57.1109286626528%,35.7644590403211%,17628,10590,28830,61.1446409989594%,36.732570239334%,0.434472934472934,0.385080051075533,0.375292366574527,16146,20362,28218
239,5,CALIFORNIA,SAN BERNARDINO,214749,221757,454893,47.2086842400301%,48.7492663109786%,340833,271240,653983,52.116492324724%,41.4750842147273%,455859,366257,841130,54.1960220179996%,43.5434475051419%,0.508027381066927,0.443149755012882,0.445505257165655,436506,612073,822116
240,5,CALIFORNIA,SAN DIEGO,437666,475736,958634,45.6551718382615%,49.6264476327775%,735476,477766,1306400,56.2979179424372%,36.5711879975505%,964650,600094,1602143,60.2099812563548%,37.4557077614171%,0.520839674097495,0.39379282946024,0.383509379170011,913402,1213242,1564744
241,5,CALIFORNIA,SAN FRANCISCO,241578,51496,319786,75.5436448124683%,16.1032690611847%,345084,37688,405792,85.0396262124438%,9.28751675735352%,378156,56417,443553,85.2561024274439%,12.7193368098063%,0.175709888970021,0.098460702454725,0.12982168703532,293074,382772,434573
242,5,CALIFORNIA,SAN JOAQUIN,79776,81773,167239,47.7017920461137%,48.8958915085596%,121124,88936,224166,54.0331718458642%,39.6741700347064%,161137,121098,288492,55.8549283862291%,41.9762073125078%,0.506180787253403,0.42338379510616,0.429067975268836,161549,210060,282235
243,5,CALIFORNIA,SAN LUIS OBISPO,44526,56859,108886,40.8923093878001%,52.2188343772386%,67107,56164,135009,49.7055751838766%,41.6001896169885%,88310,67436,159714,55.2925854965751%,42.2229735652479%,0.560822606894511,0.455614053589246,0.43298704300592,101385,123271,155746
244,5,CALIFORNIA,SAN MATEO,166757,80296,259399,64.2859070389631%,30.9546297402843%,237882,57929,314384,75.6660644307598%,18.4261921726296%,291496,75584,374251,77.8878346350444%,20.1960716203831%,0.325015280122079,0.19583112189878,0.20590606952163,247053,295811,367080
245,5,CALIFORNIA,SANTA BARBARA,73411,71493,154974,47.3698813994606%,46.1322544426807%,107142,56365,176786,60.6054778093288%,31.8831807948593%,129963,65736,200339,64.8715427350641%,32.8123830107967%,0.493381825208414,0.344725302280636,0.335903607070041,144904,163507,195699
246,5,CALIFORNIA,SANTA CLARA,332490,188750,548129,60.6590784286181%,34.4353245312691%,511684,144826,703709,72.7124422168823%,20.5803819476517%,617967,214612,850741,72.6386761658366%,25.2264790341596%,0.362117258844294,0.220599838540159,0.257767731350418,521240,656510,832579
247,5,CALIFORNIA,SANTA CRUZ,66618,29627,108350,61.4840793724042%,27.343793262575%,95249,22438,128821,73.9390316796175%,17.4179675673997%,114246,26937,144837,78.879015721121%,18.59814826322%,0.307828978128734,0.19065827151682,0.190794925734685,96245,117687,141183
248,5,CALIFORNIA,SHASTA,20127,43278,66544,30.2461529213753%,65.0366674681414%,22301,51778,80053,27.857794211335%,64.6796497320525%,30000,60789,92930,32.2823630689766%,65.4137522866674%,0.682564466524722,0.69895651939146,0.669563493374748,63405,74079,90789
249,5,CALIFORNIA,SIERRA,540,1172,1847,29.2365998917163%,63.4542501353546%,601,1048,1830,32.8415300546448%,57.2677595628415%,730,1142,1931,37.8042465044019%,59.1403417918177%,0.684579439252336,0.635536688902365,0.610042735042735,1712,1649,1872
250,5,CALIFORNIA,SISKIYOU,6323,12198,19819,31.9037287451436%,61.5470003531964%,7234,11341,20492,35.3015811048214%,55.3435487019325%,9593,13290,23472,40.8699727334697%,56.620654396728%,0.658603747097889,0.610551816958277,0.580780492068348,18521,18575,22883
251,5,CALIFORNIA,SOLANO,75116,51604,131735,57.0205336470946%,39.1725813185562%,102360,51920,166113,61.620703978617%,31.2558318734837%,131639,69306,205877,63.940605312881%,33.6637895442424%,0.407228535353535,0.336530982628986,0.344900345865784,126720,154280,200945
252,5,CALIFORNIA,SONOMA,117295,63529,197006,59.5387957727176%,32.2472412007756%,160435,51408,231253,69.3763972791704%,22.2301980947274%,199938,61825,268317,74.5155916322857%,23.0417752136465%,0.351330575587311,0.242670279405031,0.236186932454167,180824,211843,261763
253,5,CALIFORNIA,STANISLAUS,56448,67188,128267,44.0082016418876%,52.3813607552995%,81647,78494,172146,47.4289266088088%,45.5973417912702%,105841,104145,214954,49.2389069289243%,48.4499009090317%,0.543433951276327,0.490155550421191,0.495961635537607,123636,160141,209986
254,5,CALIFORNIA,SUTTER,8416,17350,26564,31.6819756060834%,65.3139587411534%,13076,18176,33523,39.0060555439549%,54.2194910956657%,17367,24375,42644,40.725541694025%,57.1592721133102%,0.673368004346814,0.581594777934212,0.583944228834268,25766,31252,41742
255,5,CALIFORNIA,TEHAMA,6507,13270,20854,31.2026469742016%,63.6328761868227%,6809,15494,23908,28.4800066923206%,64.8067592437678%,8911,19141,28731,31.0152796630817%,66.6214193728029%,0.670981443090459,0.694704748240147,0.682339940111222,19777,22303,28052
256,5,CALIFORNIA,TRINITY,1932,3340,5797,33.3275832327066%,57.6160082801449%,2214,2812,5686,38.937741822019%,49.454801266268%,2851,3188,6259,45.5504074133248%,50.9346540980987%,0.633535660091047,0.559490648627139,0.527901970524921,5272,5026,6039
257,5,CALIFORNIA,TULARE,33006,54070,89818,36.7476452381483%,60.1995145739162%,47585,58299,112334,42.3602827282924%,51.8979115850945%,66105,77579,146885,45.0045954318004%,52.8161486877489%,0.620951812210023,0.550593101885082,0.539927897330252,87076,105884,143684
258,5,CALIFORNIA,TUOLUMNE,9359,13172,23727,39.4445146879083%,55.5148143465251%,9123,14551,25529,35.7358298405735%,56.9979239296486%,11978,17689,30408,39.3909497500658%,58.1721915285451%,0.584616750255204,0.614640533919067,0.59625172750868,22531,23674,29667
259,5,CALIFORNIA,VENTURA,133258,136173,282692,47.1389356614266%,48.17009324636%,194402,132323,351726,55.2708642522873%,37.6210459277961%,251388,162207,422825,59.4543842015018%,38.3626795955774%,0.505409548270244,0.404998087076287,0.392188010009792,269431,326725,413595
260,5,CALIFORNIA,YOLO,33747,23057,61436,54.9303340061202%,37.5301126375415%,54752,20739,82090,66.6975271043976%,25.2637349250822%,67598,27292,97294,69.4780767570457%,28.0510617304253%,0.405904513766636,0.274721489978938,0.287617241015913,56804,75491,94890
261,5,CALIFORNIA,YUBA,5546,9838,16127,34.3895330811682%,61.0032864140882%,7910,13170,22998,34.3942951561005%,57.2658492042786%,11230,17676,29796,37.6896227681568%,59.323399113975%,0.639495579823193,0.624762808349146,0.611499342697018,15384,21080,28906
263,6,COLORADO,ADAMS,54132,47561,107852,50.1910024848867%,44.0983940956125%,96558,80082,193665,49.8582603981101%,41.3507861513438%,134202,95657,236740,56.6875052800541%,40.4059305567289%,0.467691974865527,0.45336277173913,0.416155121182986,101693,176640,229859
264,6,COLORADO,ALAMOSA,2455,2857,5659,43.3822230075985%,50.4859515815515%,3189,3046,6939,45.9576307825335%,43.8968151030408%,3759,3813,7808,48.1429303278689%,48.8345286885246%,0.537838855421687,0.488532477947073,0.503565768621236,5312,6235,7572
265,6,COLORADO,ARAPAHOE,82614,97768,189942,43.4943298480589%,51.4725547798802%,159885,117053,303046,52.7593170673759%,38.6254891996595%,213607,127323,350183,60.998677834161%,36.3589894426628%,0.542005299863623,0.422668611747034,0.373457894582466,180382,276938,340930
266,6,COLORADO,ARCHULETA,1432,2988,4758,30.0966792770071%,62.7994955863808%,2500,4264,7339,34.0645864559204%,58.1005586592179%,3738,5189,9144,40.8792650918635%,56.7475940507437%,0.676018099547511,0.630396215257244,0.581270303573429,4420,6764,8927
267,6,COLORADO,BACA,531,1663,2278,23.3099209833187%,73.0026338893766%,283,1753,2153,13.144449605202%,81.421272642824%,317,1867,2225,14.247191011236%,83.9101123595506%,0.757976298997265,0.861001964636542,0.85485347985348,2194,2036,2184
268,6,COLORADO,BENT,783,1096,1963,39.8879266428935%,55.8329088130413%,590,1188,1927,30.6175402179554%,61.6502335236118%,732,1503,2274,32.1899736147757%,66.0949868073879%,0.583288983501863,0.668166479190101,0.67248322147651,1879,1778,2235
269,6,COLORADO,BOULDER,69983,50873,139626,50.1217538280836%,36.4351911535101%,132334,41396,188142,70.3372984235312%,22.0025300039332%,159089,42501,206111,77.1860793455953%,20.6204423829878%,0.420938968690011,0.238277787371208,0.210828910164195,120856,173730,201590
270,6,COLORADO,BROOMFIELD,0,0,0,0%,0%,19731,14367,37689,52.3521451882512%,38.1198758258378%,29077,16295,46632,62.3541773889175%,34.94381540573%,#DIV/0!,0.421344360373042,0.359142202239267,0,34098,45372
271,6,COLORADO,CHAFFEE,2768,4300,7610,36.3731931668857%,56.5045992115637%,4888,5391,11250,43.4488888888889%,47.92%,7160,6222,13718,52.1941974048695%,45.3564659571366%,0.608375778155065,0.524467360638194,0.464952921835301,7068,10279,13382
272,6,COLORADO,CHEYENNE,209,957,1212,17.2442244224422%,78.960396039604%,132,925,1102,11.978221415608%,83.9382940108893%,131,993,1136,11.5316901408451%,87.4119718309859%,0.820754716981132,0.87511825922422,0.883451957295374,1166,1057,1124
273,6,COLORADO,CLEAR CREEK,2188,2247,4924,44.4354183590577%,45.6336311941511%,2729,2575,5866,46.5223320831913%,43.8970337538357%,3604,2754,6548,55.0397067806964%,42.0586438607208%,0.506651634723788,0.485482654600302,0.433155080213904,4435,5304,6358
274,6,COLORADO,CONEJOS,1749,1772,3671,47.6436938163988%,48.2702260964315%,1771,1914,4022,44.0328194927897%,47.5882645450025%,1959,2286,4333,45.2111700900069%,52.7579044541888%,0.503266117580233,0.519402985074627,0.538515901060071,3521,3685,4245
275,6,COLORADO,COSTILLA,1054,504,1648,63.9563106796116%,30.5825242718447%,1125,588,1848,60.8766233766234%,31.8181818181818%,1311,741,2094,62.6074498567335%,35.3868194842407%,0.323491655969191,0.343257443082312,0.361111111111111,1558,1713,2052
276,6,COLORADO,CROWLEY,511,855,1445,35.363321799308%,59.1695501730104%,339,1079,1527,22.2003929273084%,70.6614276358874%,437,1271,1750,24.9714285714286%,72.6285714285714%,0.625915080527086,0.760930888575458,0.744145199063232,1366,1418,1708
277,6,COLORADO,CUSTER,507,1451,2111,24.0170535291331%,68.7351965892942%,797,2061,3066,25.9947814742335%,67.2211350293542%,1112,2474,3635,30.5914718019257%,68.060522696011%,0.741062308478039,0.721133659902029,0.689905186837702,1958,2858,3586
278,6,COLORADO,DELTA,3264,8372,12686,25.7291502443639%,65.9940091439382%,4087,11655,16790,24.34187016081%,69.4163192376415%,5887,13081,19370,30.3923593185338%,67.5322663913268%,0.719491234101066,0.740376064032524,0.689635175031632,11636,15742,18968
279,6,COLORADO,DENVER,122693,61224,198347,61.8577543396169%,30.8671167196882%,244551,62690,331852,73.692790762147%,18.8909513879681%,313293,71618,393829,79.5505155790965%,18.1850498566637%,0.332889292452574,0.20404177827829,0.186063791369953,183917,307241,384911
280,6,COLORADO,DOLORES,293,741,1134,25.8377425044092%,65.3439153439153%,242,944,1255,19.2828685258964%,75.2191235059761%,341,1089,1449,23.5334713595583%,75.1552795031056%,0.716634429400387,0.795952782462057,0.761538461538462,1034,1186,1430
281,6,COLORADO,DOUGLAS,27076,56007,86225,31.401565671209%,64.9544795592925%,68657,102573,187499,36.6172619587304%,54.7058917647561%,104653,121270,231605,45.1859847585328%,52.3607003303037%,0.674109023506614,0.599036383811248,0.53677580414566,83083,171230,225923
282,6,COLORADO,EAGLE,6772,7165,15188,44.5878324993416%,47.1754016328681%,14099,8990,25223,55.8973952345082%,35.6420727114142%,18588,9892,29140,63.7886067261496%,33.9464653397392%,0.514099160508,0.38936290008229,0.347331460674157,13937,23089,28480
283,6,COLORADO,EL PASO,61799,128294,200757,30.7829863964893%,63.9051191241152%,108010,179228,318967,33.8624371800218%,56.1901387917872%,161941,202828,378851,42.7453009230542%,53.5376704825908%,0.674901232554592,0.62397036603792,0.556045058653559,190093,287238,364769
284,6,COLORADO,ELBERT,2326,6151,8965,25.9453430005577%,68.6112660345789%,3134,11705,15978,19.6144698961072%,73.2569783452247%,4490,14027,18983,23.6527419269873%,73.8924300690091%,0.725610475404034,0.788799784352045,0.757520116649565,8477,14839,18517
285,6,COLORADO,FREMONT,5293,9914,16056,32.9658694569008%,61.7463876432486%,5297,15122,21973,24.1068584171483%,68.8208255586402%,7369,17517,25557,28.833587666784%,68.5409085573424%,0.651936608140988,0.740584749498017,0.70388973720164,15207,20419,24886
286,6,COLORADO,GARFIELD,6087,9103,17104,35.5881665107577%,53.2214686623012%,11271,13132,26470,42.580279561768%,49.6108802417831%,15427,14717,30904,49.919104323065%,47.6216670981103%,0.599275839368005,0.538130557718313,0.488223195329087,15190,24403,30144
287,6,COLORADO,GILPIN,1099,1006,2465,44.5841784989858%,40.8113590263692%,1634,1566,3576,45.6935123042506%,43.7919463087248%,2223,1833,4186,53.1055900621118%,43.7888198757764%,0.47790973871734,0.489375,0.451923076923077,2105,3200,4056
288,6,COLORADO,GRAND,2308,3570,6353,36.3292932472847%,56.1939241303321%,3358,4494,8588,39.1010712622264%,52.3288309268747%,4710,4883,9870,47.7203647416413%,49.4731509625127%,0.607349438584553,0.572338257768721,0.509016991556343,5878,7852,9593
289,6,COLORADO,GUNNISON,3059,3128,7236,42.2747374239912%,43.2283029297955%,5128,3289,9412,54.4836379090523%,34.9447513812155%,7132,3735,11190,63.7354781054513%,33.3780160857909%,0.505576208178439,0.390756801710823,0.343701113462777,6187,8417,10867
290,6,COLORADO,HINSDALE,188,316,566,33.2155477031802%,55.8303886925795%,197,339,589,33.446519524618%,57.5551782682513%,255,353,632,40.3481012658228%,55.8544303797468%,0.626984126984127,0.632462686567164,0.580592105263158,504,536,608
291,6,COLORADO,HUERFANO,1495,1466,3174,47.1014492753623%,46.1877756773787%,1633,1883,3783,43.1667988369019%,49.7753106000529%,2076,2203,4406,47.1175669541534%,50%,0.495103005741304,0.535551763367463,0.514839915868194,2961,3516,4279
292,6,COLORADO,JACKSON,173,682,925,18.7027027027027%,73.7297297297297%,171,629,861,19.8606271777003%,73.054587688734%,175,681,876,19.9771689497717%,77.7397260273973%,0.79766081871345,0.78625,0.795560747663551,855,800,856
293,6,COLORADO,JEFFERSON,100970,120138,235491,42.8763731947293%,51.0159623934673%,160776,138177,328882,48.8856185501183%,42.0141570532896%,218396,148417,377358,57.8750152375198%,39.330556129723%,0.54334533350218,0.462203088779842,0.404612159329141,221108,298953,366813
294,6,COLORADO,KIOWA,211,728,968,21.797520661157%,75.2066115702479%,91,728,855,10.6432748538012%,85.1461988304094%,98,795,903,10.8527131782946%,88.0398671096346%,0.775292864749734,0.888888888888889,0.890257558790593,939,819,893
295,6,COLORADO,KIT CARSON,809,2542,3458,23.395026026605%,73.5106998264893%,536,2967,3702,14.4786601836845%,80.1458670988655%,662,3144,3871,17.1015241539654%,81.2193231723069%,0.758579528498956,0.846988295746503,0.826064109301104,3351,3503,3806
296,6,COLORADO,LA PLATA,7864,9993,20490,38.3796974133724%,48.7701317715959%,15525,12587,31150,49.8394863563403%,40.4077046548957%,20548,14233,35667,57.6106765357333%,39.9052345305184%,0.559612476899815,0.447744735344337,0.40921767631753,17857,28112,34781
297,6,COLORADO,LAKE,1296,1056,2628,49.3150684931507%,40.1826484018265%,1616,1270,3199,50.5157861831822%,39.699906220694%,2303,1497,3961,58.1418833627872%,37.7934864933098%,0.448979591836735,0.44005544005544,0.393947368421053,2352,2886,3800
298,6,COLORADO,LARIMER,46055,62429,118537,38.8528476340721%,52.6662561056885%,93113,83430,195980,47.5114807633432%,42.5706704765793%,126120,91489,224338,56.2187413634783%,40.7817667983133%,0.575467350023967,0.472576086279263,0.420428383017247,108484,176543,217609
299,6,COLORADO,LAS ANIMAS,3243,2569,6094,53.216278306531%,42.1562192320315%,2650,3710,6793,39.0107463565435%,54.6150448991609%,3497,4284,7961,43.9266423816104%,53.8123351337772%,0.442016517549897,0.583333333333333,0.550571905924688,5812,6360,7781
300,6,COLORADO,LINCOLN,510,1630,2199,23.1923601637108%,74.1246020918599%,409,1892,2436,16.7898193760263%,77.6683087027915%,470,2135,2651,17.729158807997%,80.5356469256884%,0.761682242990654,0.822251195132551,0.81957773512476,2140,2301,2605
301,6,COLORADO,LOGAN,2296,5531,8096,28.3596837944664%,68.3176877470356%,1851,7282,9722,19.0392923266818%,74.9022834807653%,2218,8087,10532,21.0596278009875%,76.7850360805165%,0.706656445636898,0.797328369648527,0.784764677341097,7827,9133,10305
302,6,COLORADO,MESA,15465,32396,51054,30.2914561053003%,63.4543816351314%,21729,49779,77653,27.982177121296%,64.1044132229276%,31536,56894,90623,34.7991128080068%,62.7809717179965%,0.676876789034914,0.696131901325726,0.643378943797354,47861,71508,88430
303,6,COLORADO,MINERAL,168,294,486,34.5679012345679%,60.4938271604938%,237,344,652,36.3496932515337%,52.760736196319%,317,427,756,41.9312169312169%,56.4814814814815%,0.636363636363636,0.592082616179002,0.573924731182796,462,581,744
304,6,COLORADO,MOFFAT,1223,3840,5337,22.9154955967772%,71.9505340078696%,874,5305,6525,13.3946360153257%,81.3026819923372%,1203,5670,7026,17.1221178479932%,80.7002561912895%,0.758443610507604,0.858553163942385,0.824967263203841,5063,6179,6873
305,6,COLORADO,MONTEZUMA,2556,6158,9384,27.2378516624041%,65.6223358908781%,3973,7853,12858,30.8990511743662%,61.0748172344066%,5836,9306,15500,37.6516129032258%,60.0387096774194%,0.706678907505164,0.664045323862675,0.614581957469291,8714,11826,15142
306,6,COLORADO,MONTROSE,4041,9266,14215,28.4277172001407%,65.1846640872318%,5466,14382,21186,25.8000566411781%,67.8844519966015%,7687,16770,24922,30.8442340101115%,67.289944627237%,0.696325242353648,0.724607013301088,0.685693257554074,13307,19848,24457
307,6,COLORADO,MORGAN,2885,5722,8998,32.0626805956879%,63.5919093131807%,3151,8145,11960,26.3461538461538%,68.1020066889632%,3876,9593,13744,28.2013969732247%,69.7977299185099%,0.664807714650866,0.721051699716714,0.712228079293192,8607,11296,13469
308,6,COLORADO,OTERO,2963,4082,7312,40.5224288840263%,55.8260393873085%,2943,4928,8452,34.8201609086607%,58.3057264552769%,3605,5756,9576,37.6461988304094%,60.108604845447%,0.579418026969482,0.626095794689366,0.614891571413311,7045,7871,9361
309,6,COLORADO,OURAY,705,1279,2233,31.5718763994626%,57.2772055530676%,1697,1351,3310,51.2688821752266%,40.8157099697885%,2365,1577,4020,58.8308457711443%,39.228855721393%,0.644657258064516,0.443241469816273,0.400050735667174,1984,3048,3942
310,6,COLORADO,PARK,2393,3677,6665,35.9039759939985%,55.1687921980495%,3421,6135,10417,32.8405491024287%,58.8941153883076%,4903,6991,12291,39.8909771377431%,56.8790171670328%,0.605766062602965,0.642005023022185,0.58777534891542,6070,9556,11894
311,6,COLORADO,PHILLIPS,564,1573,2220,25.4054054054054%,70.8558558558559%,436,1791,2332,18.696397941681%,76.8010291595197%,486,1958,2485,19.5573440643863%,78.7927565392354%,0.736078614880674,0.804220925011226,0.801145662847791,2137,2227,2444
312,6,COLORADO,PITKIN,4137,2565,7800,53.0384615384615%,32.8846153846154%,7333,2550,10523,69.6854509170389%,24.232633279483%,8989,2780,11957,75.1777201639207%,23.2499790917454%,0.38272157564906,0.258018820196297,0.236213781969581,6702,9883,11769
313,6,COLORADO,PROWERS,1361,3026,4524,30.0839964633068%,66.8877099911583%,1186,3531,5016,23.6443381180223%,70.3947368421053%,1458,4008,5561,26.2183060600611%,72.0733680992627%,0.689765215409163,0.748569005723977,0.733260153677278,4387,4717,5466
314,6,COLORADO,PUEBLO,28888,22827,53946,53.5498461424387%,42.3145367589812%,35875,36265,78646,45.6157973704956%,46.1116903593317%,43772,42252,88301,49.5713525328139%,47.8499677240348%,0.441399980663251,0.502703077349598,0.49116525620757,51715,72140,86024
315,6,COLORADO,RIO BLANCO,543,2185,2855,19.0192644483363%,76.5323992994746%,436,2791,3450,12.6376811594203%,80.8985507246377%,561,3061,3691,15.1991330262801%,82.9314548902736%,0.800953079178886,0.86488999070344,0.845113197128658,2728,3227,3622
316,6,COLORADO,RIO GRANDE,1707,3111,5075,33.6354679802956%,61.3004926108374%,2001,3085,5534,36.1582941814239%,55.7462956270329%,2495,3660,6305,39.5717684377478%,58.0491673275179%,0.645703611457036,0.606567046795124,0.59463850528026,4818,5086,6155
317,6,COLORADO,ROUTT,4208,4472,9638,43.6605104793526%,46.3996679809089%,7600,5230,13986,54.3400543400543%,37.3945373945374%,10582,5925,16876,62.704432329936%,35.1090305759659%,0.515207373271889,0.407638347622759,0.358938632095475,8680,12830,16507
318,6,COLORADO,SAGUACHE,1145,1078,2529,45.2748121787268%,42.6255436931594%,1417,1147,2835,49.9823633156966%,40.4585537918871%,1884,1413,3389,55.591619946887%,41.6937149601652%,0.484930274403959,0.447347893915757,0.428571428571429,2223,2564,3297
319,6,COLORADO,SAN JUAN,149,210,436,34.1743119266055%,48.1651376146789%,265,215,506,52.3715415019763%,42.4901185770751%,342,202,562,60.8540925266904%,35.9430604982206%,0.584958217270195,0.447916666666667,0.371323529411765,359,480,544
320,6,COLORADO,SAN MIGUEL,1598,1043,3255,49.0937019969278%,32.0430107526882%,2975,1033,4329,68.7225687225687%,23.8623238623239%,3924,1136,5147,76.2385855838352%,22.0711093841072%,0.394926164331692,0.257734530938124,0.224505928853755,2641,4008,5060
321,6,COLORADO,SEDGWICK,384,877,1303,29.4704528012279%,67.3062164236378%,267,1015,1364,19.574780058651%,74.4134897360704%,301,1121,1446,20.8160442600277%,77.5242047026279%,0.695479777954005,0.791731669266771,0.788326300984529,1261,1282,1422
322,6,COLORADO,SUMMIT,5304,4497,11068,47.9219371160101%,40.6306469100108%,9557,5100,16174,59.0886608136515%,31.5320885371584%,12631,5322,18479,68.3532658693652%,28.8002597543157%,0.458830731558004,0.347956607764208,0.296440706288643,9801,14657,17953
323,6,COLORADO,TELLER,2750,6477,9847,27.9272874987306%,65.7763785924647%,3603,9745,14444,24.9446136804209%,67.4674605372473%,5278,11241,16939,31.1588641596316%,66.3616506287266%,0.70196163433402,0.730071920887024,0.680489133724802,9227,13348,16519
324,6,COLORADO,WASHINGTON,477,1878,2445,19.5092024539877%,76.8098159509202%,296,2299,2733,10.8305890962313%,84.1200146359312%,369,2595,3008,12.2672872340426%,86.2699468085106%,0.797452229299363,0.885934489402697,0.875506072874494,2355,2595,2964
325,6,COLORADO,WELD,23436,37409,64541,36.3118018004059%,57.9616058009637%,46519,76651,135428,34.3496175089346%,56.5990784771244%,66060,96145,166974,39.5630457436487%,57.5808209661385%,0.614824554195086,0.622318746447999,0.592737585154588,60845,123170,162205
326,6,COLORADO,YUMA,1082,3156,4358,24.8279027076641%,72.418540614961%,726,3850,4791,15.1534126487163%,80.3590064704655%,785,4107,4981,15.7598875727766%,82.4533226259787%,0.744690891930156,0.841346153846154,0.839533932951758,4238,4576,4892
328,7,CONNECTICUT,FAIRFIELD,193769,159659,370289,52.329126709138%,43.1174028934157%,243852,160077,421209,57.8933498571968%,38.0041736999922%,297505,168445,472396,62.9778829625992%,35.6575838914809%,0.451744061025159,0.3962998447747,0.361508745573559,353428,403929,465950
329,7,CONNECTICUT,HARTFORD,221167,127468,367556,60.1723274820708%,34.6798855140441%,240403,148173,406864,59.0868201659523%,36.4183117700263%,283368,159024,449336,63.0637206900849%,35.3908878879057%,0.365620204511882,0.381323087375443,0.359464004774047,348635,388576,442392
330,7,CONNECTICUT,LITCHFIELD,41806,39172,87338,47.8669078751517%,44.8510384941263%,39775,53051,97442,40.8191539582521%,54.4436690544119%,50164,55601,107544,46.6450941010191%,51.7006992486796%,0.483736323445874,0.57151013724603,0.52570320994658,80978,92826,105765
331,7,CONNECTICUT,MIDDLESEX,43319,29295,77433,55.9438482300828%,37.8327069853938%,45357,38867,88624,51.1791388337245%,43.8560660769092%,56848,40665,99198,57.3076070082058%,40.9937700356862%,0.403434599388548,0.461471789513678,0.417021320234225,72614,84224,97513
332,7,CONNECTICUT,NEW HAVEN,197928,122919,341099,58.0265553402385%,36.0361654534314%,205609,159048,379006,54.2495369466446%,41.964507158198%,242630,169893,417983,58.0478153417723%,40.6459114365895%,0.383107836445409,0.4361578140554,0.411838855045658,320847,364657,412523
333,7,CONNECTICUT,NEW LONDON,60449,41168,109147,55.383107185722%,37.7179400258367%,62278,54058,123528,50.4160999935237%,43.7617382293893%,79459,57110,139604,56.9174235695252%,40.9085699550156%,0.405129063050474,0.464671296933022,0.418176892266913,101617,116336,136569
334,7,CONNECTICUT,TOLLAND,33554,24705,62700,53.5151515151515%,39.4019138755981%,38506,34194,77424,49.7339326307088%,44.1646001239926%,44151,34838,80714,54.7005476125579%,43.1622766806254%,0.424054652500043,0.470343878954608,0.441048753623922,58259,72700,78989
335,7,CONNECTICUT,WINDHAM,24023,16708,43963,54.6436776380138%,38.0046857584787%,21792,25747,50823,42.8782244259489%,50.6601341912126%,26706,29141,57082,46.7853263725868%,51.051119442206%,0.410203530480469,0.541597425271882,0.521800633874693,40731,47539,55847
337,8,DELAWARE,KENT,22790,24081,48247,47.2360975811968%,49.911911621448%,33351,36991,74598,44.7076329124105%,49.5871202981313%,44552,41009,87025,51.1944843435794%,47.1232404481471%,0.513771841863839,0.525873589036422,0.479295473404939,46871,70342,85561
338,8,DELAWARE,NEW CASTLE,127539,78587,212995,59.8788703960187%,36.8961712716261%,162919,85525,262391,62.0901631534618%,32.5944868535887%,195034,88364,287633,67.8065451460716%,30.7210925032941%,0.381257095174796,0.344242565729098,0.311801777006189,206126,248444,283398
339,8,DELAWARE,SUSSEX,29739,34620,66287,44.8640004827493%,52.2274352437129%,39333,62611,106008,37.1038034865293%,59.0625235831258%,56682,71230,129352,43.8199641288886%,55.0667944832705%,0.537920104414301,0.614170524994114,0.556867221214585,64359,101944,127912
341,51,DISTRICT OF COLUMBIA,DISTRICT OF COLUMBIA,171923,18073,201894,85.1550813793377%,8.95172714394682%,282830,12723,311268,90.8638215299999%,4.08747445930838%,317323,18586,344356,92.1496939214069%,5.3973213767148%,0.0951230552222152,0.0430481165814592,0.0553304615238056,189996,295553,335909
343,9,FLORIDA,ALACHUA,47365,34124,85729,55.2496821378997%,39.804500227461%,75820,46834,128571,58.9713076821367%,36.4265658663307%,89704,50972,142604,62.9042663599899%,35.7437379035651%,0.418755905705064,0.381838342002707,0.362336148312434,81489,122654,140676
344,9,FLORIDA,BAKER,2392,5610,8154,29.3352955604611%,68.8005886681384%,2112,10294,12634,16.7167959474434%,81.478549944594%,2037,11911,14059,14.488939469379%,84.7215306920834%,0.701074731317171,0.829759793648235,0.853957556638945,8002,12406,13948
345,9,FLORIDA,BAY,18850,38637,58805,32.055097355667%,65.7035966329394%,21797,62194,87453,24.9242450230409%,71.1170571621328%,25614,66097,93024,27.5348297213622%,71.0537065703474%,0.672099779080488,0.74048409948685,0.720709620438115,57487,83991,91711
346,9,FLORIDA,BRADFORD,3075,5414,8673,35.4548599100657%,62.4236135132019%,2924,8913,12098,24.1692841792032%,73.6733344354439%,3160,10334,13632,23.1807511737089%,75.8069248826291%,0.63776652138061,0.752977950494213,0.765821846746702,8489,11837,13494
347,9,FLORIDA,BREVARD,97318,115185,218395,44.5605439684975%,52.7415920694155%,119679,181848,314752,38.0232691134608%,57.7750101667344%,148549,207883,360764,41.176226009247%,57.6229889900323%,0.542039406502497,0.603090270523038,0.583233267495623,212503,301527,356432
348,9,FLORIDA,BROWARD,387703,177902,575143,67.4098441604957%,30.9317856602619%,553320,260951,831951,66.5087246724867%,31.3661501699018%,618752,333409,957672,64.6100126139221%,34.8145294004628%,0.314533994572184,0.320471931334899,0.350160319525794,565605,814271,952161
349,9,FLORIDA,CALHOUN,2155,2873,5174,41.6505604947816%,55.5276381909548%,1241,4655,6081,20.4078276599244%,76.5499095543496%,1209,5274,6526,18.5258964143426%,80.8152007355195%,0.57140015910899,0.789518317503392,0.813512262841277,5028,5896,6483
350,9,FLORIDA,CHARLOTTE,29645,35426,66896,44.3150562066491%,52.9568285099259%,33445,60218,96374,34.7033432253512%,62.4836574179758%,42273,73243,116340,36.3357400722022%,62.9559910606842%,0.544420709686343,0.642921964916776,0.634050694276118,65071,93663,115516
351,9,FLORIDA,CITRUS,25525,29767,57206,44.6194455127085%,52.0347515994826%,22789,54456,79700,28.5934755332497%,68.3262233375157%,27092,65352,93208,29.0661745772895%,70.114153291563%,0.538359979743905,0.704977668457505,0.706936091038899,55292,77245,92444
352,9,FLORIDA,CLAY,14632,41736,57353,25.5121789618677%,72.7703869021673%,27822,74963,106483,26.1281143468911%,70.3990308312125%,38317,84480,124405,30.8002089948153%,67.907238455046%,0.740420096508657,0.729318480323004,0.687964689691116,56368,102785,122797
353,9,FLORIDA,COLLIER,29921,60450,92162,32.465658297346%,65.5910245003364%,61085,105423,170789,35.766354976023%,61.7270433107519%,77621,128950,207818,37.350470122896%,62.049485607599%,0.668909273992763,0.633140749993994,0.62424057587948,90371,166508,206571
354,9,FLORIDA,COLUMBIA,7047,10964,18508,38.0754268424465%,59.2392478928031%,7601,20368,28707,26.4778625422371%,70.9513359111018%,8914,23836,33042,26.9777858483143%,72.1384904061497%,0.608739103880962,0.728234831420501,0.72781679389313,18011,27969,32750
355,9,FLORIDA,DESOTO,3320,4256,7817,42.4715363950365%,54.4454394268901%,3781,6778,10818,34.9510075799593%,62.6548345350342%,4259,8313,12659,33.6440477130895%,65.6686942096532%,0.561774023231257,0.641916848186381,0.661231307667833,7576,10559,12572
356,9,FLORIDA,DIXIE,1826,2697,4666,39.1341620231462%,57.8011144449207%,1270,5822,7202,17.6339905581783%,80.8386559289086%,1365,6759,8167,16.7136035263867%,82.7598873515367%,0.596285651116516,0.820924985899605,0.831979320531758,4523,7092,8124
357,9,FLORIDA,DUVAL,107864,152098,264636,40.7593826992548%,57.4744176907148%,205704,211672,432695,47.5401841944095%,48.9194467234426%,252556,233762,492820,51.2471084777404%,47.4335457164888%,0.585077819065863,0.50714942881239,0.480677252332836,259962,417376,486318
358,9,FLORIDA,ESCAMBIA,40943,73017,116648,35.0996159385502%,62.596015362458%,57461,88808,152469,37.6870052272921%,58.2465943896792%,70929,96674,170372,41.6318409128261%,56.7428920245111%,0.640724815724816,0.607155309737538,0.576803517836793,113960,146269,167603
359,9,FLORIDA,FLAGLER,13897,12613,27111,51.2596363099849%,46.52355132603%,22026,33850,57503,38.3040884823401%,58.8664939220562%,28161,43043,71716,39.267388030565%,60.0186848123153%,0.475782723500566,0.605805712649438,0.604502556036178,26510,55876,71204
360,9,FLORIDA,FRANKLIN,2046,2454,4644,44.0568475452196%,52.8423772609819%,1744,4125,6015,28.9941812136326%,68.5785536159601%,2120,4675,6849,30.9534238574974%,68.2581398744342%,0.545333333333333,0.702845459192367,0.688005886681383,4500,5869,6795
361,9,FLORIDA,GADSDEN,9735,4767,14727,66.1030759828886%,32.3691179466286%,15020,6728,22113,67.9238457016235%,30.4255415366527%,16153,7465,23762,67.9782846561737%,31.4157057486744%,0.328713280926769,0.309361780393599,0.316072487086121,14502,21748,23618
362,9,FLORIDA,GILCHRIST,1910,3300,5395,35.4031510658017%,61.1677479147359%,1458,6740,8420,17.3159144893112%,80.0475059382423%,1700,7895,9685,17.5529168817759%,81.5178110480124%,0.633397312859885,0.822151744327885,0.822824387701928,5210,8198,9595
363,9,FLORIDA,GLADES,1442,1841,3365,42.852897473997%,54.7102526002972%,1271,2996,4353,29.1982540776476%,68.8260969446359%,1385,3782,5193,26.6705180050067%,72.8288080107838%,0.560767590618337,0.70213264588704,0.731952777240178,3283,4267,5167
364,9,FLORIDA,GULF,2397,3550,6144,39.013671875%,57.7799479166667%,1720,5329,7293,23.5842588783765%,73.0700671877142%,1985,6113,8163,24.3170403038099%,74.8866838172241%,0.596939633428619,0.755993757979855,0.754877747591998,5947,7049,8098
365,9,FLORIDA,HAMILTON,1722,2146,3964,43.4409687184662%,54.1372351160444%,1904,3443,5460,34.8717948717949%,63.0586080586081%,1963,3815,5830,33.6706689536878%,65.4373927958834%,0.554808686659772,0.643912474284646,0.660263066805123,3868,5347,5778
366,9,FLORIDA,HARDEE,2339,3765,6233,37.526070912883%,60.4042996951709%,2149,5242,7583,28.3397072398787%,69.1283133324542%,2298,6122,8485,27.0830878020035%,72.1508544490277%,0.616808650065531,0.709240968745772,0.7270783847981,6104,7391,8420
367,9,FLORIDA,HENDRY,3240,4747,8139,39.8083302617029%,58.3241184420691%,4615,6195,11115,41.5204678362573%,55.7354925775979%,4929,7906,12940,38.0911901081917%,61.097372488408%,0.594340803806185,0.573080481036078,0.615971951694585,7987,10810,12835
368,9,FLORIDA,HERNANDO,32644,30646,65219,50.0528986951655%,46.9893742621015%,31795,58970,93796,33.898034031302%,62.8704848820845%,37519,70412,108922,34.4457501698463%,64.6444244505242%,0.484215515879286,0.649699774142015,0.652379761143694,63290,90765,107931
369,9,FLORIDA,HIGHLANDS,14167,20206,35149,40.305556345842%,57.4866994793593%,14937,29565,45686,32.6949174801909%,64.7134789651097%,16938,34873,52170,32.4669350201265%,66.8449300364194%,0.587845110988276,0.664352163947688,0.673081005963984,34373,44502,51811
370,9,FLORIDA,HILLSBOROUGH,169557,180760,360295,47.0606031168903%,50.1699995836745%,307896,266870,597660,51.5169159722919%,44.6524779975237%,376367,327398,712063,52.8558568553625%,45.9787968199443%,0.515989803520811,0.464310693395225,0.465209267298033,350317,574766,703765
371,9,FLORIDA,HOLMES,2177,5011,7395,29.4388100067613%,67.7620013522651%,853,7483,8514,10.0187925769321%,87.8905332393705%,924,8080,9068,10.1896779885311%,89.1045434494927%,0.697134112409571,0.897672744721689,0.897378942692137,7188,8336,9004
372,9,FLORIDA,INDIAN RIVER,19768,28635,49622,39.837168997622%,57.7062593204627%,29043,48620,80009,36.2996662875427%,60.7681635815971%,37844,58872,97484,38.8207295556194%,60.3914488531451%,0.591595562258538,0.626038139139616,0.608710037635965,48403,77663,96716
373,9,FLORIDA,JACKSON,6868,9138,16300,42.1349693251534%,56.0613496932515%,6397,14257,21041,30.4025474074426%,67.7581863979849%,6766,15488,22419,30.1797582407779%,69.0842588875507%,0.570910908409346,0.69027791226881,0.695964770378359,16006,20654,22254
374,9,FLORIDA,JEFFERSON,3041,2478,5644,53.880226789511%,43.905031892275%,3541,3930,7645,46.3178548070634%,51.4061478090255%,3897,4479,8451,46.1128860489883%,52.9996450124246%,0.448994383040406,0.526033998126088,0.53474212034384,5519,7471,8376
375,9,FLORIDA,LAFAYETTE,789,1670,2505,31.4970059880239%,66.6666666666667%,518,2809,3392,15.2712264150943%,82.8125%,510,3128,3658,13.9420448332422%,85.5112083105522%,0.679137860919073,0.844304177938082,0.85981308411215,2459,3327,3638
376,9,FLORIDA,LAKE,36571,50010,88611,41.2713997133539%,56.4376883231201%,62838,102188,170462,36.863347842921%,59.9476716218277%,83505,125859,211314,39.5170220619552%,59.5601805843437%,0.577609406220764,0.619223637487426,0.601149194703961,86581,165026,209364
377,9,FLORIDA,LEE,73560,106141,184377,39.8965163767715%,57.5673755403331%,124908,191551,326420,38.2660376202439%,58.6823724036517%,157695,233247,393899,40.034374293918%,59.2149256535305%,0.59065336308646,0.605294840721863,0.596628144328315,179701,316459,390942
378,9,FLORIDA,LEON,61427,39062,103124,59.5661533687599%,37.8786703386215%,92068,53821,152132,60.5184970946284%,35.3778297794021%,103517,57453,162929,63.535036733792%,35.2625990462103%,0.388719163291504,0.36891746464778,0.356917438031931,100489,145889,160970
379,9,FLORIDA,LEVY,5398,6858,12724,42.4237661112858%,53.8981452373468%,5101,13775,19395,26.3005929363238%,71.0234596545502%,6205,16749,23145,26.8092460574638%,72.3655217109527%,0.559562663185379,0.729762661580843,0.729676744793936,12256,18876,22954
380,9,FLORIDA,LIBERTY,1017,1317,2410,42.1991701244813%,54.6473029045643%,651,2543,3296,19.751213592233%,77.1541262135922%,694,2846,3561,19.4889076102218%,79.9213704015726%,0.56426735218509,0.796180338134001,0.803954802259887,2334,3194,3540
381,9,FLORIDA,MADISON,3014,3038,6162,48.9126906848426%,49.3021746186303%,3526,4851,8505,41.4579659024104%,57.037037037037%,3747,5576,9380,39.9466950959488%,59.4456289978678%,0.501982815598149,0.579085591500537,0.598090743322965,6052,8377,9323
382,9,FLORIDA,MANATEE,49177,57952,110221,44.6167245806153%,52.5780023770425%,71224,101944,178958,39.7992825132154%,56.9653214720772%,90166,124987,216958,41.5591957890467%,57.608845951751%,0.540955296885064,0.588699990760418,0.580921483781309,107129,173168,215153
383,9,FLORIDA,MARION,44665,55141,102956,43.3826100470104%,53.5578305295466%,62041,107833,174700,35.5128792215226%,61.7246708643389%,74858,127826,204376,36.6275883665401%,62.5445257760207%,0.552481814720558,0.634782250373806,0.630666456158355,99806,169874,202684
384,9,FLORIDA,MARTIN,26620,33970,62013,42.9264831567575%,54.7788366955316%,30185,53204,85792,35.183933233868%,62.015106303618%,36893,61168,98726,37.3690821060308%,61.9573364665843%,0.560653573196897,0.63802180143664,0.623774997195623,60590,83389,98061
385,9,FLORIDA,MIAMI-DADE,328808,289533,625449,52.57151262533%,46.2920238100948%,624146,333999,980204,63.6751125275963%,34.0744375660577%,617864,532833,1156816,53.4107412068989%,46.0603069113844%,0.468241633661685,0.348589201008198,0.463052393462397,618341,958145,1150697
386,9,FLORIDA,MONROE,16483,16059,33896,48.6281567146566%,47.3772716544725%,18971,21904,42478,44.6607655727671%,51.5655162672442%,21881,25693,48029,45.5578921068521%,53.4947635803369%,0.493485342019544,0.535877675840979,0.540063900449826,32542,40875,47574
387,9,FLORIDA,NASSAU,6952,16404,23780,29.2346509671993%,68.9823380992431%,10869,34266,46607,23.3205312506705%,73.5211448923981%,15564,42566,58811,26.464436925065%,72.3776164323001%,0.702346292173317,0.759189099368561,0.732255289867538,23356,45135,58130
388,9,FLORIDA,OKALOOSA,16948,52093,70680,23.9784946236559%,73.7026032823996%,23780,71893,100855,23.5784046403252%,71.2835258539487%,34248,79798,116373,29.4295068443711%,68.5708884363211%,0.754522674932287,0.751445026287458,0.699700121003805,69041,95673,114046
389,9,FLORIDA,OKEECHOBEE,4588,5057,9853,46.5644981223993%,51.3244697046585%,3959,9356,13653,28.9972899728997%,68.5270636490149%,4390,11470,15954,27.5166102544816%,71.8941958129623%,0.52431311560394,0.70266616597822,0.723203026481715,9645,13315,15860
390,9,FLORIDA,ORANGE,140220,134517,280125,50.0562248995984%,48.0203480589023%,329894,195216,546275,60.3897304471191%,35.7358473296417%,395014,245398,647403,61.0151636615833%,37.904983449258%,0.489620982976447,0.371762106987107,0.383187697919464,274737,525110,640412
391,9,FLORIDA,OSCEOLA,28181,26212,55659,50.6315241021219%,47.093911137462%,85458,50301,140206,60.9517424361297%,35.8764960130094%,97297,73480,172436,56.424992460971%,42.6129114570043%,0.481900244516758,0.370516871809604,0.430268712999994,54393,135759,170777
392,9,FLORIDA,PALM BEACH,269732,152951,433186,62.2670169396056%,35.3083894678037%,374673,272402,662332,56.5687600780273%,41.1277123859333%,433572,334711,773158,56.0780590771873%,43.2914100352063%,0.361857467653064,0.420974384731291,0.435661078014221,422683,647075,768283
393,9,FLORIDA,PASCO,69564,68582,142731,48.7378355087542%,48.0498279981223%,90142,142101,241139,37.3817590684211%,58.9290823964601%,119073,179621,301970,39.4320627876941%,59.4830612312481%,0.496445789237473,0.611863436142316,0.601354563533248,138146,232243,298694
394,9,FLORIDA,PINELLAS,200630,184825,398472,50.3498363749523%,46.3834347206328%,233701,239201,492403,47.461327408647%,48.5782986699919%,277450,276209,559715,49.5698703804615%,49.3481503979704%,0.479498255308661,0.505815158320329,0.498879274065806,385455,472902,553659
395,9,FLORIDA,POLK,75200,90295,168607,44.6007579756475%,53.5535298059986%,117433,157430,284314,41.3039808099496%,55.3718775719803%,145049,194586,343256,42.2567995898105%,56.6883026079661%,0.545605607420164,0.572758064926891,0.572926818496327,165495,274863,339635
396,9,FLORIDA,PUTNAM,12102,13447,26222,46.1520860346274%,51.281366791244%,10094,22138,33117,30.4798139928134%,66.8478424978108%,10527,25514,36373,28.9417974871471%,70.1454375498309%,0.52632196954871,0.686832961032514,0.707915984573125,25549,32232,36041
397,9,FLORIDA,SANTA ROSA,12802,36274,50319,25.4416820684036%,72.0880780619647%,18464,65339,87745,21.0427944612229%,74.464641859935%,27612,77385,106928,25.8229836899596%,72.3711282358222%,0.739139294156003,0.779673758695989,0.737021057744507,49076,83803,104997
398,9,FLORIDA,SARASOTA,72853,83100,160942,45.2666177877745%,51.6335077232792%,97870,124438,229063,42.7262368867953%,54.3247927426079%,120110,148370,270575,44.3906495426407%,54.8350734546799%,0.53285284669099,0.559754934595246,0.552629618593564,155953,222308,268480
399,9,FLORIDA,SEMINOLE,59174,75677,137634,42.9937370126568%,54.9842335469433%,105914,109443,224896,47.0946570859419%,48.6638268355151%,132528,125241,260815,50.8130283917719%,48.019093993827%,0.561189757584297,0.508193371935902,0.485865251446062,134851,215357,257769
400,9,FLORIDA,ST. JOHNS,19502,39546,60746,32.1041714680802%,65.10058275442%,43099,88684,136514,31.5711209106758%,64.9633004673513%,63850,110946,176622,36.1506494094733%,62.8155042973129%,0.669726324346295,0.672954781724502,0.634717041579899,59048,131783,174796
401,9,FLORIDA,ST. LUCIE,41559,34705,77989,53.2882842452141%,44.4998653656285%,66881,70289,140847,47.4848594574254%,49.9045063082636%,84137,86831,172169,48.8688439846895%,50.4335856048418%,0.455063988251338,0.51242254137202,0.507878667352955,76264,137170,170968
402,9,FLORIDA,SUMTER,9637,12127,22261,43.2909572795472%,54.4764386146175%,22638,52730,76665,29.5284680101741%,68.779756081654%,29341,62761,92485,31.7251446180462%,67.8607341731092%,0.557204557985664,0.699633796836854,0.681429284923237,21764,75368,92102
403,9,FLORIDA,SUWANNEE,4075,8006,12473,32.6705684278041%,64.1866431492023%,3964,14287,18694,21.2046645982668%,76.4255910987483%,4485,16410,21057,21.2993303889443%,77.9313292491808%,0.662693485638606,0.782806421565942,0.785355348169419,12081,18251,20895
404,9,FLORIDA,TAYLOR,2649,4056,6808,38.9101057579318%,59.5769682726205%,2152,6930,9290,23.1646932185145%,74.5963401506997%,2299,7751,10127,22.7016885553471%,76.5379678088279%,0.604921700223714,0.763047786831094,0.771243781094527,6705,9082,10050
405,9,FLORIDA,UNION,1407,2332,3826,36.7746994249869%,60.9513852587559%,1014,4568,5694,17.8082191780822%,80.2247980330172%,1053,5133,6245,16.8614891913531%,82.1937550040032%,0.623696175447981,0.818344679326406,0.829776915615907,3739,5582,6186
406,9,FLORIDA,VOLUSIA,97304,82357,183654,52.9822383394862%,44.8435645289512%,109091,143007,260869,41.8183072729991%,54.8194687755157%,130575,173821,307439,42.4718399422324%,56.5383702132781%,0.458402213056813,0.567267491213734,0.571035756054613,179661,252098,304396
407,9,FLORIDA,WAKULLA,3838,4512,8587,44.695469896355%,52.5445440782578%,4348,10512,15351,28.3238876946127%,68.4776236075826%,5351,12874,18404,29.0752010432515%,69.9521843077592%,0.540359281437126,0.707402422611036,0.70639231824417,8350,14860,18225
408,9,FLORIDA,WALTON,5642,12182,18318,30.8003057102304%,66.502893328966%,6876,25756,33637,20.4417754258703%,76.5704432618842%,10338,32947,43711,23.6507972821487%,75.3746196609549%,0.683460502692998,0.789286589850454,0.761164375649763,17824,32632,43285
409,9,FLORIDA,WASHINGTON,2798,4994,8029,34.848673558351%,62.1995267156558%,2264,8637,11156,20.2940121907494%,77.4202223019003%,2347,9876,12327,19.0395067737487%,80.1168167437333%,0.640913757700205,0.792312631868636,0.807984946412501,7792,10901,12223
411,10,GEORGIA,APPLING,2093,3940,6099,34.3171011641253%,64.6007542220036%,1434,5494,7012,20.4506560182544%,78.3513976041072%,1779,6526,8341,21.328377892339%,78.2400191823522%,0.653074755511354,0.793013856812933,0.785791691751957,6033,6928,8305
412,10,GEORGIA,ATKINSON,821,1228,2071,39.6426846933848%,59.2950265572187%,697,1878,2610,26.7049808429119%,71.9540229885058%,825,2300,3155,26.148969889065%,72.9001584786054%,0.599316739873109,0.729320388349515,0.736,2049,2575,3125
413,10,GEORGIA,BACON,956,2010,2995,31.9198664440735%,67.1118530884808%,608,3364,4020,15.1243781094527%,83.681592039801%,625,4018,4668,13.3890317052271%,86.0754070265638%,0.677680377612947,0.846928499496475,0.865388757269007,2966,3972,4643
414,10,GEORGIA,BAKER,893,615,1519,58.788676761027%,40.4871626069783%,650,775,1440,45.1388888888889%,53.8194444444444%,652,897,1555,41.9292604501608%,57.6848874598071%,0.407824933687003,0.543859649122807,0.579083279535184,1508,1425,1549
415,10,GEORGIA,BALDWIN,5893,6041,12126,48.5980537687613%,49.8185716641927%,7970,7697,16116,49.4539587987094%,47.7599900719782%,9140,8903,18251,50.0794477014958%,48.7808887184264%,0.506200770906653,0.491287419416608,0.493432356038353,11934,15667,18043
416,10,GEORGIA,BANKS,1220,3202,4533,26.9137436576219%,70.6375468784469%,684,6134,6975,9.80645161290323%,87.9426523297491%,932,7795,8801,10.5897057152596%,88.5694807408249%,0.724106739032112,0.899677324728659,0.893204995989458,4422,6818,8727
417,10,GEORGIA,BARROW,3657,7925,12102,30.2181457610312%,65.4850437944141%,6580,21108,29060,22.6428079834824%,72.6359256710255%,10453,26804,37921,27.5652013396271%,70.6837899844413%,0.684251424624417,0.762351921409997,0.719435273908259,11582,27688,37257
418,10,GEORGIA,BARTOW,7508,14720,22781,32.9572889688776%,64.6152495500637%,8212,29911,39550,20.763590391909%,75.6283185840708%,12092,37674,50467,23.9602116234371%,74.6507618840034%,0.662227820766601,0.784591978595598,0.757022867017643,22228,38123,49766
419,10,GEORGIA,BEN HILL,2234,2381,4661,47.9296288350139%,51.0834584853036%,2101,3739,5936,35.394204851752%,62.9885444743935%,2392,4110,6560,36.4634146341463%,62.6524390243902%,0.515926327193933,0.640239726027397,0.632113195939711,4615,5840,6502
420,10,GEORGIA,BERRIEN,1640,2718,4410,37.18820861678%,61.6326530612245%,1047,5422,6590,15.8877086494689%,82.2761760242792%,1269,6419,7743,16.3889965129795%,82.9006844892161%,0.623680587425425,0.838151182562993,0.83493756503642,4358,6469,7688
421,10,GEORGIA,BIBB,24996,24071,49776,50.2169720347155%,48.3586467373835%,36787,24043,62596,58.7689309221036%,38.4098025432935%,43468,26585,70802,61.3937459393802%,37.5483743397079%,0.490574112947602,0.395249054742726,0.379498379798153,49067,60830,70053
422,10,GEORGIA,BLECKLEY,1273,2436,3749,33.9557215257402%,64.9773272872766%,1101,3719,4974,22.1351025331725%,74.7687977482911%,1311,4328,5706,22.9758149316509%,75.8499824745882%,0.656780803451065,0.771576763485477,0.767511970207484,3709,4820,5639
423,10,GEORGIA,BRANTLEY,1372,3118,4566,30.048182216382%,68.287341217696%,619,5567,6301,9.82383748611332%,88.3510553880337%,699,6991,7746,9.02401239349342%,90.2530338239091%,0.694432071269488,0.899935337859683,0.909102730819246,4490,6186,7690
424,10,GEORGIA,BROOKS,2096,2406,4551,46.0558119094704%,52.8675016479895%,2528,3701,6336,39.8989898989899%,58.4122474747475%,2790,4260,7100,39.2957746478873%,60%,0.534429142603287,0.594156365387703,0.604255319148936,4502,6229,7050
425,10,GEORGIA,BRYAN,2172,4835,7059,30.7692307692308%,68.4941209803088%,4014,10529,15173,26.4548869702761%,69.393000724972%,6739,14244,21340,31.5791940018744%,66.7478912839738%,0.690024261452833,0.723990923468335,0.678835247581375,7007,14543,20983
426,10,GEORGIA,BULLOCH,5561,8990,14782,37.6200784738195%,60.8172101204167%,9261,15097,25316,36.5816084689524%,59.6342234160215%,11243,18386,30084,37.372024996676%,61.1155431458583%,0.617826953473988,0.619796370802201,0.620540686489588,14551,24358,29629
427,10,GEORGIA,BURKE,3720,3381,7135,52.1373510861948%,47.3861247372109%,4731,4491,9351,50.5935194096888%,48.0269489894129%,5209,5400,10684,48.7551478846874%,50.5428678397604%,0.476130122517955,0.486987638256344,0.509001790932227,7101,9222,10609
428,10,GEORGIA,BUTTS,2281,3198,5635,40.4791481810115%,56.7524401064774%,2566,6717,9514,26.9707799033004%,70.6012192558335%,3274,8406,11771,27.8141194460963%,71.412794155127%,0.583683153860193,0.723580738985242,0.719691780821918,5479,9283,11680
429,10,GEORGIA,CALHOUN,1107,768,1887,58.664546899841%,40.6995230524642%,1179,830,2025,58.2222222222222%,40.9876543209877%,1260,923,2194,57.4293527803099%,42.0692798541477%,0.4096,0.413140866102539,0.422812643151626,1875,2009,2183
430,10,GEORGIA,CAMDEN,3636,6371,10119,35.9324043877854%,62.9607668741971%,5930,12310,18901,31.3740013755886%,65.1288291624782%,7967,15251,23688,33.6330631543397%,64.3828098615333%,0.636654341960628,0.674890350877193,0.656861056077181,10007,18240,23218
431,10,GEORGIA,CANDLER,1053,1643,2722,38.6847905951506%,60.3600293901543%,1026,2664,3763,27.2654796704757%,70.7945787935158%,1269,3133,4431,28.6391333784699%,70.7063868201309%,0.609421364985163,0.721951219512195,0.71172194457065,2696,3690,4402
432,10,GEORGIA,CARROLL,8752,16326,25741,34.0002330911775%,63.4241093974593%,12464,30029,44121,28.2495863647696%,68.0605607307178%,16238,37476,54474,29.8087160847377%,68.7961229210266%,0.651008852380573,0.706681100416539,0.697695200506386,25078,42493,53714
433,10,GEORGIA,CATOOSA,5470,12033,17721,30.8673325433102%,67.9024885728796%,4771,20876,26757,17.8308480023919%,78.020704862279%,6932,25167,32593,21.268370509005%,77.2159666185991%,0.687482145917843,0.813974343977853,0.784043116607994,17503,25647,32099
434,10,GEORGIA,CHARLTON,1015,1770,2816,36.0440340909091%,62.8551136363636%,1004,2951,4016,25%,73.4810756972112%,1103,3419,4566,24.1568112133158%,74.8795444590451%,0.635547576301616,0.74614412136536,0.756081379920389,2785,3955,4522
435,10,GEORGIA,CHATHAM,37590,37847,76475,49.1533180778032%,49.4893756129454%,62290,45688,112142,55.5456474826559%,40.7412031174761%,78254,53237,133420,58.6523759556288%,39.9018138210163%,0.501703408141893,0.423123228805868,0.40487181632203,75437,107978,131491
436,10,GEORGIA,CHATTAHOOCHEE,600,590,1207,49.7100248550124%,48.8815244407622%,594,751,1390,42.7338129496403%,54.0287769784173%,667,880,1582,42.1618204804046%,55.6257901390645%,0.495798319327731,0.558364312267658,0.568842921784098,1190,1345,1547
437,10,GEORGIA,CHATTOOGA,2729,3640,6477,42.1337038752509%,56.1988574957542%,1613,6462,8252,19.5467765390208%,78.3082888996607%,1854,8064,10050,18.4477611940299%,80.2388059701493%,0.571518291725546,0.800247678018576,0.813067150635209,6369,8075,9918
438,10,GEORGIA,CHEROKEE,12295,38033,52348,23.4870482157867%,72.6541606174066%,25231,80649,112043,22.5190328713083%,71.9804003819962%,42794,99587,144830,29.5477456328109%,68.7613063591797%,0.75570259100302,0.761701926709482,0.699440234300925,50328,105880,142381
439,10,GEORGIA,CLARKE,15167,11850,28904,52.4737060614448%,40.9977857735954%,29603,12717,44976,65.8195482034863%,28.2750800426894%,36048,14446,51333,70.2238326222898%,28.1417411801375%,0.438612725321094,0.300496219281663,0.286093397235315,27017,42320,50494
440,10,GEORGIA,CLAY,821,448,1277,64.291307752545%,35.0822239624119%,697,566,1273,54.7525530243519%,44.4619010212097%,790,637,1434,55.0906555090656%,44.42119944212%,0.353033884948779,0.448139350752177,0.446391030133146,1269,1263,1427
441,10,GEORGIA,CLAYTON,40042,19966,61402,65.2128595159767%,32.5168561284649%,78220,12645,92859,84.2352383721556%,13.6174199592931%,95476,15813,112344,84.985401979634%,14.0755180516984%,0.332722303692841,0.139162493809498,0.142089514686986,60008,90865,111289
442,10,GEORGIA,CLINCH,816,1091,1929,42.3017107309487%,56.5578019699326%,686,1727,2455,27.9429735234216%,70.3462321792261%,747,2105,2864,26.0824022346369%,73.4986033519553%,0.5721027792344,0.715706589307915,0.738078541374474,1907,2413,2852
443,10,GEORGIA,COBB,86676,140494,235027,36.8791670744212%,59.777812761938%,160121,152912,330819,48.4013916975748%,46.2222544654328%,221846,165459,393746,56.3424136372179%,42.0217602210562%,0.618453140819651,0.48848523957538,0.427205948800041,227170,313033,387305
444,10,GEORGIA,COFFEE,3593,5756,9430,38.101802757158%,61.0392364793213%,4094,9588,13915,29.4214876033058%,68.904060366511%,4511,10578,15214,29.650322071776%,69.5280662547654%,0.615680821478233,0.70077474053501,0.701040493074425,9349,13682,15089
445,10,GEORGIA,COLQUITT,3297,6589,9972,33.0625752105896%,66.0750100280786%,3463,9898,13624,25.4183793305931%,72.651203758074%,4187,11777,16083,26.0337001803146%,73.2263881116707%,0.666498078090229,0.74081281341217,0.737722375344525,9886,13361,15964
446,10,GEORGIA,COLUMBIA,8969,26660,36008,24.908353699178%,74.0391024216841%,18887,43085,64743,29.172265727569%,66.5477348902584%,29236,50013,80579,36.2824060859529%,62.0670397994515%,0.7482668612647,0.695233331181824,0.631086827594039,35629,61972,79249
447,10,GEORGIA,COOK,1639,2279,3944,41.5567951318458%,57.7839756592292%,1753,4176,6057,28.9417203235925%,68.9450222882615%,2059,4900,7035,29.2679459843639%,69.6517412935323%,0.581674323634507,0.704334626412549,0.704124155769507,3918,5929,6959
448,10,GEORGIA,COWETA,9056,21327,31226,29.0014731313649%,68.298853519503%,16583,42533,61745,26.8572354036764%,68.8849299538424%,24210,51501,76799,31.5238479667704%,67.0594669201422%,0.701938584076622,0.719483726909804,0.680231406268574,30383,59116,75711
449,10,GEORGIA,CRAWFORD,1513,1987,3567,42.4165965797589%,55.7050742921222%,1421,3635,5176,27.4536321483771%,70.2279752704791%,1615,4428,6102,26.4667322189446%,72.5663716814159%,0.567714285714286,0.718947784810127,0.732748634784048,3500,5056,6043
450,10,GEORGIA,CRISP,2268,3285,5609,40.4350151542164%,58.566589409877%,2837,4549,7512,37.7662406815761%,60.5564430244941%,2986,4987,8039,37.1439233735539%,62.0350789899241%,0.591572123176661,0.615894936366098,0.625486015301643,5553,7386,7973
451,10,GEORGIA,DADE,1628,3333,5049,32.244008714597%,66.0130718954248%,965,5051,6242,15.4597885293175%,80.9195770586351%,1261,6066,7434,16.9626042507398%,81.5980629539952%,0.671840354767184,0.839594414893617,0.827896819980893,4961,6016,7327
452,10,GEORGIA,DAWSON,1458,4210,5898,24.7202441505595%,71.3801288572397%,1448,9900,11765,12.3076923076923%,84.1478963025924%,2486,13398,16081,15.4592376096014%,83.3157141968783%,0.742766407904023,0.872400422982023,0.843490304709141,5668,11348,15884
453,10,GEORGIA,DECATUR,3398,4187,7648,44.4299163179916%,54.7463389121339%,4124,6020,10286,40.0933307408128%,58.5261520513319%,4780,6758,11627,41.1112066741206%,58.1233336200224%,0.552010547132498,0.593454258675079,0.585716762003814,7585,10144,11538
454,10,GEORGIA,DEKALB,154509,58807,219980,70.2377488862624%,26.7328848077098%,251370,51468,314757,79.8616075258056%,16.3516617581182%,308227,58373,370804,83.1239684577297%,15.7422789398173%,0.275680211517186,0.169952251698928,0.159228041462084,213316,302838,366600
455,10,GEORGIA,DODGE,2326,3472,5877,39.578015994555%,59.0777607622937%,1839,5021,7009,26.2376943929234%,71.6364673990584%,2171,5843,8070,26.9021065675341%,72.4039653035936%,0.598827181786823,0.731924198250729,0.729099076615922,5798,6860,8014
456,10,GEORGIA,DOOLY,1901,1588,3520,54.0056818181818%,45.1136363636364%,1872,1951,3859,48.5099766778958%,50.5571391552216%,1911,2159,4105,46.5529841656517%,52.5943970767357%,0.455144740613356,0.510332199843055,0.530466830466831,3489,3823,4070
457,10,GEORGIA,DOUGHERTY,16650,12248,29064,57.2873658133774%,42.1414808698046%,23311,10232,34087,68.3867750168686%,30.017308651392%,24577,10454,35311,69.6015405964147%,29.6055053665996%,0.423835559554294,0.305041290284113,0.298421398190174,28898,33543,35031
458,10,GEORGIA,DOUGLAS,11162,18893,30964,36.0483141712957%,61.0160186022478%,31005,24817,57738,53.6994700197444%,42.982091516852%,42809,25451,69097,61.9549329203873%,36.8337265004269%,0.628614207286641,0.444573823940382,0.372853794315851,30055,55822,68260
459,10,GEORGIA,EARLY,1622,1938,3585,45.2440725244073%,54.0585774058578%,2168,2552,4785,45.3082549634274%,53.3333333333333%,2437,2722,5187,46.9828417196838%,52.4773472141893%,0.54438202247191,0.540677966101695,0.527621632099244,3560,4720,5159
460,10,GEORGIA,ECHOLS,272,614,898,30.2895322939866%,68.3741648106904%,156,1007,1182,13.1979695431472%,85.1945854483926%,167,1256,1441,11.589174184594%,87.1616932685635%,0.693002257336343,0.865864144453998,0.882642304989459,886,1163,1423
461,10,GEORGIA,EFFINGHAM,3232,7326,10650,30.3474178403756%,68.7887323943662%,4853,17874,23458,20.6880381959246%,76.1957541137352%,7720,23358,31570,24.4535951853025%,73.9879632562559%,0.693881416935026,0.786465437585251,0.751592766587296,10558,22727,31078
462,10,GEORGIA,ELBERT,2527,3262,5853,43.1744404578848%,55.7321031949428%,2539,5292,7987,31.7891573807437%,66.2576687116564%,2879,6226,9171,31.3924326681932%,67.88790753462%,0.563482466747279,0.675775762993232,0.683800109829764,5789,7831,9105
463,10,GEORGIA,EMANUEL,2835,3343,6263,45.2658470381606%,53.3769758901485%,2435,5335,7860,30.9796437659033%,67.8753180661578%,2884,6551,9501,30.3546995053152%,68.9506367750763%,0.541113629006151,0.686615186615187,0.694329623741388,6178,7770,9435
464,10,GEORGIA,EVANS,1217,1841,3080,39.512987012987%,59.7727272727273%,1130,2404,3613,31.2759479656795%,66.5375034597288%,1324,2888,4247,31.1749470214269%,68.0009418412998%,0.602027468933944,0.680249009620826,0.685660018993352,3058,3534,4212
465,10,GEORGIA,FANNIN,2736,5463,8390,32.6102502979738%,65.1132300357569%,1923,9632,11812,16.2800541821876%,81.544192346766%,2571,12169,14850,17.3131313131313%,81.9461279461279%,0.666300768386389,0.833578537429684,0.825576662143826,8199,11555,14740
466,10,GEORGIA,FAYETTE,11912,29338,42449,28.0619095856204%,69.1135244646517%,23284,35048,60913,38.2250094396927%,57.5377998128478%,33065,37952,71993,45.9280763407554%,52.7162363007515%,0.711224242424242,0.600836590550641,0.534407254601011,41250,58332,71017
467,10,GEORGIA,FLOYD,10282,16194,26825,38.3299161230196%,60.3690587138863%,9159,24114,34608,26.4649791955617%,69.6775312066574%,12008,29123,41648,28.8321167883212%,69.9265270841337%,0.611648285239462,0.724731764493734,0.708054751890302,26476,33273,41131
468,10,GEORGIA,FORSYTH,6694,27769,35755,18.7218570829255%,77.6646622849951%,23462,69851,98221,23.8869488194989%,71.1161564227609%,42203,85122,129305,32.6383357178763%,65.8304009899076%,0.805762702028262,0.748566652020619,0.668541134891027,34463,93313,127325
469,10,GEORGIA,FRANKLIN,2040,3659,5762,35.4043734814301%,63.5022561610552%,1243,7054,8502,14.6200893907316%,82.9687132439426%,1593,9069,10765,14.7979563399907%,84.2452392011147%,0.642042463590103,0.850186814511269,0.850590883511536,5699,8297,10662
470,10,GEORGIA,FULTON,152039,104870,263212,57.7629439387262%,39.8424084008328%,297051,117783,431391,68.8588774452875%,27.3030730821923%,381144,137240,524659,72.6460424771137%,26.1579425874711%,0.408199012101561,0.283928029042942,0.264745825488441,256909,414834,518384
471,10,GEORGIA,GILMER,2230,4941,7370,30.2578018995929%,67.0420624151967%,1965,10477,12773,15.3840131527441%,82.0245831049871%,2932,13429,16525,17.7428139183056%,81.2647503782148%,0.689025240552224,0.842067191769812,0.820793350039729,7171,12442,16361
472,10,GEORGIA,GLASCOCK,249,763,1020,24.4117647058823%,74.8039215686275%,138,1235,1390,9.92805755395684%,88.8489208633094%,155,1403,1566,9.8978288633461%,89.5913154533844%,0.75395256916996,0.899490167516387,0.900513478818999,1012,1373,1558
473,10,GEORGIA,GLYNN,7778,14346,22384,34.7480343102216%,64.090421729807%,11775,21512,34263,34.3665178180545%,62.7849283483641%,15879,25616,41984,37.8215510670732%,61.0137195121951%,0.64843608750678,0.64625829903566,0.617327388842029,22124,33287,41495
474,10,GEORGIA,GORDON,4032,7944,12205,33.0356411306841%,65.0880786562884%,3181,15191,18959,16.7783110923572%,80.1255340471544%,4384,19405,24033,18.2415844879957%,80.7431448425082%,0.663326653306613,0.826856085347268,0.815713144730758,11976,18372,23789
475,10,GEORGIA,GRADY,2721,3894,6703,40.5937639862748%,58.0933910189467%,3013,6053,9213,32.7037881254749%,65.7006403994356%,3619,7034,10707,33.8003175492668%,65.695339497525%,0.588662131519274,0.667659386719612,0.660283488219281,6615,9066,10653
476,10,GEORGIA,GREENE,2137,2980,5197,41.11987685203%,57.3407735231864%,3199,5490,8852,36.1387257117036%,62.0198825124266%,4088,7068,11247,36.3474704365609%,62.8434249133102%,0.582372483877272,0.631833352514674,0.633560415919684,5117,8689,11156
477,10,GEORGIA,GWINNETT,61434,121756,191111,32.1457163637886%,63.7095719241697%,166153,146989,328331,50.6053342511064%,44.7685415023254%,241827,166413,413865,58.4313725490196%,40.2094886013555%,0.664643266553851,0.469400463687401,0.407635214579659,183190,313142,408240
478,10,GEORGIA,HABERSHAM,2530,6964,9691,26.1066969353008%,71.8604891136106%,2483,13190,16243,15.2865849904574%,81.2042110447577%,3563,16637,20432,17.4383320281911%,81.4261942051684%,0.733515904781968,0.841574682575129,0.823613861386139,9494,15673,20200
479,10,GEORGIA,HALL,10259,26841,38150,26.8912188728702%,70.3564875491481%,16180,51733,70694,22.8873737516621%,73.1787704755708%,25031,64170,90523,27.651536073705%,70.888061597605%,0.723477088948787,0.761754008805383,0.719386553962399,37100,67913,89201
480,10,GEORGIA,HANCOCK,2414,662,3086,78.2242384964355%,21.451717433571%,2701,843,3580,75.4469273743017%,23.5474860335195%,2985,1159,4165,71.6686674669868%,27.8271308523409%,0.215214564369311,0.237866817155756,0.279681467181467,3076,3544,4144
481,10,GEORGIA,HARALSON,2869,5153,8167,35.1291784008816%,63.0953838618832%,1475,9585,11357,12.9875847494937%,84.3972880162015%,1792,12331,14248,12.5772038180797%,86.5454800673779%,0.642358514086263,0.866636528028933,0.873114777313602,8022,11060,14123
482,10,GEORGIA,HARRIS,2912,5554,8562,34.0107451530016%,64.868021490306%,4086,11936,16502,24.7606350745364%,72.3306265907163%,5457,14319,19991,27.2972837777%,71.6272322545145%,0.656035908339239,0.744975658469604,0.724059466019417,8466,16022,19776
483,10,GEORGIA,HART,3192,4242,7536,42.3566878980892%,56.2898089171974%,2585,7286,10117,25.5510526836019%,72.0173964614016%,3157,9464,12727,24.8055315471046%,74.3615934627171%,0.570621468926554,0.738121770843886,0.749861342207432,7434,9871,12621
484,10,GEORGIA,HEARD,1178,1947,3198,36.8355222013759%,60.8818011257036%,743,3370,4223,17.5941273975847%,79.8010892730287%,824,4516,5391,15.2847338156186%,83.7692450380263%,0.62304,0.819353270119134,0.845692883895131,3125,4113,5340
485,10,GEORGIA,HENRY,11971,25815,38867,30.7999073764376%,66.4188128746752%,50057,45724,98766,50.6824210760788%,46.2952838021181%,73276,48187,122742,59.6992064655945%,39.25877042903%,0.683189541099878,0.477380691368852,0.396721635395141,37786,95781,121463
486,10,GEORGIA,HOUSTON,13301,23174,36988,35.9603114523629%,62.652752243971%,22553,35430,60079,37.5389071056442%,58.9723530684599%,32232,41534,74823,43.0776632853534%,55.5096694866552%,0.635339273474983,0.611041167238673,0.563050727977659,36475,57983,73766
487,10,GEORGIA,IRWIN,1105,1720,2852,38.7447405329593%,60.3085553997195%,891,2716,3670,24.2779291553134%,74.0054495912807%,1008,3134,4168,24.1842610364683%,75.1919385796545%,0.608849557522124,0.752980316052121,0.756639304683728,2825,3607,4142
488,10,GEORGIA,JACKSON,3420,7878,11635,29.3940696175333%,67.7094972067039%,4491,21784,27190,16.5171018756896%,80.1176903273262%,7642,29497,37670,20.2867002920096%,78.3036899389434%,0.697291556027616,0.829077069457659,0.794232477988099,11298,26275,37139
489,10,GEORGIA,JASPER,1558,2298,3943,39.5130611209739%,58.280497083439%,1544,4360,6045,25.5417700578991%,72.125723738627%,1761,5822,7644,23.0376766091052%,76.1643118785976%,0.595954356846473,0.738482384823848,0.767770011868654,3856,5904,7583
490,10,GEORGIA,JEFF DAVIS,1379,2797,4221,32.6699834162521%,66.2639185027245%,901,4104,5096,17.6805337519623%,80.5337519623234%,1028,4695,5771,17.8132039507884%,81.3550511176573%,0.66977969348659,0.81998001998002,0.82037392975712,4176,5005,5723
491,10,GEORGIA,JEFFERSON,2973,2559,5566,53.4135824649659%,45.9755659360402%,3821,3063,6968,54.8363949483352%,43.9580941446613%,4061,3537,7642,53.1405391258833%,46.2836953677048%,0.462581344902386,0.444944799535154,0.46551724137931,5532,6884,7598
492,10,GEORGIA,JENKINS,1250,1317,2593,48.2067103740841%,50.790590050135%,1123,1895,3056,36.7473821989529%,62.0091623036649%,1266,2161,3455,36.6425470332851%,62.5470332850941%,0.513050253213868,0.627899271040424,0.630580682812956,2567,3018,3427
493,10,GEORGIA,JOHNSON,1065,1797,2883,36.9406867845994%,62.3309053069719%,1136,2519,3686,30.8193163320673%,68.3396635919696%,1222,2850,4100,29.8048780487805%,69.5121951219512%,0.627882599580713,0.689192886456908,0.699901768172888,2862,3655,4072
494,10,GEORGIA,JONES,3102,4850,8068,38.4481903817551%,60.1140307387209%,3961,8305,12551,31.5592383077046%,66.1700262927257%,4888,9965,14966,32.660697581184%,66.5842576506749%,0.609909456740443,0.677074841023969,0.670908234026796,7952,12266,14853
495,10,GEORGIA,LAMAR,2194,2912,5230,41.9502868068834%,55.678776290631%,2270,5190,7612,29.8213347346295%,68.1818181818182%,2615,6330,9039,28.9301913928532%,70.0298705609028%,0.570309439874657,0.695710455764075,0.707657909446618,5106,7460,8945
496,10,GEORGIA,LANIER,832,1048,1904,43.6974789915966%,55.0420168067227%,806,1984,2871,28.0738418669453%,69.1048415186346%,1019,2509,3576,28.4955257270693%,70.162192393736%,0.557446808510638,0.711111111111111,0.711167800453515,1880,2790,3528
497,10,GEORGIA,LAURENS,5724,8133,14036,40.7808492447991%,57.9438586491878%,6752,12411,19530,34.5724526369688%,63.5483870967742%,8073,14493,22729,35.5185005939549%,63.7643539091029%,0.586923576531717,0.647654333872567,0.642249401754852,13857,19163,22566
498,10,GEORGIA,LEE,1936,5872,7884,24.5560629122273%,74.4799594114663%,3170,10646,14143,22.4139150109595%,75.2739871314431%,4558,12007,16714,27.2705516333613%,71.8379801364126%,0.752049180327869,0.770555877243775,0.724841533353456,7808,13816,16565
499,10,GEORGIA,LIBERTY,5347,4455,9972,53.6201363818692%,44.6750902527076%,9556,6134,16143,59.1959363191476%,37.9978938239485%,13099,7959,21389,61.2417597830661%,37.2107157884894%,0.454499081820037,0.390949649458254,0.377956121189097,9802,15690,21058
500,10,GEORGIA,LINCOLN,1275,1807,3103,41.0892684498872%,58.2339671285852%,1273,2759,4102,31.0336421257923%,67.2598732325695%,1435,3179,4650,30.8602150537634%,68.3655913978495%,0.58630759247242,0.684275793650794,0.688990030342436,3082,4032,4614
501,10,GEORGIA,LONG,975,1320,2314,42.1348314606742%,57.0440795159896%,1360,2626,4117,33.0337624483847%,63.784308962837%,2033,3528,5656,35.9441301272984%,62.3762376237624%,0.57516339869281,0.6588058203713,0.634418270095307,2295,3986,5561
502,10,GEORGIA,LOWNDES,10616,14462,25432,41.7426863793646%,56.8653664674426%,15064,21635,37805,39.8465811400608%,57.2278799100648%,20117,25691,46355,43.3976917268903%,55.4222845431992%,0.576680756041152,0.589525600152593,0.560840901152637,25078,36699,45808
503,10,GEORGIA,LUMPKIN,2121,4427,6750,31.4222222222222%,65.5851851851852%,2220,9619,12425,17.8672032193159%,77.4164989939638%,3126,12163,15531,20.1274869615608%,78.3143390638079%,0.676084300549786,0.812484162513726,0.795539276604094,6548,11839,15289
504,10,GEORGIA,MACON,2757,1566,4355,63.3065442020666%,35.9586681974742%,2705,1540,4287,63.097737345463%,35.9225565663634%,2857,1783,4662,61.2827112827113%,38.2453882453882%,0.362248438584316,0.362779740871614,0.38426724137931,4323,4245,4640
505,10,GEORGIA,MADISON,2285,5529,7993,28.5875140748155%,69.1730263980983%,2425,9201,11998,20.2117019503251%,76.6877812968828%,3411,11326,14937,22.835910825467%,75.8251322219991%,0.707576145380087,0.791415792189919,0.76854176562394,7814,11626,14737
506,10,GEORGIA,MARION,982,1187,2184,44.96336996337%,54.3498168498168%,1213,1921,3190,38.025078369906%,60.2194357366771%,1311,2275,3624,36.1754966887417%,62.7759381898455%,0.547256800368834,0.612954690491385,0.634411600669269,2169,3134,3586
507,10,GEORGIA,MCDUFFIE,2580,3926,6550,39.3893129770992%,59.9389312977099%,3699,5432,9268,39.9115235217954%,58.6102719033233%,4168,6169,10455,39.8660927785748%,59.0052606408417%,0.603442975714725,0.594896506406746,0.596788236432234,6506,9131,10337
508,10,GEORGIA,MCINTOSH,2047,1766,3837,53.3489705499088%,46.0255407870732%,2303,3487,5903,39.0140606471286%,59.0716584787396%,2612,4016,6696,39.0083632019116%,59.9761051373955%,0.463152373459218,0.602245250431779,0.605914302957151,3813,5790,6628
509,10,GEORGIA,MERIWETHER,3441,3162,6709,51.2893128633179%,47.1307199284543%,3804,5222,9217,41.271563415428%,56.6561788000434%,4287,6524,10877,39.4134412062149%,59.9797738346971%,0.47887323943662,0.57855085309107,0.603459439459809,6603,9026,10811
510,10,GEORGIA,MILLER,783,1349,2150,36.4186046511628%,62.7441860465116%,623,1891,2544,24.4889937106918%,74.3317610062893%,749,2066,2835,26.4197530864197%,72.8747795414462%,0.632739212007505,0.752187748607796,0.73392539964476,2132,2514,2815
511,10,GEORGIA,MITCHELL,2971,2790,5799,51.2329712019314%,48.1117434040352%,3493,4279,7880,44.3274111675127%,54.3020304568528%,3995,4935,8963,44.572129867232%,55.0596898359924%,0.48429092171498,0.550566134843026,0.552631578947368,5761,7772,8930
512,10,GEORGIA,MONROE,2839,4561,7541,37.6475268532025%,60.4826946028378%,3571,8832,12687,28.146922046189%,69.6145660912745%,4384,11060,15592,28.1169830682401%,70.9338122113905%,0.616351351351351,0.712085785697009,0.716135716135716,7400,12403,15444
513,10,GEORGIA,MONTGOMERY,1013,1465,2509,40.3746512554803%,58.3897967317656%,847,2670,3576,23.6856823266219%,74.6644295302013%,979,2960,3966,24.6848209783157%,74.6343923348462%,0.591202582728006,0.759169746943418,0.751459761360751,2478,3517,3939
514,10,GEORGIA,MORGAN,2238,3524,5902,37.9193493730939%,59.708573364961%,2663,6559,9475,28.1055408970976%,69.2242744063325%,3355,8230,11707,28.6580678226702%,70.2998206201418%,0.611593196806664,0.71123400563869,0.710401381096245,5762,9222,11585
515,10,GEORGIA,MURRAY,2684,5539,8372,32.0592451027234%,66.1610129001433%,1800,10341,12458,14.4485471183175%,83.0069031947343%,2302,12943,15389,14.9587367600234%,84.1055299239717%,0.67359844339049,0.851742031134173,0.848999672023614,8223,12141,15245
516,10,GEORGIA,MUSCOGEE,28193,23479,52163,54.0478883499799%,45.0108314322412%,39851,26976,69032,57.7282999188782%,39.0775292617916%,49529,30049,80543,61.4938604223831%,37.3080218020188%,0.454385353769933,0.403669175632604,0.377604363014904,51672,66827,79578
517,10,GEORGIA,NEWTON,6703,11127,18375,36.4789115646258%,60.5551020408163%,21943,20913,43987,49.8851933525815%,47.5435924250347%,29794,23869,54239,54.9309537417725%,44.0070797765446%,0.624060572069546,0.487983012880344,0.44479436483238,17830,42856,53663
518,10,GEORGIA,OCONEE,3184,7611,11168,28.5100286532951%,68.1500716332378%,5581,13425,20149,27.6986450940493%,66.6286168048042%,8162,16595,25168,32.4300699300699%,65.9369040050858%,0.705048633626679,0.706355887614438,0.670315466332754,10795,19006,24757
519,10,GEORGIA,OGLETHORPE,1519,2706,4385,34.6408209806157%,61.7103762827822%,1831,4625,6674,27.4348216961343%,69.2987713515133%,2436,5593,8131,29.9594145861518%,68.7861271676301%,0.640473372781065,0.716387856257745,0.696599825632084,4225,6456,8029
520,10,GEORGIA,PAULDING,6743,16881,24260,27.7947238252267%,69.5836768342951%,18025,44662,64890,27.7777777777778%,68.8272461087995%,29704,54525,85385,34.7883117643614%,63.8578204602682%,0.714569928885879,0.712460318726371,0.647342364268838,23624,62687,84229
521,10,GEORGIA,PEACH,3540,3525,7137,49.6006725514922%,49.3905002101723%,5100,5413,10752,47.4330357142857%,50.3441220238095%,5920,6502,12545,47.190115583898%,51.8294141092069%,0.498938428874735,0.514886331208979,0.523426179359201,7065,10513,12422
522,10,GEORGIA,PICKENS,2489,5488,8201,30.3499573222778%,66.9186684550665%,1979,11651,14038,14.0974497791708%,82.9961532981906%,2808,14075,17116,16.4057022668848%,82.2329983641038%,0.687977936567632,0.854805575935436,0.833678848545875,7977,13630,16883
523,10,GEORGIA,PIERCE,1300,3348,4681,27.7718436231574%,71.523178807947%,903,6302,7311,12.3512515387772%,86.1988784024073%,1100,7899,9048,12.157382847038%,87.3010610079576%,0.720309810671256,0.874670367800139,0.87776419602178,4648,7205,8999
524,10,GEORGIA,PIKE,1413,3358,4885,28.9252814738997%,68.7410440122825%,1240,7278,8725,14.2120343839542%,83.4154727793696%,1505,9127,10720,14.0391791044776%,85.1399253731343%,0.703835673862922,0.854425921577835,0.858446200150489,4771,8518,10632
525,10,GEORGIA,POLK,4112,5841,10116,40.6484776591538%,57.7402135231317%,2867,11014,14215,20.1688357368976%,77.4815335912768%,3658,13589,17399,21.0241967929191%,78.1021897810219%,0.586858233698382,0.793458684532815,0.787905142923407,9953,13881,17247
526,10,GEORGIA,PULASKI,1390,1922,3346,41.5421398684997%,57.4417214584579%,1104,2437,3605,30.624133148405%,67.6005547850208%,1217,2805,4059,29.9827543729983%,69.1056910569106%,0.580314009661836,0.688223665631178,0.697414221780209,3312,3541,4022
527,10,GEORGIA,PUTNAM,2612,3596,6299,41.4668995078584%,57.0884267344023%,2758,6544,9488,29.0682967959528%,68.9713322091062%,3448,8291,11855,29.0847743568115%,69.9367355546183%,0.579252577319588,0.703504622661793,0.706278217906125,6208,9302,11739
528,10,GEORGIA,QUITMAN,542,348,904,59.9557522123894%,38.4955752212389%,461,575,1044,44.1570881226054%,55.0766283524904%,497,604,1106,44.9367088607595%,54.6112115732369%,0.391011235955056,0.555019305019305,0.548592188919164,890,1036,1101
529,10,GEORGIA,RABUN,1776,3451,5341,33.2521999625538%,64.6133682830931%,1444,6287,7992,18.0680680680681%,78.6661661661662%,1984,7474,9568,20.7357859531773%,78.1145484949833%,0.660225750908743,0.813219505885396,0.790230492704589,5227,7731,9458
530,10,GEORGIA,RANDOLPH,1381,1174,2569,53.7563254184508%,45.6987154534838%,1598,1271,2899,55.122456019317%,43.842704380821%,1671,1391,3074,54.3591411841249%,45.2504879635654%,0.459491193737769,0.443011502265598,0.454278249510124,2555,2869,3062
531,10,GEORGIA,RICHMOND,31413,25485,57538,54.5952240258612%,44.2924675866384%,48814,24461,75515,64.6414619611998%,32.3922399523274%,59124,26781,87016,67.9461248506022%,30.7770984646502%,0.447906780554677,0.333824633230979,0.311751353239043,56898,73275,85905
532,10,GEORGIA,ROCKDALE,8295,15440,24649,33.6524808308654%,62.6394579901822%,23255,13478,37869,61.4090681031979%,35.5911167445668%,31244,13012,44686,69.9189902877859%,29.1187396500022%,0.650516115441331,0.366918030109166,0.294016630513377,23735,36733,44256
533,10,GEORGIA,SCHLEY,460,706,1176,39.1156462585034%,60.0340136054422%,401,1472,1909,21.0057621791514%,77.1084337349398%,462,1800,2275,20.3076923076923%,79.1208791208791%,0.60548885077187,0.785904965296316,0.795755968169761,1166,1873,2262
534,10,GEORGIA,SCREVEN,2233,2461,4719,47.3193473193473%,52.1508794236067%,2300,3305,5715,40.2449693788276%,57.830271216098%,2661,3916,6628,40.1478575739288%,59.0826795413398%,0.524286322965488,0.589652096342551,0.595408240839288,4694,5605,6577
535,10,GEORGIA,SEMINOLE,1313,1537,2877,45.6378171706639%,53.4237052485228%,1189,2345,3588,33.1382385730212%,65.3567447045708%,1254,2611,3884,32.2863027806385%,67.2245108135942%,0.539298245614035,0.663554046406338,0.675549805950841,2850,3534,3865
536,10,GEORGIA,SPALDING,5831,9271,15391,37.885777402378%,60.2365018517315%,9357,15646,25704,36.4028944911298%,60.8699035169624%,11784,18057,30116,39.1287023509098%,59.958161774472%,0.613892199708648,0.625764908211015,0.605107067457525,15102,25003,29841
537,10,GEORGIA,STEPHENS,2869,5370,8376,34.2526265520535%,64.1117478510029%,1837,7686,9815,18.7162506367804%,78.3087111563933%,2385,9368,11885,20.0673117374842%,78.8220445940261%,0.651778128413642,0.807098603381287,0.797073087722284,8239,9523,11753
538,10,GEORGIA,STEWART,1267,675,1954,64.8413510747185%,34.5445240532242%,1222,805,2058,59.3780369290573%,39.1156462585034%,1182,801,1990,59.3969849246231%,40.251256281407%,0.347579814624099,0.397138628515047,0.40393343419062,1942,2027,1983
539,10,GEORGIA,SUMTER,4748,4847,9697,48.9635969887594%,49.9845312983397%,5520,5276,10974,50.3007107709131%,48.0772735556771%,6318,5732,12150,52%,47.1769547325103%,0.505158936946326,0.488699518340126,0.475684647302905,9595,10796,12050
540,10,GEORGIA,TALBOT,1662,844,2531,65.6657447649151%,33.3465033583564%,2002,1196,3246,61.6759088108441%,36.845348120764%,2114,1392,3522,60.022714366837%,39.5229982964225%,0.336791699920192,0.373983739837398,0.397033656588705,2506,3198,3506
541,10,GEORGIA,TALIAFERRO,556,271,832,66.8269230769231%,32.5721153846154%,545,349,897,60.7580824972129%,38.9074693422519%,561,360,928,60.4525862068966%,38.7931034482759%,0.327690447400242,0.390380313199105,0.390879478827362,827,894,921
542,10,GEORGIA,TATTNALL,1963,3597,5610,34.9910873440285%,64.1176470588235%,1681,5096,6903,24.3517311313922%,73.8229755178908%,2061,6053,8183,25.1863619699377%,73.9704264939509%,0.646942446043165,0.751955142393389,0.745994577273848,5560,6777,8114
543,10,GEORGIA,TAYLOR,1340,1412,2780,48.2014388489209%,50.7913669064748%,1296,2064,3408,38.0281690140845%,60.5633802816901%,1387,2418,3839,36.1292003125814%,62.9851523834332%,0.513081395348837,0.614285714285714,0.635479632063075,2752,3360,3805
544,10,GEORGIA,TELFAIR,1777,1693,3493,50.8731749212711%,48.4683653020326%,1313,2450,3796,34.5890410958904%,64.5416227608009%,1487,2825,4333,34.3180244634203%,65.1973228709901%,0.487896253602306,0.651076268934361,0.655148423005566,3470,3763,4312
545,10,GEORGIA,TERRELL,1584,1504,3113,50.8833922261484%,48.3135239318985%,2267,1874,4189,54.1179279064216%,44.7362138935307%,2376,2004,4416,53.804347826087%,45.3804347826087%,0.487046632124352,0.45254769379377,0.457534246575342,3088,4141,4380
546,10,GEORGIA,THOMAS,4862,7093,12058,40.3217780726489%,58.8240172499585%,7142,11228,18802,37.9853207105627%,59.717051377513%,8708,12954,21853,39.8480757790692%,59.2779023475038%,0.593308239230448,0.611213935764834,0.598005724309851,11955,18370,21662
547,10,GEORGIA,TIFT,3547,6678,10328,34.3435321456235%,64.6591789310612%,4347,9584,14219,30.5717701666784%,67.4027709402912%,5322,10784,16283,32.684394767549%,66.2285819566419%,0.653105134474328,0.687962098916086,0.669564137588476,10225,13931,16106
548,10,GEORGIA,TOOMBS,2643,4487,7210,36.6574202496533%,62.2330097087379%,2338,6615,9138,25.5854672794922%,72.3900196979646%,2939,7872,10914,26.9287154113982%,72.1275426058274%,0.629312762973352,0.738858483189992,0.728147257422995,7130,8953,10811
549,10,GEORGIA,TOWNS,1495,2902,4497,33.2443851456527%,64.5319101623304%,1210,5383,6764,17.8888231815494%,79.5830869308102%,1550,6384,7979,19.4259932322346%,80.0100263190876%,0.659995451444167,0.816472015774306,0.804638265691959,4397,6593,7934
550,10,GEORGIA,TREUTLEN,879,1062,1963,44.7784004075395%,54.1008660213958%,862,1809,2703,31.890492045875%,66.9256381798002%,952,2101,3077,30.939226519337%,68.2807929801755%,0.547140649149923,0.677274429052789,0.688175565018015,1941,2671,3053
551,10,GEORGIA,TROUP,6379,11198,17804,35.8290271849023%,62.8959784318131%,9713,15750,26111,37.1988816973689%,60.319405614492%,11578,18143,30049,38.5304003461014%,60.378049186329%,0.637082551061046,0.618544554844284,0.610443793950406,17577,25463,29721
552,10,GEORGIA,TURNER,1169,1258,2456,47.5977198697068%,51.2214983713355%,1246,2095,3398,36.6686286050618%,61.6539140670983%,1410,2349,3792,37.1835443037975%,61.9462025316456%,0.518335393489905,0.627057767135588,0.624900239425379,2427,3341,3759
553,10,GEORGIA,TWIGGS,1977,1570,3615,54.6887966804979%,43.4301521438451%,1971,2035,4059,48.5587583148559%,50.1355013550135%,2044,2370,4444,45.994599459946%,53.3303330333033%,0.44262757259656,0.50798801797304,0.536927956502039,3547,4006,4414
554,10,GEORGIA,UNION,2230,4567,6956,32.0586543990799%,65.6555491661875%,1963,9852,12063,16.2729006051563%,81.6712260631684%,2801,12651,15560,18.0012853470437%,81.3046272493573%,0.671914079741062,0.833855268726195,0.818728967123997,6797,11815,15452
555,10,GEORGIA,UPSON,3158,5019,8282,38.1308862593576%,60.6013040328423%,3475,7292,10934,31.7815986830071%,66.6910554234498%,4201,8608,12905,32.5532739248353%,66.7028283611004%,0.613794790265379,0.677254574161791,0.672027480677648,8177,10767,12809
556,10,GEORGIA,WALKER,6341,12326,18895,33.5591426303255%,65.2341889388727%,4215,18950,23956,17.5947570546001%,79.1033561529471%,5769,23174,29354,19.6531988826054%,78.946651223002%,0.660309637327905,0.818044463630477,0.800677193103687,18667,23165,28943
557,10,GEORGIA,WALTON,5484,12966,19083,28.7376198710895%,67.9452916208143%,8292,31125,40698,20.374465575704%,76.4779596048946%,12682,37842,51095,24.8204325276446%,74.0620412956258%,0.702764227642276,0.789633914300936,0.748990578734859,18450,39417,50524
558,10,GEORGIA,WARE,3480,6099,9628,36.144578313253%,63.3464894058995%,3440,8513,12184,28.2337491792515%,69.8703217334209%,4211,9865,14192,29.6716459977452%,69.51099210823%,0.636705292828061,0.712206140717811,0.700838306337028,9579,11953,14076
559,10,GEORGIA,WARREN,1196,933,2145,55.7575757575758%,43.4965034965035%,1314,991,2334,56.2982005141388%,42.4592973436161%,1469,1166,2651,55.4130516786118%,43.9834024896266%,0.43823391263504,0.429934924078091,0.442504743833017,2129,2305,2635
560,10,GEORGIA,WASHINGTON,3476,3162,6691,51.9503811089523%,47.2575100881782%,4200,4149,8461,49.6395225150691%,49.036756884529%,4730,4663,9459,50.0052859710329%,49.2969658526271%,0.476348297680024,0.496945742005031,0.496433514319174,6638,8349,9393
561,10,GEORGIA,WAYNE,2736,5219,8004,34.1829085457271%,65.2048975512244%,2041,8153,10413,19.6004993757803%,78.2963603188322%,2687,9987,12778,21.028329942088%,78.1577711691971%,0.656065367693275,0.799784186776535,0.787991163010888,7955,10194,12674
562,10,GEORGIA,WEBSTER,541,359,909,59.5159515951595%,39.4939493949395%,473,630,1116,42.3835125448029%,56.4516129032258%,639,748,1390,45.9712230215827%,53.8129496402878%,0.398888888888889,0.57116953762466,0.539293439077145,900,1103,1387
563,10,GEORGIA,WHEELER,752,813,1575,47.7460317460317%,51.6190476190476%,646,1421,2102,30.732635585157%,67.6022835394862%,689,1583,2285,30.1531728665208%,69.2778993435449%,0.519488817891374,0.687469762941461,0.696742957746479,1565,2067,2272
564,10,GEORGIA,WHITE,2014,4857,7043,28.5957688485021%,68.962090018458%,1674,9761,11823,14.1588429332657%,82.5594180833968%,2411,12222,14816,16.2729481641469%,82.4919006479482%,0.706884005239412,0.853607345867949,0.835235426775097,6871,11435,14633
565,10,GEORGIA,WHITFIELD,7034,15852,23302,30.1862501072869%,68.0284954081195%,7937,21537,30658,25.8888381499119%,70.2492008611129%,10670,25636,36746,29.0371741141893%,69.7654166439885%,0.692650528707507,0.730711813801995,0.706109183055142,22886,29474,36306
566,10,GEORGIA,WILCOX,962,1381,2365,40.676532769556%,58.3932346723044%,852,2096,2976,28.6290322580645%,70.4301075268817%,862,2403,3281,26.2724779030783%,73.2398658945443%,0.589415279556125,0.710990502035278,0.735987748851455,2343,2948,3265
567,10,GEORGIA,WILKES,1940,2044,4026,48.1867858917039%,50.7699950322901%,1848,2572,4486,41.1948283548819%,57.3339277753009%,2160,2823,5029,42.950884867767%,56.134420361901%,0.513052208835341,0.581900452488688,0.566526189042745,3984,4420,4983
568,10,GEORGIA,WILKINSON,1884,1800,3740,50.3743315508021%,48.1283422459893%,1894,2333,4287,44.1800793095405%,54.4203405644973%,2075,2664,4770,43.5010482180294%,55.8490566037736%,0.488599348534202,0.551928081381595,0.562143912217768,3684,4227,4739
569,10,GEORGIA,WORTH,2214,3792,6061,36.5286256393334%,62.5639333443326%,2020,6152,8295,24.3520192887282%,74.16515973478%,2395,6830,9285,25.7942918686053%,73.5595045772752%,0.631368631368631,0.752814488497308,0.740379403794038,6006,8172,9225
571,11,HAWAII,HAWAII,28670,17050,50860,56.3704286276052%,33.5233975619347%,41259,17501,64867,63.6055313179275%,26.9798202475835%,58731,26897,87814,66.8811351265174%,30.6295123784362%,0.372922134733158,0.29783866575902,0.314114541972252,45720,58760,85628
572,11,HAWAII,HONOLULU,139618,101310,255990,54.5404117348334%,39.5757646783077%,175696,90326,285790,61.477308513244%,31.605724483012%,238866,136250,382102,62.5136743592025%,35.6580180161318%,0.420499070261655,0.339543346039049,0.363220976977788,240928,266022,375116
573,11,HAWAII,KAUAI,13470,6583,21773,61.8656133743627%,30.2346943462086%,16456,7574,26335,62.4871843554205%,28.7602050503133%,21225,11582,33497,63.3638833328358%,34.5762307072275%,0.328280057846706,0.315189346650021,0.353034413387387,20053,24030,32807
574,11,HAWAII,MAUI,23484,12876,39248,59.8348960456584%,32.8067672238076%,33480,13446,51945,64.4527866012128%,25.8850707479064%,47305,22126,71044,66.5854963121446%,31.1440797252407%,0.354125412541254,0.286536248561565,0.318676095692126,36360,46926,69431
576,12,IDAHO,ADA,40650,75050,123485,32.9189780135239%,60.7766125440337%,75677,93752,195669,38.6760294170257%,47.9135683220132%,120539,130699,259389,46.4703591902509%,50.3872562059301%,0.648660328435609,0.553340927468143,0.520219871197828,115700,169429,251238
577,12,IDAHO,ADAMS,336,1476,1909,17.6008381351493%,77.317967522263%,415,1556,2183,19.0105359596885%,71.2780577187357%,591,1941,2586,22.8538283062645%,75.0580046403712%,0.814569536423841,0.789446981227803,0.766587677725118,1812,1971,2532
578,12,IDAHO,BANNOCK,10892,18223,30852,35.3040321535071%,59.06586282899%,10342,17180,33416,30.9492458702418%,51.4124970074216%,14682,23331,39553,37.1198139205623%,58.9866761054787%,0.625897303795295,0.624227890414941,0.613763712414174,29115,27522,38013
579,12,IDAHO,BEAR LAKE,517,2296,2899,17.8337357709555%,79.1997240427734%,255,2203,2928,8.70901639344262%,75.2390710382514%,350,2914,3315,10.5580693815988%,87.9034690799397%,0.816210451475293,0.896257119609439,0.892769607843137,2813,2458,3264
580,12,IDAHO,BENEWAH,895,2606,3687,24.2744778953078%,70.6807702739355%,770,3103,4185,18.3990442054958%,74.1457586618877%,977,3878,4973,19.6460888799517%,77.9810979288156%,0.744358754641531,0.801187709785696,0.798764160659114,3501,3873,4855
581,12,IDAHO,BINGHAM,3310,10628,14465,22.8828206014518%,73.4739025233322%,2924,10907,16625,17.587969924812%,65.606015037594%,4124,15295,19996,20.624124824965%,76.4902980596119%,0.762519730233893,0.788590846648832,0.787630670992327,13938,13831,19419
582,12,IDAHO,BLAINE,3748,3528,7938,47.2159234063996%,44.4444444444444%,6416,3340,10724,59.828422230511%,31.1450951137635%,8919,4032,13289,67.1156595680638%,30.3408834374295%,0.484881803188565,0.342353423534235,0.311327310632384,7276,9756,12951
583,12,IDAHO,BOISE,745,2019,3055,24.3862520458265%,66.088379705401%,777,2673,3814,20.372312532774%,70.0839014158364%,1204,3485,4820,24.9792531120332%,72.3029045643154%,0.730463096960926,0.774782608695652,0.743228833439966,2764,3450,4689
584,12,IDAHO,BONNER,4318,8945,14537,29.7035151681915%,61.5326408474926%,5819,13343,20943,27.7849400754429%,63.7110251635391%,8310,18369,27335,30.4005853301628%,67.1995610023779%,0.67443263213451,0.696326061997704,0.68851905993478,13263,19162,26679
585,12,IDAHO,BONNEVILLE,7235,24988,33556,21.5609727023483%,74.4665633567767%,8930,26699,44221,20.1940254630153%,60.37629180706%,14254,37805,53995,26.3987406241319%,70.0157421983517%,0.775470936908419,0.749361475202784,0.726195278434084,32223,35629,52059
586,12,IDAHO,BOUNDARY,832,2797,3884,21.4212152420185%,72.0133882595263%,933,3789,5163,18.0708890180128%,73.3875653689715%,1220,4937,6313,19.3252019642009%,78.2037066370981%,0.770735739873243,0.802414231257941,0.801851551080071,3629,4722,6157
587,12,IDAHO,BUTTE,354,1054,1460,24.2465753424658%,72.1917808219178%,160,914,1230,13.0081300813008%,74.3089430894309%,188,1202,1415,13.2862190812721%,84.9469964664311%,0.748579545454545,0.851024208566108,0.864748201438849,1408,1074,1390
588,12,IDAHO,CAMAS,113,359,507,22.2879684418146%,70.8086785009862%,110,410,590,18.6440677966102%,69.4915254237288%,149,507,754,19.7612732095491%,67.2413793103448%,0.760593220338983,0.788461538461538,0.772865853658537,472,520,656
589,12,IDAHO,CANYON,10588,30560,43000,24.6232558139535%,71.0697674418605%,16883,47222,72785,23.1957134024868%,64.8787524902109%,25881,61759,90410,28.6262581572835%,68.3099214688641%,0.742684942160008,0.736635207862101,0.704689639434048,41148,64105,87640
590,12,IDAHO,CARIBOU,475,2601,3177,14.9512118350645%,81.8696883852691%,271,2275,3035,8.92915980230642%,74.9588138385502%,431,2906,3416,12.6170960187354%,85.0702576112412%,0.845578673602081,0.893558523173606,0.870842073718909,3076,2546,3337
591,12,IDAHO,CASSIA,1087,5983,7279,14.9333699684023%,82.1953565050144%,1036,5949,8178,12.6681340180973%,72.7439471753485%,1464,7907,9629,15.2040710354139%,82.1165230034272%,0.846251768033946,0.851682176091625,0.843773343293138,7070,6985,9371
592,12,IDAHO,CLARK,63,311,382,16.4921465968586%,81.413612565445%,44,203,283,15.547703180212%,71.7314487632509%,41,264,311,13.1832797427653%,84.887459807074%,0.831550802139037,0.821862348178138,0.865573770491803,374,247,305
593,12,IDAHO,CLEARWATER,841,2885,3896,21.5862422997947%,74.0503080082136%,704,2852,3801,18.5214417258616%,75.0328860826098%,877,3453,4419,19.8461190314551%,78.1398506449423%,0.774288781535158,0.802024746906637,0.797459584295612,3726,3556,4330
594,12,IDAHO,CUSTER,416,1794,2330,17.8540772532189%,76.9957081545064%,427,1777,2414,17.6884838442419%,73.6122618061309%,603,2089,2739,22.0153340635268%,76.2687112084702%,0.811764705882353,0.806261343012704,0.776002971768202,2210,2204,2692
595,12,IDAHO,ELMORE,1840,4891,6966,26.4140109101349%,70.212460522538%,1814,5816,8522,21.2860830790894%,68.2468904013142%,2601,7246,10205,25.4875061244488%,71.0044096031357%,0.726637943841925,0.762254259501966,0.73585863714837,6731,7630,9847
596,12,IDAHO,FRANKLIN,513,3594,4243,12.0905020032996%,84.7042187131746%,385,3901,5499,7.00127295871977%,70.9401709401709%,657,5845,6664,9.85894357743097%,87.7100840336134%,0.87509130752374,0.910172655156323,0.898954167948324,4107,4286,6502
597,12,IDAHO,FREMONT,699,4242,5088,13.7382075471698%,83.372641509434%,651,4090,5715,11.3910761154856%,71.5660542432196%,998,5548,6719,14.853400803691%,82.5718112814407%,0.85853066180935,0.862687196793925,0.84754048273755,4941,4741,6546
598,12,IDAHO,GEM,1346,4376,5983,22.4970750459636%,73.1405649339796%,1229,5980,7954,15.4513452351018%,75.1822982147347%,1803,7951,9958,18.1060453906407%,79.8453504719823%,0.764767563788885,0.829518657234013,0.815152757842936,5722,7209,9754
599,12,IDAHO,GOODING,1282,3502,5026,25.5073617190609%,69.6776760843613%,930,3743,5191,17.9156231939896%,72.1055673280678%,1256,4659,6050,20.7603305785124%,77.0082644628099%,0.732023411371238,0.800984378343676,0.787658495350803,4784,4673,5915
600,12,IDAHO,IDAHO,1187,5806,7452,15.9286097691895%,77.9119699409555%,1196,6441,8233,14.5269039232358%,78.2339365966233%,1561,7826,9602,16.2570297854614%,81.5038533638825%,0.83025883025883,0.843394002880712,0.833706189410887,6993,7637,9387
601,12,IDAHO,JEFFERSON,1100,6480,7836,14.037774374681%,82.6952526799387%,976,8436,11475,8.50544662309368%,73.516339869281%,1661,12099,14173,11.7194665914062%,85.3665420165103%,0.854881266490765,0.896302592435189,0.879287790697674,7580,9412,13760
602,12,IDAHO,JEROME,1360,4418,6007,22.6402530381222%,73.5475278841352%,1329,4644,6751,19.6859724485261%,68.7898089171974%,1893,5734,7812,24.2319508448541%,73.399897593446%,0.764624437521634,0.777498744349573,0.751802805821424,5778,5973,7627
603,12,IDAHO,KOOTENAI,13488,28162,43812,30.7860860038346%,64.2791929151831%,16264,44449,66310,24.5272206303725%,67.0321218519077%,24312,62837,89467,27.1742653715895%,70.234835190629%,0.676158463385354,0.732116680117932,0.721029501199096,41650,60713,87149
604,12,IDAHO,LATAH,5661,8161,15311,36.9734178041931%,53.3015479067337%,8093,7265,18173,44.5330985527981%,39.9768887910637%,10236,9472,20570,49.7617890131259%,46.0476421973748%,0.590435537548835,0.473043365021487,0.480617008321494,13822,15358,19708
605,12,IDAHO,LEMHI,660,2859,3641,18.1268882175227%,78.5223839604504%,733,3011,4096,17.8955078125%,73.5107421875%,1032,3592,4738,21.7813423385395%,75.8125791473196%,0.812446717817562,0.804220085470086,0.77681660899654,3519,3744,4624
606,12,IDAHO,LEWIS,335,1295,1688,19.845971563981%,76.718009478673%,270,1202,1590,16.9811320754717%,75.5974842767296%,349,1489,1870,18.6631016042781%,79.6256684491979%,0.794478527607362,0.816576086956522,0.810119695321001,1630,1472,1838
607,12,IDAHO,LINCOLN,437,1049,1574,27.7636594663278%,66.6454891994917%,360,1184,1748,20.5949656750572%,67.7345537757437%,414,1469,1940,21.340206185567%,75.7216494845361%,0.705921938088829,0.766839378238342,0.780138077535847,1486,1544,1883
608,12,IDAHO,MADISON,816,7941,8970,9.09698996655519%,88.5284280936455%,1201,8941,15688,7.65553289138195%,56.9926058133605%,2666,13559,17112,15.5797101449275%,79.2367928938756%,0.906817403220281,0.881581542102149,0.835685670261941,8757,10142,16225
609,12,IDAHO,MINIDOKA,1344,4907,6518,20.6198220312979%,75.2838293955201%,1167,4887,6871,16.9844273031582%,71.1250181924029%,1550,6265,7993,19.3919679719755%,78.381083448017%,0.784994400895857,0.807234886025768,0.801663467690339,6251,6054,7815
610,12,IDAHO,NEZ PERCE,4995,10577,16021,31.1778290993072%,66.0195992759503%,4828,10699,17201,28.0681355735132%,62.1998721004593%,6686,13738,20967,31.8882052749559%,65.5220107788429%,0.67923195479065,0.689057770335544,0.672640031335683,15572,15527,20424
611,12,IDAHO,ONEIDA,307,1426,1798,17.0745272525028%,79.3103448275862%,184,1531,2068,8.89748549323017%,74.0328820116054%,249,2148,2451,10.1591187270502%,87.6376988984088%,0.822850548182343,0.892711370262391,0.896120150187735,1733,1715,2397
612,12,IDAHO,OWYHEE,623,2450,3188,19.5420326223338%,76.8506900878294%,591,3052,3925,15.0573248407643%,77.7579617834395%,816,3819,4742,17.2079291438212%,80.5356389708984%,0.797266514806378,0.837771067801263,0.823948220064725,3073,3643,4635
613,12,IDAHO,PAYETTE,1643,4961,6858,23.957421988918%,72.3388743073783%,1507,6489,8704,17.3138786764706%,74.5519301470588%,2161,8862,11293,19.1357478083769%,78.4733905959444%,0.751211387038159,0.811530765382691,0.803955366052799,6604,7996,11023
614,12,IDAHO,POWER,755,1872,2709,27.8700627537837%,69.1029900332226%,699,1666,2758,25.3444525018129%,60.4060913705584%,865,2116,3074,28.1392322706571%,68.8353936239427%,0.712599923867529,0.704439746300211,0.709828916470983,2627,2365,2981
615,12,IDAHO,SHOSHONE,2225,2879,5385,41.3184772516249%,53.4633240482823%,1384,3297,5120,27.03125%,64.39453125%,1693,4216,6049,27.9880972061498%,69.6974706563068%,0.564067398119122,0.704336680196539,0.713487899813843,5104,4681,5909
616,12,IDAHO,TETON,720,1745,2671,26.9561961812055%,65.3313365780606%,2159,2167,4976,43.3882636655949%,43.5490353697749%,3318,2858,6347,52.2766661414842%,45.029147628801%,0.707910750507099,0.500924641701341,0.462759067357513,2465,4326,6176
617,12,IDAHO,TWIN FALLS,5777,15794,22530,25.641367066134%,70.1020861074124%,6233,19828,29874,20.8642967128607%,66.3720961371092%,9391,25897,36501,25.72806224487%,70.94874113038%,0.732186732186732,0.760830359541077,0.733875538426661,21571,26061,35288
618,12,IDAHO,VALLEY,1129,2548,3978,28.3810960281548%,64.0522875816994%,1913,2906,5349,35.763694148439%,54.3279117592073%,2976,3947,7063,42.1350700835339%,55.8827693614611%,0.69295621430514,0.603029674206267,0.570128556983967,3677,4819,6923
619,12,IDAHO,WASHINGTON,980,2899,4070,24.0786240786241%,71.2285012285012%,776,3283,4455,17.4186307519641%,73.692480359147%,1073,4154,5344,20.0785928143713%,77.7320359281437%,0.747357566383089,0.808819906380882,0.794719724507366,3879,4059,5227
621,13,ILLINOIS,ADAMS,12197,17331,30109,40.5094822146202%,57.5608622006709%,7676,22790,31951,24.0242871897593%,71.3279709555256%,8633,24220,33527,25.7493960091866%,72.2402839502491%,0.586934435112436,0.748047003216701,0.737223389036009,29528,30466,32853
622,13,ILLINOIS,ALEXANDER,2357,1588,4022,58.6026852312282%,39.4828443560418%,1262,1496,2846,44.3429374560787%,52.5650035137034%,1114,1486,2618,42.5515660809779%,56.7608861726509%,0.402534854245881,0.542422044960116,0.571538461538462,3945,2758,2600
623,13,ILLINOIS,BOND,3060,3804,7032,43.5153583617747%,54.0955631399318%,2068,4888,7530,27.4634794156707%,64.9136786188579%,2288,5625,8145,28.0908532842234%,69.060773480663%,0.554195804195804,0.702702702702703,0.710855554151396,6864,6956,7913
624,13,ILLINOIS,BOONE,6481,8617,15523,41.7509502029247%,55.5111769632159%,8986,12282,23001,39.067866614495%,53.3976783618104%,10542,13883,24979,42.203450898755%,55.5786860963209%,0.570737846072327,0.577487304871168,0.568393039918117,15098,21268,24425
625,13,ILLINOIS,BROWN,1077,1529,2660,40.4887218045113%,57.4812030075188%,476,1796,2379,20.0084068936528%,75.4939050021017%,486,1931,2521,19.2780642602142%,76.5965886552955%,0.58672294704528,0.790492957746479,0.798924286305337,2606,2272,2417
626,13,ILLINOIS,BUREAU,7754,8526,16823,46.0916602270701%,50.6806158235749%,6029,9281,16571,36.3828374871764%,56.0074829521453%,6669,10411,17434,38.2528392795687%,59.7166456349662%,0.523710073710074,0.60620509470934,0.609543325526932,16280,15310,17080
627,13,ILLINOIS,CALHOUN,1310,1229,2602,50.3458877786318%,47.2328977709454%,739,1721,2571,28.7436795021392%,66.9389342668223%,677,2046,2772,24.4227994227994%,73.8095238095238%,0.484048838125246,0.699593495934959,0.751377157546823,2539,2460,2723
628,13,ILLINOIS,CARROLL,3113,3835,7177,43.374669081789%,53.4345826947193%,2447,4434,7445,32.8676964405641%,59.5567494963063%,2748,5105,8024,34.247258225324%,63.6216350947159%,0.55195739781232,0.644383083854091,0.650070036928562,6948,6881,7853
629,13,ILLINOIS,CASS,2789,2968,5899,47.2791998643838%,50.313612476691%,1621,3216,5124,31.6354410616706%,62.7634660421546%,1615,3625,5317,30.374271205567%,68.177543727666%,0.515546291471252,0.664874922472607,0.691793893129771,5757,4837,5240
630,13,ILLINOIS,CHAMPAIGN,35515,34645,74285,47.8091135491687%,46.6379484418119%,50137,33368,91628,54.7179901340202%,36.4168158204916%,57067,35285,95142,59.9808706985348%,37.0866704504845%,0.493799885974914,0.399592838752171,0.382070772695773,70160,83505,92352
631,13,ILLINOIS,CHRISTIAN,6799,7537,14771,46.0293818969603%,51.0256583846727%,3992,10543,15459,25.8231450934731%,68.1997541884986%,4335,11563,16204,26.7526536657615%,71.3589237225377%,0.525739397321429,0.725352597179223,0.727324191722229,14336,14535,15898
632,13,ILLINOIS,CLARK,2932,4398,7512,39.0308839190628%,58.5463258785943%,1877,5622,7928,23.675580221998%,70.9132189707366%,1993,6226,8356,23.8511249401628%,74.5093346098612%,0.6,0.749699959994666,0.757513079450055,7330,7499,8219
633,13,ILLINOIS,CLAY,2212,3789,6135,36.0554197229014%,61.760391198044%,1020,5021,6350,16.0629921259843%,79.0708661417323%,1129,5629,6886,16.3955852454255%,81.7455707232065%,0.631394767538744,0.831153782486343,0.832938739271974,6001,6041,6758
634,13,ILLINOIS,CLINTON,6436,8588,15427,41.7190639787386%,55.6686329163156%,3945,12412,17419,22.6476835639244%,71.255525575521%,4493,14304,19170,23.4376630151278%,74.6165884194053%,0.571618743343983,0.758818854313138,0.760972495611002,15024,16357,18797
635,13,ILLINOIS,COLES,8904,10495,20093,44.3139401781715%,52.2321206390285%,7309,13003,21863,33.4309106709967%,59.4749119516992%,8067,14037,22606,35.6852163142529%,62.0941343006282%,0.541007268415898,0.640163450177235,0.635043431053203,19399,20312,22104
636,13,ILLINOIS,COOK,1280547,534542,1865907,68.6286615570872%,28.6478372180393%,1611946,453287,2158615,74.6750115235927%,20.9989738790845%,1725973,558269,2321486,74.3477669044741%,24.0479158607892%,0.294499057621968,0.219484678000013,0.244400111721963,1815089,2065233,2284242
637,13,ILLINOIS,CRAWFORD,3333,4974,8500,39.2117647058823%,58.5176470588235%,1992,6277,8728,22.8230980751604%,71.9179651695692%,2202,7043,9425,23.3633952254642%,74.7267904509284%,0.59877211989888,0.759100253960576,0.761817198485668,8307,8269,9245
638,13,ILLINOIS,CUMBERLAND,1870,2964,4975,37.5879396984925%,59.5778894472362%,1031,4206,5567,18.5198491108317%,75.5523621340039%,1142,4601,5832,19.5816186556927%,78.8923182441701%,0.613156805957799,0.803131563872446,0.801149225143653,4834,5237,5743
639,13,ILLINOIS,DE WITT,2870,3968,7051,40.703446319671%,56.2757055736775%,1910,5077,7543,25.3214901232931%,67.3074373591409%,2191,5632,8024,27.3055832502493%,70.1894317048853%,0.580286633518573,0.726635179619293,0.719928416208616,6838,6987,7823
640,13,ILLINOIS,DEKALB,14798,17139,33233,44.5280293683989%,51.5722324195829%,20466,19091,43600,46.9403669724771%,43.7866972477064%,24643,21905,47825,51.527443805541%,45.8024046001045%,0.536650280239221,0.482620016684784,0.470589499011773,31937,39557,46548
641,13,ILLINOIS,DOUGLAS,3215,4734,8152,39.4381746810599%,58.0716388616291%,1949,5698,8169,23.8584894111886%,69.751499571551%,2335,6227,8738,26.7223620965896%,71.2634470130465%,0.595546609636432,0.745128808683144,0.727283345012847,7949,7647,8562
642,13,ILLINOIS,DUPAGE,152550,201037,364362,41.8677029986662%,55.1750731415461%,228622,166415,428769,53.3205525586038%,38.8122742082567%,281222,193611,485104,57.9714865266005%,39.9112355288763%,0.568564455141167,0.421264337264611,0.407745459982773,353587,395037,474833
643,13,ILLINOIS,EDGAR,3216,4833,8232,39.067055393586%,58.7099125364432%,1793,5645,7873,22.7740378508828%,71.7007493966722%,1887,6193,8196,23.0234260614934%,75.5612493899463%,0.600447260529258,0.758940575423501,0.766460396039604,8049,7438,8080
644,13,ILLINOIS,EDWARDS,978,2212,3260,30%,67.8527607361963%,434,2778,3347,12.9668359725127%,82.9997012249776%,488,2833,3366,14.4979203802733%,84.1651812240048%,0.693416927899687,0.864881693648817,0.853056308340861,3190,3212,3321
645,13,ILLINOIS,EFFINGHAM,4225,9855,14485,29.1681049361408%,68.0358992060752%,3083,13635,17609,17.508092452723%,77.4319950025555%,3716,15006,19049,19.5075857000368%,78.7757887553152%,0.699928977272727,0.815587988993899,0.801516931951715,14080,16718,18722
646,13,ILLINOIS,FAYETTE,3886,5200,9338,41.6149068322981%,55.6864424930392%,1819,7372,9585,18.9775691184142%,76.9118414188837%,1826,8055,10056,18.1583134447096%,80.1014319809069%,0.572309046885318,0.802089000108802,0.815200890598118,9086,9191,9881
647,13,ILLINOIS,FORD,2090,3889,6153,33.9671704859418%,63.2049406793434%,1414,4480,6396,22.1075672295184%,70.0437773608505%,1754,5048,6953,25.2265209262189%,72.6017546382856%,0.65044321792942,0.760095011876485,0.742134666274625,5979,5894,6802
648,13,ILLINOIS,FRANKLIN,10201,8490,19212,53.0970226941495%,44.1911305434104%,4727,13116,18711,25.263214152103%,70.0978034311368%,4760,13622,18626,25.5556748630946%,73.134328358209%,0.454229308223209,0.735078181920081,0.741051028179741,18691,17843,18382
649,13,ILLINOIS,FULTON,8940,6936,16277,54.9241260674572%,42.6122749892486%,6133,8492,15797,38.8238273089827%,53.7570424764196%,6503,9867,16678,38.991485789663%,59.1617699964024%,0.436885865457294,0.580649572649573,0.602748930971289,15876,14625,16370
650,13,ILLINOIS,GALLATIN,1878,1591,3558,52.7824620573356%,44.7161326587971%,657,1942,2707,24.2704100480236%,71.7399335057259%,622,2019,2674,23.2610321615557%,75.5048616305161%,0.458633611991929,0.747210465563678,0.764483150321848,3469,2599,2641
651,13,ILLINOIS,GREENE,2490,3129,5767,43.176694988729%,54.2569793653546%,1205,4145,5585,21.5756490599821%,74.2166517457475%,1349,4770,6227,21.6637224987956%,76.6018949735025%,0.556860651361452,0.774766355140187,0.779539140382415,5619,5350,6119
652,13,ILLINOIS,GRUNDY,7516,8709,16584,45.3207911239749%,52.514471780029%,8065,13454,23237,34.7075784309506%,57.8990403236218%,9626,16523,26691,36.0645910606571%,61.9047619047619%,0.536764252696456,0.625214926344161,0.631878848139508,16225,21519,26149
653,13,ILLINOIS,HAMILTON,1943,2519,4587,42.3588402005668%,54.916067146283%,802,3206,4166,19.2510801728277%,76.9563130100816%,824,3432,4315,19.0961761297798%,79.5365005793743%,0.564545047064097,0.799900199600798,0.806390977443609,4462,4008,4256
654,13,ILLINOIS,HANCOCK,4256,5134,9691,43.9170364255495%,52.9769889588278%,2139,6430,9121,23.45137594562%,70.4966560684136%,2315,6906,9383,24.6722796546947%,73.601193648087%,0.546751863684771,0.750379274127669,0.74894263095109,9390,8569,9221
655,13,ILLINOIS,HARDIN,1184,1366,2637,44.899507015548%,51.8012893439515%,420,1653,2148,19.5530726256983%,76.9553072625698%,449,1691,2162,20.7678075855689%,78.2146160962072%,0.535686274509804,0.79739507959479,0.79018691588785,2550,2073,2140
656,13,ILLINOIS,HENDERSON,2030,1708,3866,52.5090532850492%,44.1800310398345%,1155,2155,3518,32.8311540648096%,61.2563956793633%,1187,2394,3647,32.5472991499863%,65.6429942418426%,0.456928838951311,0.651057401812689,0.668528344037978,3738,3310,3581
657,13,ILLINOIS,HENRY,11921,10896,23470,50.7925010651896%,46.4252236898168%,8871,13985,24643,35.9980521852047%,56.7503956498803%,9797,15300,25635,38.2172810610493%,59.6840257460503%,0.477538677302012,0.611874343717186,0.609634617683388,22817,22856,25097
658,13,ILLINOIS,IROQUOIS,4397,8685,13424,32.7547675804529%,64.6975566150179%,2504,9750,13064,19.1671769748928%,74.6325780771586%,2908,10877,14025,20.7344028520499%,77.554367201426%,0.663889313560618,0.795658560470051,0.789046064562931,13082,12254,13785
659,13,ILLINOIS,JACKSON,11773,9823,23090,50.9874404504114%,42.5422260718926%,11634,10843,24617,47.2600235609538%,44.0467969289515%,11181,10890,22643,49.3794991829705%,48.0943337896922%,0.454852750509354,0.482404235440673,0.493407638983281,21596,22477,22071
660,13,ILLINOIS,JASPER,1815,3119,5021,36.1481776538538%,62.1190997809201%,924,3975,5136,17.9906542056075%,77.3948598130841%,1007,4494,5576,18.0595408895265%,80.5954088952654%,0.632144304823672,0.811390079608083,0.816942374113797,4934,4899,5501
661,13,ILLINOIS,JEFFERSON,6685,8362,15360,43.5221354166667%,54.4401041666667%,4425,11695,16999,26.0309429966469%,68.7981645979175%,4608,12476,17404,26.4766720294185%,71.6846701907607%,0.555725393766199,0.725496277915633,0.73027394052915,15047,16120,17084
662,13,ILLINOIS,JERSEY,4355,4699,9413,46.265802613407%,49.9203229576118%,2679,7748,10991,24.3744882176326%,70.4940405786553%,2961,8712,11937,24.8052274440814%,72.9831615983916%,0.518997128341065,0.743070873693296,0.746337702390131,9054,10427,11673
663,13,ILLINOIS,JO DAVIESS,4585,5304,10322,44.4196861073435%,51.3853904282116%,4462,6121,11334,39.3682724545615%,54.0056467266631%,5109,7166,12496,40.8850832266325%,57.3463508322663%,0.536353524117707,0.578380421430596,0.583788187372709,9889,10583,12275
664,13,ILLINOIS,JOHNSON,1928,3285,5362,35.9567325624767%,61.2644535621037%,1142,4649,6089,18.7551322056167%,76.3507965183117%,1281,5059,6437,19.9005748019264%,78.5925120397701%,0.630155380778822,0.802797444310136,0.79794952681388,5213,5791,6340
665,13,ILLINOIS,KANE,60127,76996,141405,42.5211272585835%,54.450691276829%,103665,82734,199314,52.0108973780066%,41.5093771636714%,130166,96775,231876,56.1360382273284%,41.7356690645%,0.561510468703281,0.443854312523136,0.426432420761343,137123,186399,226941
666,13,ILLINOIS,KANKAKEE,19180,20049,40183,47.7316278028022%,49.894233879999%,18971,25129,47305,40.1035831307473%,53.1212345418032%,20271,28532,49902,40.6216183720091%,57.1760650875716%,0.511075989701496,0.569818594104308,0.584636190398131,39229,44100,48803
667,13,ILLINOIS,KENDALL,8444,13688,22769,37.0855110018007%,60.1168255083666%,24884,24961,53447,46.5582726813479%,46.7023406365184%,33168,29492,63974,51.8460624628755%,46.0999781161097%,0.618470992228447,0.50077239442271,0.470667092243856,22132,49845,62660
668,13,ILLINOIS,KNOX,12572,9912,23174,54.2504530939846%,42.7720721498231%,10083,10737,22243,45.3311154070944%,48.2713662725352%,10703,12009,23143,46.2472453873742%,51.8904204295035%,0.440846824408468,0.515706051873199,0.528751320887637,22484,20820,22712
669,13,ILLINOIS,LAKE,115058,120988,242164,47.5124295931683%,49.9611833303051%,171095,109767,303520,56.3702556668424%,36.164667896679%,204032,123594,334177,61.0550696187948%,36.9845919976539%,0.512561110969896,0.39082182708946,0.377241122499435,236046,280862,327626
670,13,ILLINOIS,LASALLE,23355,21276,46007,50.7640141717565%,46.2451366096464%,19543,26689,49743,39.2879400116599%,53.6537804314175%,22442,30113,53591,41.8764344759381%,56.1904051053349%,0.476709013914096,0.577284132202803,0.572980686899439,44631,46232,52555
671,13,ILLINOIS,LAWRENCE,2822,3594,6578,42.9005776831864%,54.636667680146%,1290,4521,6094,21.168362323597%,74.187725631769%,1419,4886,6411,22.1338324754328%,76.2127593199189%,0.560162094763092,0.778007227671657,0.774940523394132,6416,5811,6305
672,13,ILLINOIS,LEE,6111,8069,14620,41.7989056087551%,55.1915184678523%,5528,8612,15489,35.6898444057073%,55.6007489185874%,6407,9630,16397,39.074220894066%,58.730255534549%,0.569040902679831,0.609052333804809,0.600486375257218,14180,14140,16037
673,13,ILLINOIS,LIVINGSTON,5829,9187,15421,37.7991051163997%,59.574606056676%,4023,10208,15269,26.3475014735739%,66.8544108978977%,4615,12208,17174,26.8720158378945%,71.0841970420403%,0.611814064997336,0.717307286908861,0.725673185519824,15016,14231,16823
674,13,ILLINOIS,LOGAN,4600,8141,13065,35.2085725220054%,62.3115193264447%,3313,8181,12401,26.7155874526248%,65.9704862511088%,3840,9136,13294,28.885211373552%,68.7227320595757%,0.638960835099286,0.711762658778493,0.704069050554871,12741,11494,12976
675,13,ILLINOIS,MACON,24262,23830,49499,49.0151316188206%,48.1423867148831%,18343,26866,48060,38.1668747399084%,55.9009571369122%,19847,28589,49390,40.184247823446%,57.8841870824054%,0.495508608500374,0.594262204428322,0.590242794615575,48092,45209,48436
676,13,ILLINOIS,MACOUPIN,11015,9749,21389,51.49843377437%,45.5795034830988%,6689,14322,22360,29.9150268336315%,64.0518783542039%,7365,16153,24022,30.6593955540754%,67.2425276829573%,0.469514544403776,0.681642948931512,0.686835615273408,20764,21011,23518
677,13,ILLINOIS,MADISON,59077,48821,111104,53.1727030529954%,43.9417122695853%,50587,70490,130179,38.8595702839936%,54.1485185782653%,57836,76031,137139,42.1732694565368%,55.4408301066801%,0.452473632504773,0.582191497972365,0.567959243129375,107898,121077,133867
678,13,ILLINOIS,MARION,8068,8240,16663,48.4186521034628%,49.4508791934226%,4369,11859,17074,25.588614267307%,69.456483542228%,4524,12678,17458,25.9136212624585%,72.6200022912132%,0.505273485405936,0.730773970914469,0.737007324729683,16308,16228,17202
679,13,ILLINOIS,MARSHALL,2570,3145,5907,43.5077027255798%,53.241916370408%,1789,3785,5984,29.8963903743315%,63.2520053475936%,2005,4197,6334,31.6545626776129%,66.2614461635617%,0.550306211723535,0.679045568711877,0.67671718800387,5715,5574,6202
680,13,ILLINOIS,MASON,3192,3411,6772,47.1352628470171%,50.3691671588896%,2014,4058,6486,31.0514955288313%,62.5655257477644%,1985,4654,6766,29.3378657995862%,68.7851019804907%,0.516583371194911,0.668313570487484,0.701009188130743,6603,6072,6639
681,13,ILLINOIS,MASSAC,2912,3676,6744,43.1791221826809%,54.5077105575326%,1558,4846,6683,23.3128834355828%,72.5123447553494%,1725,4997,6813,25.3192426243945%,73.3450755907823%,0.557984213721919,0.756714553404122,0.743379946444511,6588,6404,6722
682,13,ILLINOIS,MCDONOUGH,6080,6465,13012,46.7260989855518%,49.6849062403935%,5288,6795,13092,40.3910785212343%,51.9019248395967%,4992,7027,12285,40.6349206349206%,57.1998371998372%,0.515344758868075,0.562360340974924,0.584657625426408,12545,12083,12019
683,13,ILLINOIS,MCHENRY,40698,62112,106185,38.3274473795734%,58.4941375900551%,60803,71612,141750,42.894532627866%,50.5199294532628%,78154,82260,163879,47.690064010642%,50.1955711225966%,0.604143565800992,0.540814862364536,0.512798134826137,102810,132415,160414
684,13,ILLINOIS,MCLEAN,24936,34008,60898,40.9471575421196%,55.8441984958455%,36196,37237,79835,45.3385106782739%,46.6424500532348%,43933,40502,87002,50.4965403094182%,46.5529528056826%,0.576954397394137,0.507088093908733,0.479682596079825,58944,73433,84435
685,13,ILLINOIS,MENARD,2164,3862,6202,34.8919703321509%,62.2702354079329%,1817,4231,6515,27.8894858019954%,64.9424405218726%,2022,4764,6928,29.1859122401848%,68.7644341801386%,0.64088947892466,0.699570105820106,0.702033598585323,6026,6048,6786
686,13,ILLINOIS,MERCER,4400,3688,8318,52.8973310892041%,44.3375811493147%,3071,4807,8525,36.0234604105572%,56.3870967741936%,3280,5418,8893,36.8829416394917%,60.9243225008434%,0.455984174085064,0.61018024879411,0.622901816509542,8088,7878,8698
687,13,ILLINOIS,MONROE,5797,7632,13796,42.0194259205567%,55.3203827196289%,5535,12629,19354,28.5987392787021%,65.2526609486411%,6569,14142,21148,31.0620389634954%,66.8715717798373%,0.568322287586566,0.695276370843427,0.682825551639226,13429,18164,20711
688,13,ILLINOIS,MONTGOMERY,6542,6226,13093,49.9656304895746%,47.5521270908119%,3504,8630,12978,26.9995376791493%,66.4971490214209%,3905,9544,13727,28.4475850513586%,69.5272091498507%,0.487625313283208,0.711224657985825,0.709643839690683,12768,12134,13449
689,13,ILLINOIS,MORGAN,5899,8058,14334,41.1538998186131%,56.2159899539556%,4696,9076,14800,31.7297297297297%,61.3243243243243%,5076,9950,15309,33.1569664902998%,64.9944477104971%,0.577344701583435,0.659018297995934,0.662185545055238,13957,13772,15026
690,13,ILLINOIS,MOULTRIE,2529,3058,5725,44.174672489083%,53.4148471615721%,1481,4455,6283,23.5715422568837%,70.9056183351902%,1662,4964,6744,24.644128113879%,73.6061684460261%,0.547342044030786,0.75050539083558,0.749169936613341,5587,5936,6626
691,13,ILLINOIS,OGLE,7673,12325,20601,37.2457647687006%,59.8271928547158%,8050,14352,24193,33.2740875459844%,59.3229446534121%,9428,16248,26272,35.8861144945189%,61.8453105968331%,0.616311631163116,0.640657084188912,0.632808848730332,19998,22402,25676
692,13,ILLINOIS,PEORIA,38604,36398,76812,50.2577722230902%,47.3858251314899%,38060,35633,78503,48.4822236092888%,45.3906220144453%,43578,38252,83973,51.8952520453003%,45.5527371893347%,0.485293725500653,0.48353303570217,0.467456922888916,75002,73693,81830
693,13,ILLINOIS,PERRY,4862,4802,9942,48.9036411184872%,48.3001408167371%,2462,6855,9853,24.9873135085761%,69.572718968842%,2612,7313,10053,25.982293842634%,72.7444543917239%,0.496895695364238,0.735751851454331,0.736826196473552,9664,9317,9925
694,13,ILLINOIS,PIATT,3488,4619,8385,41.59809183065%,55.0864639236732%,2645,5634,9008,29.3627886323268%,62.544404973357%,3329,6248,9822,33.8933007534107%,63.6122989207901%,0.569754533119526,0.680516970648629,0.652396366294247,8107,8279,9577
695,13,ILLINOIS,PIKE,3198,4706,8112,39.4230769230769%,58.0128205128205%,1413,5754,7530,18.7649402390438%,76.4143426294821%,1484,6332,7949,18.6690149704365%,79.6578185935338%,0.595394736842105,0.802846379238175,0.810133060388946,7904,7167,7816
696,13,ILLINOIS,POPE,927,1346,2330,39.7854077253219%,57.7682403433476%,375,1678,2142,17.5070028011204%,78.3380018674136%,433,1722,2175,19.9080459770115%,79.1724137931034%,0.592168939727233,0.817340477350219,0.79907192575406,2273,2053,2155
697,13,ILLINOIS,PULASKI,1518,1430,3016,50.3315649867374%,47.4137931034483%,962,1675,2735,35.1736745886654%,61.2431444241316%,891,1699,2624,33.9557926829268%,64.7484756097561%,0.485074626865672,0.635191505498673,0.655984555984556,2948,2637,2590
698,13,ILLINOIS,PUTNAM,1657,1437,3179,52.1233092167348%,45.2028939918213%,1147,1767,3111,36.8691738990678%,56.7984570877531%,1338,1993,3390,39.4690265486726%,58.7905604719764%,0.464447317388494,0.606382978723404,0.598318823176223,3094,2914,3331
699,13,ILLINOIS,RANDOLPH,6794,7127,14287,47.5537201651851%,49.8845103940645%,3439,10023,14194,24.2285472734958%,70.6143440890517%,3592,11076,14891,24.1219528574307%,74.3804982875562%,0.511960347676173,0.744540187193582,0.755113171529861,13921,13462,14668
700,13,ILLINOIS,RICHLAND,2491,4718,7428,33.5352719439957%,63.5164243403339%,1584,5739,7684,20.6142634044768%,74.6876626756898%,1830,6089,8063,22.6962668981769%,75.517797345901%,0.654459703148842,0.783695206882425,0.768910215936356,7209,7323,7919
701,13,ILLINOIS,ROCK ISLAND,37957,25194,65095,58.3101620708196%,38.7034334434288%,32298,26998,63994,50.4703565959309%,42.1883301559521%,36691,28603,66758,54.9612031516822%,42.8458012522844%,0.398948551883581,0.455308958445764,0.438064753269826,63151,59296,65294
702,13,ILLINOIS,SALINE,5427,5933,11650,46.5836909871245%,50.9270386266094%,2572,8276,11384,22.5931131412509%,72.6985242445538%,2789,8103,11066,25.2033255015362%,73.2242906199169%,0.522271126760563,0.762905604719764,0.743940506793977,11360,10848,10892
703,13,ILLINOIS,SANGAMON,38414,50374,91485,41.9893971689348%,55.062578564792%,40907,49944,98373,41.5835645959765%,50.7700283614406%,48917,53485,104752,46.6979150756072%,51.0586910035131%,0.567351443888814,0.54973528084446,0.522304251870081,88788,90851,102402
704,13,ILLINOIS,SCHUYLER,1587,2077,3772,42.0731707317073%,55.0636267232238%,1075,2524,3828,28.0825496342738%,65.9352142110763%,1068,2773,3906,27.3425499231951%,70.9933435739887%,0.566866812227074,0.701305918310642,0.721947409528769,3664,3599,3841
705,13,ILLINOIS,SCOTT,954,1458,2469,38.6391251518834%,59.052247873633%,535,1966,2608,20.5138036809816%,75.3834355828221%,572,2114,2737,20.8987943003288%,77.2378516624041%,0.604477611940298,0.786085565773691,0.787043931496649,2412,2501,2686
706,13,ILLINOIS,SHELBY,4018,5851,10163,39.5355702056479%,57.5715831939388%,2288,8229,11010,20.7811080835604%,74.7411444141689%,2504,9426,12097,20.6993469455237%,77.9201454906175%,0.592866551828959,0.782447466007417,0.79010896898575,9869,10517,11930
707,13,ILLINOIS,ST. CLAIR,55961,42299,100393,55.7419341985995%,42.1334156763918%,60756,53857,120580,50.3864654171504%,44.664952728479%,68325,57150,128091,53.3409841440851%,44.6167178021875%,0.430480358233259,0.469903065097328,0.455469216975493,98260,114613,125475
708,13,ILLINOIS,STARK,1211,1694,2989,40.5152224824356%,56.6744730679157%,751,1778,2743,27.3787823550857%,64.8195406489245%,815,2004,2883,28.2691640652098%,69.5109261186264%,0.583132530120482,0.703044681692369,0.710890386661937,2905,2529,2819
709,13,ILLINOIS,STEPHENSON,8062,10715,19378,41.6038806894416%,55.2946640520178%,7768,11083,20343,38.1851251044585%,54.4806567369611%,9055,12521,22048,41.0694847605225%,56.7897314949202%,0.57064493795601,0.587926369953849,0.580320726733407,18777,18851,21576
710,13,ILLINOIS,TAZEWELL,25379,31537,58348,43.4959210255707%,54.0498388976486%,20685,38707,64400,32.1195652173913%,60.1040372670808%,24819,42513,69052,35.9424781324219%,61.566645426635%,0.554097266146602,0.651720770474138,0.631393690964178,56916,59392,67332
711,13,ILLINOIS,UNION,3982,4397,8660,45.9815242494226%,50.7736720554273%,2402,5790,8537,28.1363476631135%,67.8224200538831%,2579,6161,8886,29.0231825343237%,69.3337834796309%,0.524764291681585,0.706787109375,0.704919908466819,8379,8192,8740
712,13,ILLINOIS,VERMILION,15406,15783,32100,47.993769470405%,49.1682242990654%,10039,19087,30570,32.8393850179915%,62.4370297677462%,10323,20725,31584,32.6842705167173%,65.6186676798379%,0.506043797492706,0.65532513905102,0.667514815769132,31189,29126,31048
713,13,ILLINOIS,WABASH,1987,3406,5508,36.0748002904866%,61.837327523602%,1151,4047,5464,21.0651537335286%,74.0666178623719%,1253,4237,5593,22.4030037546934%,75.7554085463973%,0.631559428889301,0.778568680261639,0.771766848816029,5393,5198,5490
714,13,ILLINOIS,WARREN,3524,3899,7631,46.1800550386581%,51.094220940899%,2987,4275,7807,38.2605354169335%,54.7585500192135%,3090,4676,7909,39.0694145909723%,59.1225186496397%,0.525259329112219,0.588680804186175,0.602111769250579,7423,7262,7766
715,13,ILLINOIS,WASHINGTON,2638,4353,7138,36.9571308489773%,60.983468758756%,1448,5571,7427,19.4964319375252%,75.0100982900229%,1641,6115,7902,20.7668944570995%,77.3854720323969%,0.622657702760692,0.793702806667617,0.788421866941723,6991,7019,7756
716,13,ILLINOIS,WAYNE,2209,5347,7693,28.7144157025868%,69.5047445729884%,1048,6967,8261,12.6861154823871%,84.336036799419%,1187,7176,8486,13.9877445203865%,84.5628093330191%,0.707649550026469,0.869245165315034,0.858065287576228,7556,8015,8363
717,13,ILLINOIS,WHITE,2958,4521,7637,38.7324865784994%,59.1986382087207%,1412,5640,7335,19.2501704158146%,76.8916155419223%,1517,5791,7421,20.4419889502762%,78.0353052149306%,0.604492579221821,0.79977311401021,0.792419266557198,7479,7052,7308
718,13,ILLINOIS,WHITESIDE,12886,11252,24837,51.8822724161533%,45.3033780247212%,11035,12615,25582,43.1357986083965%,49.3120162614338%,12253,14527,27375,44.7598173515982%,53.0666666666667%,0.466152953848703,0.533403805496829,0.542457057505601,24138,23650,26780
719,13,ILLINOIS,WILL,90902,95828,191670,47.4263056294673%,49.9963478896019%,151927,132720,300904,50.4901895621195%,44.1070906335576%,183915,155116,345105,53.2924762028948%,44.9474797525391%,0.5131901676217,0.466261720657516,0.457527482737567,186730,284647,339031
720,13,ILLINOIS,WILLIAMSON,12192,14012,26939,45.2578046698096%,52.0138089758343%,8581,21570,31852,26.940223533844%,67.719452467663%,10206,22801,33653,30.3271625115146%,67.7532463673372%,0.534727522515647,0.715399157573546,0.690792862120156,26204,30151,33007
721,13,ILLINOIS,WINNEBAGO,51981,53816,109297,47.5594023623704%,49.2383139518926%,55713,55624,118376,47.064438737582%,46.9892545786308%,64056,60861,127709,50.1577805792857%,47.6559991856486%,0.508672268589847,0.499600312564556,0.487211508441605,105797,111337,124917
722,13,ILLINOIS,WOODFORD,5529,10905,16793,32.9244327993807%,64.9377716905854%,5092,13207,19864,25.6343133306484%,66.4871123640757%,6160,14799,21432,28.7420679357969%,69.0509518477044%,0.663563344286236,0.721733428056178,0.706092847941219,16434,18299,20959
724,14,INDIANA,ADAMS,3775,8555,12590,29.9841143764893%,67.9507545671168%,2805,9648,13090,21.4285714285714%,73.7051184110008%,3236,10686,14209,22.7742979801534%,75.2058554437329%,0.693836171938362,0.774753071549024,0.767562131877604,12330,12453,13922
725,14,INDIANA,ALLEN,41636,70426,114320,36.4205738278516%,61.6042687193842%,55382,83930,147137,37.6397507085233%,57.0420764321687%,73189,92083,169082,43.2860978696727%,54.4605575992714%,0.628455676322036,0.602460663833697,0.557160317537151,112062,139312,165272
726,14,INDIANA,BARTHOLOMEW,9015,16200,25769,34.9838953781676%,62.8662346229966%,9841,20640,32490,30.2893197907048%,63.5272391505079%,12934,22410,36235,35.6947702497585%,61.8462812198151%,0.642474717430101,0.677143138348479,0.634053870529651,25215,30481,35344
727,14,INDIANA,BENTON,1328,2441,3874,34.279814145586%,63.0098089829633%,860,2579,3666,23.4588106928532%,70.3491543917076%,1009,3007,4114,24.5260087506077%,73.0918813806514%,0.647651897054922,0.749927304448968,0.748754980079681,3769,3439,4016
728,14,INDIANA,BLACKFORD,2103,2699,4893,42.9797670141018%,55.1604332720213%,1243,3350,4839,25.6871254391403%,69.2291795825584%,1376,3841,5351,25.7148196598767%,71.7809755185947%,0.562057476051645,0.729370781624211,0.736246885183055,4802,4593,5217
729,14,INDIANA,BOONE,4763,13161,18396,25.8914981517721%,71.542726679713%,10181,19654,32178,31.6396295605693%,61.0789980732177%,15244,22351,38520,39.5742471443406%,58.0244029075805%,0.73426690470877,0.658756494050612,0.594520547945205,17924,29835,37595
730,14,INDIANA,BROWN,2608,3871,6817,38.2572979316415%,56.7845093149479%,2518,5016,7945,31.6928886091882%,63.1340465701699%,3036,5777,8981,33.8046988085959%,64.3246854470549%,0.597468745176725,0.665781789222193,0.65550890729604,6479,7534,8813
731,14,INDIANA,CARROLL,2965,5102,8268,35.8611514271892%,61.7077890662796%,1892,6273,8643,21.8905472636816%,72.5789656369316%,2224,7086,9495,23.4228541337546%,74.6287519747235%,0.632453204413041,0.768279240661359,0.761117078410311,8067,8165,9310
732,14,INDIANA,CASS,5412,9305,15106,35.826823778631%,61.5980405137032%,3759,9701,14209,26.4550636920262%,68.2736293898234%,4304,10552,15198,28.3195157257534%,69.4301881826556%,0.6322620099205,0.72072808320951,0.710285406569736,14717,13460,14856
733,14,INDIANA,CLARK,17360,19417,37336,46.4966788086565%,52.0061067066638%,18808,30035,51147,36.7724402213229%,58.7228967485874%,23093,33668,57869,39.9056489657675%,58.1796816948625%,0.527965848220355,0.614929467886903,0.593153749933934,36777,48843,56761
734,14,INDIANA,CLAY,3605,6393,10158,35.4892695412483%,62.9356172474897%,2306,8531,11282,20.4396383619926%,75.6160255273888%,2552,9499,12267,20.8037825059102%,77.4353957772887%,0.639427885577115,0.787210482605887,0.7882333416314,9998,10837,12051
735,14,INDIANA,CLINTON,3643,7141,10991,33.1453007005732%,64.9713401874261%,2819,8531,11936,23.6176273458445%,71.472855227882%,3361,9334,12949,25.9556722526836%,72.0827863155456%,0.66218471810089,0.751629955947137,0.735250098463962,10784,11350,12695
736,14,INDIANA,CRAWFORD,1817,2327,4209,43.1693989071038%,55.2862912805892%,1323,3015,4593,28.8047028086218%,65.643370346179%,1355,3483,4944,27.4069579288026%,70.4490291262136%,0.561534749034749,0.695020746887967,0.719925589086399,4144,4338,4838
737,14,INDIANA,DAVIESS,2697,6872,9761,27.630365741215%,70.4026226821023%,1800,8545,10768,16.7161961367013%,79.3554977711738%,2169,9576,11954,18.1445541241425%,80.1070771289945%,0.718152367018497,0.826002899951667,0.815325670498084,9569,10345,11745
738,14,INDIANA,DEARBORN,6020,11452,17650,34.1076487252125%,64.8838526912181%,4883,18113,23987,20.3568599658148%,75.5117355234085%,5446,19528,25383,21.4553047315132%,76.9333806090691%,0.655448717948718,0.787658723256218,0.781933210538961,17472,22996,24974
739,14,INDIANA,DECATUR,2889,6115,9171,31.5014720314033%,66.6775706029877%,2121,8490,11127,19.0617417093556%,76.3008897276894%,2439,9575,12287,19.8502482298364%,77.927891267193%,0.679142603287428,0.800113090189426,0.796986848676544,9004,10611,12014
740,14,INDIANA,DEKALB,4776,8701,13785,34.6463547334059%,63.1193326079071%,3942,12054,16902,23.3226837060703%,71.3170039048633%,4966,14237,19628,25.3005909924598%,72.5341349093132%,0.645618461081843,0.753563390847712,0.741394573764516,13477,15996,19203
741,14,INDIANA,DELAWARE,20876,22105,44147,47.2874714023603%,50.0713525267855%,18153,24263,45123,40.2300378964165%,53.7708042461716%,20474,26827,48191,42.4851113278413%,55.668070801602%,0.514297014960099,0.572024707657488,0.567155028434917,42981,42416,47301
742,14,INDIANA,DUBOIS,5090,10134,15504,32.8302373581011%,65.3637770897833%,5389,13365,19984,26.9665732586069%,66.8785028022418%,6292,15033,21770,28.9021589343133%,69.0537436839688%,0.665659485023647,0.712647968433401,0.704947245017585,15224,18754,21325
743,14,INDIANA,ELKHART,16402,36756,54482,30.1053558973606%,67.4644836826842%,20740,41867,65630,31.6014017979582%,63.7924729544416%,26108,46972,74387,35.0975304824768%,63.1454420799333%,0.691448135746266,0.668727139137796,0.642747673782157,53158,62607,73080
744,14,INDIANA,FAYETTE,3415,5060,8647,39.4934659419452%,58.5174048803053%,2252,6839,9530,23.6306400839454%,71.7628541448059%,2237,7755,10136,22.0698500394633%,76.5094711917916%,0.597050147492625,0.752282477175228,0.776120896717374,8475,9091,9992
745,14,INDIANA,FLOYD,13209,16486,30030,43.986013986014%,54.8984348984349%,13945,21432,37425,37.2611890447562%,57.2665330661323%,17511,23400,41802,41.8903401751112%,55.978182862064%,0.555177639333221,0.605817338949035,0.571973307912297,29695,35377,40911
746,14,INDIANA,FOUNTAIN,2717,4408,7281,37.3163027056723%,60.5411344595523%,1476,5662,7492,19.7010144153764%,75.5739455419114%,1629,6154,7986,20.3981968444778%,77.0598547458052%,0.618666666666667,0.793219389184646,0.790697674418605,7125,7138,7783
747,14,INDIANA,FRANKLIN,2591,5587,8339,31.0708718071711%,66.9984410600791%,1969,8669,11013,17.8788704258603%,78.7160628348316%,2137,9691,12000,17.8083333333333%,80.7583333333333%,0.683174370261678,0.814908817446888,0.819327020629016,8178,10638,11828
748,14,INDIANA,FULTON,2960,5218,8327,35.5470157319563%,62.6636243545094%,1960,6010,8374,23.4057797946023%,71.7697635538572%,2280,6694,9147,24.9262053132174%,73.1824641959112%,0.638053313768648,0.754077791718946,0.745932694450635,8178,7970,8974
749,14,INDIANA,GIBSON,5802,7734,13772,42.1289573046762%,56.1574208539065%,3721,11081,15484,24.0312580728494%,71.5641952983725%,4023,11817,16161,24.8932615555968%,73.1204752181177%,0.57136524822695,0.748615052019997,0.746022727272727,13536,14802,15840
750,14,INDIANA,GRANT,9712,16153,26386,36.8073978625028%,61.2180701887364%,7010,17008,25312,27.6943742098609%,67.1934260429836%,8015,18543,27159,29.5113958540447%,68.2757097094886%,0.624511888652619,0.708135564992922,0.698207696362678,25865,24018,26558
751,14,INDIANA,GREENE,4898,7452,12619,38.8144860924003%,59.0538077502179%,2929,10277,13801,21.2230997753786%,74.4656184334469%,3389,11103,14784,22.9234307359307%,75.101461038961%,0.603400809716599,0.778206875662578,0.766146839635661,12350,13206,14492
752,14,INDIANA,HAMILTON,18002,56372,75926,23.709928087875%,74.2459763453889%,57263,87404,154256,37.1220568405767%,56.6616533554611%,88390,101587,193999,45.5620905262398%,52.3647029108397%,0.75795304810821,0.604173723102021,0.534733151907863,74374,144667,189977
753,14,INDIANA,HANCOCK,6503,15943,22950,28.3355119825708%,69.4684095860567%,8904,25074,36181,24.6096017246621%,69.3015671208645%,12895,28996,42911,30.0505697839715%,67.57241732889%,0.710282455671389,0.737948084054388,0.69217731732353,22446,33978,41891
754,14,INDIANA,HARRISON,5870,8711,14896,39.406552094522%,58.4787862513426%,4783,12943,18558,25.7732514279556%,69.7435068434099%,5343,14565,20236,26.4034394149041%,71.9756868946432%,0.597421301693985,0.730170371206138,0.73161543098252,14581,17726,19908
755,14,INDIANA,HENDRICKS,10786,28651,40221,26.8168369757092%,71.2339325228115%,22600,48337,75559,29.9104011434773%,63.9725247819585%,32604,53802,88505,36.8385966894526%,60.789785887803%,0.726500494459518,0.681407446043673,0.622665092701896,39437,70937,86406
756,14,INDIANA,HENRY,7647,10321,18315,41.7526617526618%,56.3527163527164%,5124,13895,20155,25.4229719672538%,68.9407095013644%,5544,15043,21030,26.3623395149786%,71.5311459819306%,0.574410062333036,0.730585204269415,0.730703842230534,17968,19019,20587
757,14,INDIANA,HOWARD,12899,20331,34095,37.8325267634551%,59.6304443466784%,11215,23675,36843,30.4399750291779%,64.2591537062671%,13303,26449,40630,32.7418163918287%,65.0972188038395%,0.611826662654228,0.678561192318716,0.665350171060576,33230,34890,39752
758,14,INDIANA,HUNTINGTON,4119,10113,14620,28.1737346101231%,69.172366621067%,3506,11649,16043,21.853767998504%,72.6111076481955%,4255,13147,17829,23.8656122048348%,73.7394133153851%,0.710581787521079,0.768657208841966,0.755487874956901,14232,15155,17402
759,14,INDIANA,JACKSON,5330,9054,14602,36.5018490617724%,62.0052047664703%,3843,12859,17573,21.8687759631252%,73.174756729073%,4302,14555,19238,22.361991891049%,75.6575527601622%,0.629449388209121,0.769907795473596,0.771861908044758,14384,16702,18857
760,14,INDIANA,JASPER,3744,7212,11167,33.5273573923166%,64.5831467717382%,3329,9382,13378,24.8841381372402%,70.1300642846464%,3798,11383,15475,24.5428109854604%,73.5573505654281%,0.658269441401971,0.738100857524978,0.74981885251301,10956,12711,15181
761,14,INDIANA,JAY,3167,4687,8030,39.439601494396%,58.3686176836862%,1889,5697,7986,23.6538943150513%,71.3373403456048%,1926,6361,8461,22.7632667533388%,75.1802387424654%,0.59676597911892,0.750988663327182,0.767587788101846,7854,7586,8287
762,14,INDIANA,JEFFERSON,5117,6582,11931,42.8882742435672%,55.1672114659291%,4326,8546,13544,31.9403425871235%,63.0980507974011%,4731,9663,14697,32.1902429067157%,65.7481118595632%,0.562612189075989,0.663921690490988,0.671321383909962,11699,12872,14394
763,14,INDIANA,JENNINGS,3549,5732,9494,37.3815041078576%,60.3749736675795%,2364,8224,11150,21.2017937219731%,73.7578475336323%,2523,9490,12251,20.5942372051261%,77.4630642396539%,0.617605861437345,0.776728371741594,0.789977524348622,9281,10588,12013
764,14,INDIANA,JOHNSON,11952,29404,42284,28.266010784221%,69.5393056475263%,17318,45456,66500,26.0421052631579%,68.3548872180451%,24736,51219,77618,31.8688963900126%,65.9885593547888%,0.710997195086565,0.724121451556377,0.674333486933053,41356,62774,75955
765,14,INDIANA,KNOX,6300,8485,15054,41.8493423674771%,56.3637571409592%,3772,11077,15516,24.3103892755865%,71.3908223769013%,4067,11655,16011,25.4012866154519%,72.7937043282743%,0.573892458572878,0.745976160010775,0.741317898486198,14785,14849,15722
766,14,INDIANA,KOSCIUSKO,5785,19040,25284,22.8800822654643%,75.3045404208195%,6313,23935,32084,19.6764742550804%,74.6010472509662%,8364,26499,35787,23.3716153910638%,74.0464414452175%,0.766968781470292,0.791291986247025,0.760089493158936,24825,30248,34863
767,14,INDIANA,LAGRANGE,2733,5437,8333,32.7973118924757%,65.2466098643946%,2080,7025,9566,21.7436755174577%,73.4371733221827%,2355,8110,10633,22.1480297188%,76.271983447757%,0.665483476132191,0.771554091158704,0.774964166268514,8170,9105,10465
768,14,INDIANA,LAKE,109078,63389,175994,61.9782492584975%,36.0177051490392%,116935,75625,201205,58.1173430083746%,37.5860440843915%,124870,91760,219956,56.7704449980905%,41.7174343959701%,0.367542776299234,0.392734732031575,0.423579374971149,172467,192560,216630
769,14,INDIANA,LAPORTE,19736,18994,39747,49.6540619417818%,47.7872543839787%,19798,22687,45203,43.7979780103091%,50.1891467380484%,22427,25997,49392,45.4061386459346%,52.6340298023972%,0.490420862380584,0.534000235377192,0.536861886667768,38730,42485,48424
770,14,INDIANA,LAWRENCE,5071,10677,16142,31.4149423863214%,66.1442200470821%,4210,14035,19152,21.9820384294068%,73.2821637426901%,4961,15601,21025,23.5957193816885%,74.2021403091558%,0.677990855981712,0.769251849821869,0.758729695554907,15748,18245,20562
771,14,INDIANA,MADISON,23403,27956,52216,44.8195955262755%,53.5391450896277%,18595,32376,53909,34.493312804912%,60.0567623216903%,19524,31215,51793,37.6962137740621%,60.2687621879405%,0.544325239977414,0.635184712875949,0.615207237036599,51359,50971,50739
772,14,INDIANA,MARION,134189,137810,279903,47.9412510762657%,49.2349135236135%,212899,130360,362372,58.7515039793361%,35.9740818827062%,247772,134175,389619,63.5934079190183%,34.4374889314946%,0.506656274471597,0.379771542770911,0.351292194990404,271999,343259,381947
773,14,INDIANA,MARSHALL,5541,10266,16150,34.3095975232198%,63.5665634674923%,4798,12288,18082,26.5346753677691%,67.9570843933193%,5712,13844,19927,28.6646258844783%,69.4735785617504%,0.649459100398558,0.719185297904717,0.707915729187973,15807,17086,19556
774,14,INDIANA,MARTIN,1518,3008,4609,32.9355608591885%,65.263614666956%,881,3697,4809,18.3198170097733%,76.876689540445%,1011,4029,5144,19.653965785381%,78.3242612752722%,0.664604507291206,0.807557885539537,0.799404761904762,4526,4578,5040
775,14,INDIANA,MIAMI,4155,8401,12928,32.1395420792079%,64.9829826732673%,2766,9975,13482,20.5162438807299%,73.98753894081%,3235,10925,14473,22.351965729289%,75.4853865819112%,0.669082510353616,0.782905580409701,0.771539548022599,12556,12741,14160
776,14,INDIANA,MONROE,17523,19147,40220,43.5678766782695%,47.6056688214818%,34216,20592,58454,58.534916344476%,35.2277004140007%,39861,22071,63151,63.1201406153505%,34.9495653275483%,0.522143441505318,0.375711574952562,0.356374733578764,36670,54808,61932
777,14,INDIANA,MONTGOMERY,3899,8891,13101,29.7610869399282%,67.8650484695825%,3362,11059,15156,22.1826339403537%,72.9678015307469%,4213,12659,17198,24.4970345388999%,73.6073962088615%,0.695152462861611,0.766867762291103,0.750296348980559,12790,14421,16872
778,14,INDIANA,MORGAN,6228,15286,22036,28.2628426211654%,69.3683064076965%,6040,23674,31280,19.309462915601%,75.6841432225064%,7781,27512,36159,21.5188473132553%,76.0861749495285%,0.710514083852375,0.796728814700141,0.779531351826141,21514,29714,35293
779,14,INDIANA,NEWTON,2101,3250,5510,38.1306715063521%,58.983666061706%,1404,4077,5795,24.227782571182%,70.3537532355479%,1509,4942,6591,22.8948566226673%,74.9810347443484%,0.607363109699122,0.74384236453202,0.766082777863897,5351,5481,6451
780,14,INDIANA,NOBLE,4822,9103,14216,33.9195272931908%,64.0334833989871%,3904,12198,16890,23.1142687981054%,72.2202486678508%,4660,14195,19190,24.2834809796769%,73.970818134445%,0.653716337522442,0.75754564650354,0.752850702731371,13925,16102,18855
781,14,INDIANA,OHIO,951,1515,2492,38.1621187800963%,60.7945425361156%,686,2118,2921,23.4851078397809%,72.5094145840466%,668,2054,3075,21.7235772357724%,66.7967479674797%,0.614355231143552,0.755349500713267,0.754592211609111,2466,2804,2722
782,14,INDIANA,ORANGE,2601,4687,7458,34.875301689461%,62.8452668275677%,2048,5803,8192,25%,70.83740234375%,2224,6432,8832,25.1811594202899%,72.8260869565217%,0.643111964873765,0.739141510635588,0.743068391866913,7288,7851,8656
783,14,INDIANA,OWEN,2253,4019,6503,34.6455482085191%,61.802245117638%,1946,6153,8557,22.7416150520042%,71.9060418370924%,2420,7286,9904,24.4345718901454%,73.5662358642973%,0.64078443877551,0.759723422644771,0.750669688852256,6272,8099,9706
784,14,INDIANA,PARKE,2481,3841,6447,38.4830153559795%,59.5780983403133%,1441,4863,6582,21.8930416286843%,73.8833181403829%,1503,5400,7013,21.4316269784686%,76.9998574076715%,0.607560898449858,0.771414974619289,0.782268578878748,6322,6304,6903
785,14,INDIANA,PERRY,3823,3461,7387,51.753079734669%,46.8525788547448%,3062,4556,8055,38.0136561142148%,56.5611421477343%,3203,5345,8722,36.7232286172896%,61.2818160972254%,0.475151015925316,0.59805723286952,0.625292466073935,7284,7618,8548
786,14,INDIANA,PIKE,2605,3566,6302,41.3360837829261%,56.585211044113%,1297,4398,5977,21.6998494227874%,73.5820645808934%,1415,4692,6220,22.7491961414791%,75.4340836012862%,0.577864203532653,0.77225636523266,0.768298673653185,6171,5695,6107
787,14,INDIANA,PORTER,26790,31157,59378,45.117720367813%,52.4722961366163%,33676,38832,77190,43.6274128773157%,50.3070345899728%,39746,45008,86509,45.944352610711%,52.0269567328255%,0.537680984347766,0.535554697412699,0.531042782641527,57947,72508,84754
788,14,INDIANA,POSEY,4430,6498,11110,39.8739873987399%,58.4878487848785%,3521,8404,12467,28.2425603593487%,67.4099623004733%,3811,9206,13236,28.7926866122696%,69.5527349652463%,0.594619326500732,0.704737945492662,0.70722900822002,10928,11925,13017
789,14,INDIANA,PULASKI,1919,3497,5518,34.7770931496919%,63.374411018485%,1327,3854,5459,24.3084814068511%,70.5990108078403%,1463,4246,5806,25.1980709610747%,73.1312435411643%,0.645679468242245,0.743871839413241,0.74373795761079,5416,5181,5709
790,14,INDIANA,PUTNAM,4123,7352,11871,34.7316990986438%,61.9324404009772%,3356,10637,14715,22.8066598708801%,72.2867821950391%,3946,12278,16597,23.7753810929686%,73.9772247996626%,0.640697167755991,0.760165797184306,0.756780078895464,11475,13993,16224
791,14,INDIANA,RANDOLPH,3906,6020,10132,38.5511251480458%,59.4157125937623%,2446,7517,10458,23.3887932683113%,71.8779881430484%,2513,8312,11070,22.7009936766034%,75.0858175248419%,0.606488011283498,0.754491618990264,0.767852193995381,9926,9963,10825
792,14,INDIANA,RIPLEY,3498,6988,10675,32.768149882904%,65.4613583138173%,2471,9806,12810,19.2896174863388%,76.5495706479313%,2774,11261,14271,19.4380211617967%,78.9082755237895%,0.666412359336258,0.798729331269854,0.802351264695404,10486,12277,14035
793,14,INDIANA,RUSH,2370,4749,7284,32.5370675453048%,65.1976935749588%,1525,5292,7214,21.139451067369%,73.357360687552%,1754,6035,7932,22.1129601613717%,76.0842158345941%,0.66708807416772,0.776294557723339,0.774810630376171,7119,6817,7789
794,14,INDIANA,SCOTT,3915,3761,7846,49.898037216416%,47.9352536324242%,2642,6074,9101,29.0297769475882%,66.7399186902538%,2701,7331,10167,26.5663420871447%,72.1058325956526%,0.489968733715477,0.696879302432308,0.730761562998405,7676,8716,10032
795,14,INDIANA,SHELBY,5374,9590,15310,35.1012410189419%,62.63879817113%,4247,12718,17994,23.6023118817384%,70.6791152606424%,5023,14568,19991,25.1263068380771%,72.8727927567405%,0.64087142475274,0.749661066902446,0.743606758205298,14964,16965,19591
796,14,INDIANA,SPENCER,3752,5096,8987,41.749193279181%,56.7041281851563%,2861,6572,9979,28.6702074356148%,65.8583024351137%,3213,7357,10769,29.8356393351286%,68.316463924227%,0.575949367088608,0.696703063712499,0.696026490066225,8848,9433,10570
797,14,INDIANA,ST. JOSEPH,47703,47581,97474,48.939204300634%,48.8140427190841%,52252,52021,110060,47.4759222242413%,47.2660367072506%,59896,53164,115238,51.9759107238932%,46.1340877141221%,0.499359808572268,0.498892330708812,0.470228197417301,95284,104273,113060
798,14,INDIANA,STARKE,4136,4349,8701,47.5347661188369%,49.9827606022296%,2489,6367,9226,26.9781053544331%,69.0114892694559%,2650,7466,10290,25.7531584062196%,72.555879494655%,0.512551561579258,0.718947606142728,0.738038750494266,8485,8856,10116
799,14,INDIANA,STEUBEN,4103,6953,11277,36.3837900150749%,61.6564689190388%,3744,10133,14566,25.7036935328848%,69.5661128655774%,4513,11327,16162,27.9235243162975%,70.084148001485%,0.628889290882779,0.730201052100598,0.715088383838384,11056,13877,15840
800,14,INDIANA,SULLIVAN,3833,4319,8262,46.3931251512951%,52.2754780924716%,2113,6138,8559,24.6874634887253%,71.713985278654%,2153,6691,8994,23.9381810095619%,74.3940404714254%,0.529808635917566,0.743909829111623,0.756558118498417,8152,8251,8844
801,14,INDIANA,SWITZERLAND,1336,1831,3239,41.2472985489349%,56.5297931460327%,930,2558,3699,25.1419302514193%,69.1538253582049%,964,3133,4154,23.2065479056331%,75.4212806933077%,0.578149668455952,0.733371559633028,0.764705882352941,3167,3488,4097
802,14,INDIANA,TIPPECANOE,18220,26106,46295,39.3563019764553%,56.3905389350902%,27282,30768,62515,43.6407262257058%,49.2169879228985%,35017,34581,71448,49.0104691523906%,48.400235136043%,0.588954563912828,0.530025839793282,0.496867726084083,44326,58050,69598
803,14,INDIANA,TIPTON,2392,4784,7316,32.6954620010935%,65.390924002187%,1587,5589,7510,21.1318242343542%,74.4207723035952%,1834,6110,8116,22.5973385904386%,75.2833908329226%,0.666666666666667,0.778846153846154,0.769133937562941,7176,7176,7944
804,14,INDIANA,UNION,927,1838,2828,32.7793493635078%,64.992927864215%,715,2445,3291,21.7259191735035%,74.2935278030994%,736,2688,3483,21.131208728108%,77.1748492678725%,0.664737793851718,0.77373417721519,0.785046728971963,2765,3160,3424
805,14,INDIANA,VANDERBURGH,29222,35846,66221,44.1279956509264%,54.1308648313979%,28530,40496,72507,39.3479250279283%,55.8511591984222%,34415,41844,77662,44.3138214313306%,53.8796322525817%,0.550900596299256,0.586677483846666,0.548709004838773,65068,69026,76259
806,14,INDIANA,VERMILLION,3370,3130,6633,50.8065731946329%,47.1883009196442%,2081,4513,6939,29.9899120910794%,65.0381899409137%,2145,5184,7481,28.6726373479481%,69.2955487234327%,0.481538461538462,0.684410069760388,0.707327056897258,6500,6594,7329
807,14,INDIANA,VIGO,17570,18021,36228,48.4983990283758%,49.743292480954%,15931,21937,39818,40.0095434225727%,55.0931739414335%,18123,24545,43594,41.5722347111988%,56.3036197641877%,0.50633587142817,0.57930178514841,0.575255460766851,35591,37868,42668
808,14,INDIANA,WABASH,4277,8321,12883,33.1987891019173%,64.5889932469145%,3018,9821,13468,22.4086724086724%,72.9209979209979%,3494,10762,14576,23.9709110867179%,73.8336992316136%,0.660501666931259,0.764934963782226,0.754910213243547,12598,12839,14256
809,14,INDIANA,WARREN,1471,2218,3768,39.0392781316348%,58.864118895966%,839,2898,3930,21.3486005089058%,73.7404580152672%,974,3401,4472,21.7799642218247%,76.0509838998211%,0.60124695039306,0.775488359646776,0.777371428571429,3689,3737,4375
810,14,INDIANA,WARRICK,8749,13205,22309,39.2173562239455%,59.1913577479941%,9086,19113,29589,30.7073574639224%,64.5949508263206%,11923,21326,33829,35.2449082148453%,63.0405864790564%,0.601484923020862,0.677789992552927,0.641402748954856,21954,28199,33249
811,14,INDIANA,WASHINGTON,3675,5868,9801,37.4961738598102%,59.8714416896235%,2636,8209,11382,23.1593744508874%,72.1226497979266%,2784,9114,12139,22.9343438503995%,75.0803196309416%,0.614900974536309,0.756938681420009,0.766011094301563,9543,10845,11898
812,14,INDIANA,WAYNE,10273,14273,25151,40.845294421693%,56.7492346228778%,8322,16028,25579,32.534500957817%,62.6607764181555%,9524,17567,27679,34.4087575418187%,63.4668882546335%,0.58147967082213,0.6582340862423,0.64844413273781,24546,24350,27091
813,14,INDIANA,WELLS,3319,7755,11281,29.4211506072157%,68.7439056821204%,2586,10005,13185,19.613196814562%,75.8816837315131%,2928,10855,14050,20.8398576512455%,77.2597864768683%,0.70028896514358,0.794615201334286,0.787564390916346,11074,12591,13783
814,14,INDIANA,WHITE,3655,6037,9904,36.904281098546%,60.955169628433%,2590,6893,10053,25.7634536954143%,68.5665970357107%,3032,7957,11166,27.1538599319362%,71.2609708042271%,0.622884853487412,0.726879679426342,0.724087724087724,9692,9483,10989
815,14,INDIANA,WHITLEY,4107,8080,12432,33.0357142857143%,64.993564993565%,3379,11358,15623,21.6283684311592%,72.7005056647251%,4234,12862,17556,24.1171109592162%,73.2627022100706%,0.663001559038319,0.770713170930311,0.752339728591483,12187,14737,17096
817,15,IOWA,ADAIR,1753,2275,4123,42.5175842832889%,55.1782682512734%,1133,2461,3811,29.7297297297297%,64.576226712149%,1198,2922,4177,28.6808714388317%,69.9545128082356%,0.564796425024826,0.684752365052866,0.709223300970874,4028,3594,4120
818,15,IOWA,ADAMS,897,1170,2145,41.8181818181818%,54.5454545454545%,565,1395,2106,26.8281101614435%,66.2393162393162%,590,1535,2160,27.3148148148148%,71.0648148148148%,0.566037735849057,0.711734693877551,0.722352941176471,2067,1960,2125
819,15,IOWA,ALLAMAKEE,2883,3277,6462,44.6146703806871%,50.7118539151965%,2421,4093,6923,34.9703885598729%,59.1217680196447%,2576,4744,7422,34.7076259768257%,63.918081379682%,0.53198051948052,0.628338962235186,0.648087431693989,6160,6514,7320
820,15,IOWA,APPANOOSE,2560,2992,5704,44.8807854137447%,52.4544179523142%,1814,4033,6136,29.5632333767927%,65.7268578878748%,1891,4522,6516,29.0208717004297%,69.3984039287907%,0.538904899135447,0.689755430135112,0.705130204272571,5552,5847,6413
821,15,IOWA,AUDUBON,1780,1909,3784,47.0401691331924%,50.4492600422833%,1080,2136,3412,31.6529894490035%,62.6025791324736%,1071,2299,3420,31.3157894736842%,67.2222222222222%,0.517484413120087,0.664179104477612,0.682195845697329,3689,3216,3370
822,15,IOWA,BENTON,5915,5468,11766,50.2719700832908%,46.4728879823219%,4678,8232,13844,33.790811904074%,59.4625830684773%,5160,9208,14642,35.241087283158%,62.887583663434%,0.480365457260828,0.637645236250968,0.64086859688196,11383,12910,14368
823,15,IOWA,BLACK HAWK,30112,23468,55085,54.6646092402651%,42.6032495234637%,32233,27476,64405,50.0473565716947%,42.6612840617965%,35647,29813,66593,53.5296502635412%,44.7689697115312%,0.437999253452781,0.46016513423437,0.455438435685915,53580,59709,65460
824,15,IOWA,BOONE,6270,5625,12249,51.1878520695567%,45.9221160911095%,5541,7484,14196,39.0321217244294%,52.7190757959989%,6303,8729,15340,41.0886571056063%,56.903520208605%,0.472887767969735,0.574587332053743,0.58069451836083,11895,13025,15032
825,15,IOWA,BREMER,5169,5675,11175,46.255033557047%,50.7829977628635%,5356,7208,13538,39.5627123651943%,53.242724183779%,5958,8324,14546,40.9597140107246%,57.2253540492232%,0.523330874216156,0.573702642470551,0.582831536199412,10844,12564,14282
826,15,IOWA,BUCHANAN,5045,4092,9410,53.6131774707758%,43.4856535600425%,3970,5510,10252,38.7241513850956%,53.7456106125634%,4169,6430,10774,38.6950064971227%,59.6807128271765%,0.447849403524133,0.581223628691983,0.60666100575526,9137,9480,10599
827,15,IOWA,BUENA VISTA,3297,4354,7977,41.3313275667544%,54.5819230287075%,2856,4903,8278,34.5010872191351%,59.2292824353709%,2961,5074,8167,36.2556630341619%,62.1280764050447%,0.56907593778591,0.631911328779482,0.631487243310517,7651,7759,8035
828,15,IOWA,BUTLER,2735,3837,6724,40.6751933372992%,57.064247471743%,2157,4921,7513,28.7102355916412%,65.4998003460668%,2424,5556,8098,29.9333168683626%,68.6095332180785%,0.5838405356056,0.695252896298389,0.696240601503759,6572,7078,7980
829,15,IOWA,CALHOUN,2132,2776,5041,42.2931957944852%,55.068438801825%,1398,3468,5159,27.0982748594689%,67.2223299088971%,1470,3698,5258,27.9573982502853%,70.3309243058197%,0.56560717196414,0.712700369913687,0.715557275541796,4908,4866,5168
830,15,IOWA,CARROLL,4463,4879,9568,46.6450668896321%,50.9928929765886%,3309,6638,10544,31.3827769347496%,62.9552352048558%,3454,7766,11335,30.4719894133216%,68.5134539038377%,0.52226503960608,0.667336885493114,0.692156862745098,9342,9947,11220
831,15,IOWA,CASS,2481,4206,6880,36.0610465116279%,61.1337209302326%,1951,4761,7125,27.3824561403509%,66.821052631579%,2201,4979,7276,30.2501374381528%,68.4304562946674%,0.628981606101391,0.709326579261025,0.693454038997214,6687,6712,7180
832,15,IOWA,CEDAR,4033,4031,8344,48.3341323106424%,48.310162991371%,3599,5295,9541,37.7214128498061%,55.4973273241799%,4337,6184,10703,40.5213491544427%,57.7781930299916%,0.499875992063492,0.595345176523499,0.587776827297785,8064,8894,10521
833,15,IOWA,CERRO GORDO,12185,9397,22162,54.9814998646332%,42.4014078151791%,9862,11621,22965,42.9436098410625%,50.6030916612236%,10941,12499,23801,45.9686567791269%,52.5146002268812%,0.435409137244,0.54093934739096,0.533233788395904,21582,21483,23440
834,15,IOWA,CHEROKEE,2845,3463,6592,43.1583737864078%,52.5333737864078%,1679,4192,6258,26.8296580377117%,66.9862575902844%,1936,4510,6518,29.7023626879411%,69.1930039889537%,0.548985415345593,0.714018054845852,0.699658703071672,6308,5871,6446
835,15,IOWA,CHICKASAW,3435,2936,6584,52.1719319562576%,44.5929526123937%,2266,3742,6435,35.2136752136752%,58.1507381507381%,2233,4322,6631,33.6751621173277%,65.1787060775147%,0.460838172971276,0.622836218375499,0.659344012204424,6371,6008,6555
836,15,IOWA,CLARKE,2081,1984,4176,49.8323754789272%,47.5095785440613%,1465,2713,4454,32.8917826672654%,60.9115401885945%,1466,3153,4670,31.3918629550321%,67.5160599571734%,0.488068880688807,0.649353757778842,0.682615284693657,4065,4178,4619
837,15,IOWA,CLAY,3294,3992,7578,43.4679334916865%,52.6788070731064%,2249,5877,8617,26.0995706162237%,68.2023906231867%,2662,6158,8969,29.680008919612%,68.6587133459694%,0.547900082349712,0.723234063499877,0.698185941043084,7286,8126,8820
838,15,IOWA,CLAYTON,4238,4034,8571,49.4458056236145%,47.0656866176642%,3237,5317,9129,35.4584291817286%,58.242961989265%,3340,6119,9594,34.8134250573275%,63.7794454867626%,0.487669245647969,0.621580547112462,0.6468971350037,8272,8554,9459
839,15,IOWA,CLINTON,12276,9229,22180,55.3471596032462%,41.609558160505%,10095,11276,23067,43.76381844193%,48.883686651927%,10812,13410,24687,43.7963300522542%,54.320087495443%,0.429156010230179,0.527630901689205,0.553628932375526,21505,21371,24222
840,15,IOWA,CRAWFORD,2838,3482,6555,43.2951945080092%,53.1197559115179%,1991,4617,6935,28.7094448449892%,66.5753424657534%,2220,4862,7154,31.0315907184792%,67.9619793122729%,0.550949367088608,0.698698547215496,0.686529229031347,6320,6608,7082
841,15,IOWA,DALLAS,8561,10306,19330,44.2886704604242%,53.3160889808588%,15701,19339,38252,41.0462198055004%,50.5568336296141%,26879,28162,56022,47.9793652493663%,50.2695369676199%,0.546244765993534,0.551912100456621,0.511654948129576,18867,35040,55041
842,15,IOWA,DAVIS,1691,1956,3758,44.9973390101118%,52.0489622139436%,977,2723,3882,25.1674394641937%,70.1442555383823%,1013,3035,4102,24.6952705997075%,73.9882983910288%,0.53633123114889,0.735945945945946,0.749752964426877,3647,3700,4048
843,15,IOWA,DECATUR,1674,1903,3709,45.1334591534106%,51.3076300889728%,1201,2296,3734,32.1638993036958%,61.4890198178897%,1120,2618,3804,29.4426919032597%,68.8222923238696%,0.532010064299692,0.656562768086932,0.700374531835206,3577,3497,3738
844,15,IOWA,DELAWARE,3808,4273,8349,45.6102527248772%,51.1797820098215%,2957,5694,9241,31.9987014392382%,61.6167081484688%,3157,6688,10003,31.5605318404479%,66.8599420173948%,0.528771191684197,0.658189804646862,0.679329608938547,8081,8651,9845
845,15,IOWA,DES MOINES,11351,7385,19365,58.6160599018849%,38.1358120320165%,8212,9529,19103,42.9880123540805%,49.8822174527561%,8893,10642,19956,44.5630386851072%,53.3273201042293%,0.3941609735269,0.537117411645341,0.544765804965447,18736,17741,19535
846,15,IOWA,DICKINSON,3660,4225,8121,45.0683413372737%,52.0256126092846%,3056,6753,10354,29.5151632219432%,65.2211705621016%,3661,7452,11244,32.5595873354678%,66.2753468516542%,0.535827520608751,0.688449383219492,0.670566003779357,7885,9809,11113
847,15,IOWA,DUBUQUE,22341,16462,40323,55.4051037869206%,40.8253354165117%,22850,23460,49721,45.9564369180025%,47.183282717564%,25657,27358,53926,47.578162667359%,50.7324852575752%,0.424245548024637,0.506586050529043,0.516042629444497,38803,46310,53015
848,15,IOWA,EMMET,2165,2331,4630,46.7602591792657%,50.3455723542117%,1357,3124,4753,28.5503892278561%,65.7269093204292%,1520,3268,4853,31.3208324747579%,67.3397898207295%,0.518460854092527,0.697165811202857,0.682539682539683,4496,4481,4788
849,15,IOWA,FAYETTE,4640,4747,9621,48.2278349443925%,49.3399854484981%,3689,5620,9975,36.9824561403509%,56.3408521303258%,3835,6174,10186,37.6497152955036%,60.6126055370116%,0.505699371471184,0.603716833172199,0.61684483964432,9387,9309,10009
850,15,IOWA,FLOYD,3830,3191,7238,52.9151699364465%,44.0867642995303%,3179,4375,8060,39.4416873449131%,54.2803970223325%,3172,4747,8032,39.49203187251%,59.1010956175299%,0.454493661871528,0.579163357161769,0.599444374289683,7021,7554,7919
851,15,IOWA,FRANKLIN,2122,2657,4938,42.9728635074929%,53.8072093965168%,1493,3163,4968,30.0523349436393%,63.6674718196457%,1626,3433,5130,31.6959064327485%,66.9200779727096%,0.555974053149194,0.679338487972509,0.678592607234631,4779,4656,5059
852,15,IOWA,FREMONT,1459,2069,3616,40.3484513274336%,57.2179203539823%,963,2407,3595,26.7872044506259%,66.9541029207232%,1080,2717,3857,28.0010370754472%,70.4433497536946%,0.586451247165533,0.714243323442136,0.715564919673426,3528,3370,3797
853,15,IOWA,GREENE,2301,2282,4719,48.7603305785124%,48.3577029031575%,1691,2820,4821,35.07571043352%,58.4940883634101%,1769,3229,5057,34.981214158592%,63.8520862171248%,0.497927121972507,0.625138550210596,0.646058423369348,4583,4511,4998
854,15,IOWA,GRUNDY,2139,3851,6111,35.0024545900835%,63.017509409262%,1856,4527,6872,27.0081490104773%,65.8760186263097%,2206,4945,7276,30.3188565145684%,67.9631665750412%,0.642904841402337,0.70922763590788,0.691511676688575,5990,6383,7151
855,15,IOWA,GUTHRIE,2493,2840,5469,45.5842018650576%,51.9290546717864%,1732,3628,5750,30.1217391304348%,63.095652173913%,1985,4280,6371,31.1568042693455%,67.1794066865484%,0.532533283330208,0.676865671641791,0.68316041500399,5333,5360,6265
856,15,IOWA,HAMILTON,3407,3968,7574,44.9828360179562%,52.3897544230262%,2726,4463,7694,35.4302053548219%,58.006238627502%,2843,4982,7943,35.7925217172353%,62.7218934911243%,0.538033898305085,0.620809570176659,0.63667731629393,7375,7189,7825
857,15,IOWA,HANCOCK,2281,2988,5438,41.9455682236116%,54.9466715704303%,1587,3977,5871,27.0311701584057%,67.7397376937489%,1683,4401,6172,27.2683084899546%,71.3058976020739%,0.567090529512241,0.714773544212797,0.723372781065089,5269,5564,6084
858,15,IOWA,HARDIN,3734,4486,8435,44.2679312388856%,53.1831653823355%,2787,5254,8533,32.6614320871909%,61.5727176842845%,2976,5864,8989,33.1071309378129%,65.2352875737012%,0.545742092457421,0.653401318243999,0.663348416289593,8220,8041,8840
859,15,IOWA,HARRISON,2551,3802,6543,38.9882316979979%,58.1079015742014%,2131,4902,7465,28.5465505693235%,65.6664434025452%,2440,5580,8155,29.9202942979767%,68.4242795830779%,0.59845742169054,0.696999857813167,0.695760598503741,6353,7033,8020
860,15,IOWA,HENRY,3907,4476,8671,45.0582401107139%,51.6203436743167%,2904,5779,9404,30.8804763930242%,61.4525733730328%,3275,6525,9982,32.8090563013424%,65.3676617912242%,0.53393773112251,0.665553380168145,0.665816326530612,8383,8683,9800
861,15,IOWA,HOWARD,2426,1922,4491,54.019149409931%,42.7967045201514%,1677,2611,4559,36.7843825400307%,57.2713314323317%,1772,3133,4958,35.7402178297701%,63.1908027430416%,0.442042318307268,0.608908582089552,0.638735983690112,4348,4288,4905
862,15,IOWA,HUMBOLDT,1949,2846,4940,39.4534412955466%,57.6113360323887%,1252,3568,5087,24.6117554550816%,70.1395714566542%,1442,3825,5327,27.0696452036794%,71.8040172705087%,0.593534932221064,0.740248962655602,0.726219859502563,4795,4820,5267
863,15,IOWA,IDA,1411,1968,3491,40.4182182755657%,56.3735319392724%,792,2655,3612,21.9269102990033%,73.5049833887043%,917,2885,3849,23.824369966225%,74.9545336451026%,0.58242083456644,0.77023498694517,0.75881115202525,3379,3447,3802
864,15,IOWA,IOWA,3230,3894,7413,43.5721030621881%,52.5293403480372%,3084,5205,8904,34.6361185983827%,58.4568733153639%,3547,6035,9742,36.4093615274071%,61.9482652432765%,0.546603032004492,0.627940644227289,0.629826758505531,7124,8289,9582
865,15,IOWA,JACKSON,4945,3769,9032,54.7497785651019%,41.729406554473%,3837,5824,10310,37.2162948593598%,56.4888457807954%,4029,6957,11135,36.1832061068702%,62.478670857656%,0.432522377782878,0.602836145326571,0.633260513380666,8714,9661,10986
866,15,IOWA,JASPER,8699,8729,17835,48.7748808522568%,48.9430894308943%,7109,10560,19034,37.3489545024693%,55.4796679625933%,7737,12125,20184,38.3323424494649%,60.072334522394%,0.500860683956851,0.597656913237874,0.610462189104823,17428,17669,19862
867,15,IOWA,JEFFERSON,2863,3248,7548,37.93057763646%,43.0312665606783%,3710,3748,8156,45.4879843060324%,45.9538989700834%,4319,4476,8959,48.2085054135506%,49.9609331398594%,0.531500572737686,0.502547599892733,0.50892552586697,6111,7458,8795
868,15,IOWA,JOHNSON,31174,17899,52769,59.0763516458527%,33.9195360912657%,50200,21044,76940,65.2456459578893%,27.3511827397972%,59177,23206,83851,70.5739943471157%,27.6752811534746%,0.364742322662156,0.29537926000786,0.281684328077395,49073,71244,82383
869,15,IOWA,JONES,4690,4201,9143,51.2960734988516%,45.9477195668818%,3787,5720,10133,37.3729398993388%,56.4492253034639%,4213,6596,10989,38.3383383383383%,60.02366002366%,0.472500281183219,0.601661933312296,0.610232213895828,8891,9507,10809
870,15,IOWA,KEOKUK,2181,2571,4947,44.0873256519103%,51.9708914493633%,1342,3390,4985,26.9207622868606%,68.0040120361083%,1414,3809,5303,26.664152366585%,71.8272675843862%,0.541035353535353,0.716398985629755,0.729274363392686,4752,4732,5223
871,15,IOWA,KOSSUTH,3960,4612,8878,44.6046406848389%,51.9486370804235%,2543,5653,8607,29.5457186011386%,65.6790984082723%,2696,6288,9090,29.6589658965897%,69.1749174917492%,0.538030797946804,0.689726695949244,0.699910952804987,8572,8196,8984
872,15,IOWA,LEE,9632,6339,16572,58.1221337195269%,38.2512671976828%,6215,8803,16151,38.4805894371866%,54.5043650547954%,6541,9808,16734,39.0880841400741%,58.6112107087367%,0.396906893744913,0.586163270741777,0.599914367851245,15971,15018,16349
873,15,IOWA,LINN,48897,40417,92064,53.1119655891554%,43.900981925617%,58935,48390,117098,50.3296384225179%,41.3243607918154%,70874,53744,127458,55.6057681746144%,42.1660468546502%,0.452527039433907,0.450873515024458,0.431269961000819,89314,107325,124618
874,15,IOWA,LOUISA,2294,2207,4637,49.4716411472935%,47.595428078499%,1648,3069,5008,32.9073482428115%,61.2819488817891%,1726,3506,5332,32.370592648162%,65.7539384846212%,0.490335481004221,0.65062539749841,0.670107033639144,4501,4717,5232
875,15,IOWA,LUCAS,1934,2262,4303,44.9453869393446%,52.5679758308157%,1239,2877,4354,28.4565916398714%,66.0771704180064%,1284,3295,4630,27.732181425486%,71.1663066954644%,0.53908484270734,0.698979591836735,0.719589430006552,4196,4116,4579
876,15,IOWA,LYON,1313,3918,5342,24.5788094346687%,73.3433171096967%,920,5192,6377,14.4268464795358%,81.4175944801631%,1067,5718,6863,15.5471368206324%,83.3163339647384%,0.748996367807303,0.849476439790576,0.84274134119381,5231,6112,6785
877,15,IOWA,MADISON,3093,3662,6969,44.3822643133879%,52.5469938298178%,2678,5360,8636,31.0097267253358%,62.0657711903659%,3134,6525,9824,31.9014657980456%,66.4189739413681%,0.542116950407106,0.666832545409306,0.675535769748421,6755,8038,9659
878,15,IOWA,MAHASKA,3370,5971,9543,35.3138426071466%,62.5694226134339%,2619,7432,10632,24.6331828442438%,69.9021820917984%,2894,8320,11404,25.377060680463%,72.9568572430726%,0.639224922385184,0.739428912546015,0.741929730693776,9341,10051,11214
879,15,IOWA,MARION,5741,8358,14408,39.8459189339256%,58.0094392004442%,5482,10962,17816,30.7700942972609%,61.5289627301302%,6178,12722,19232,32.123544093178%,66.1501663893511%,0.592808000567416,0.666626125030406,0.673121693121693,14099,16444,18900
880,15,IOWA,MARSHALL,8322,8785,17624,47.2197004085338%,49.8467998184294%,7652,9146,17980,42.5583982202447%,50.8676307007786%,8176,9610,18136,45.0816056462285%,52.9885310983679%,0.51353247208745,0.54446957971187,0.540312605419993,17107,16798,17786
881,15,IOWA,MILLS,2039,3684,5915,34.4716821639899%,62.2823330515638%,2090,5067,7698,27.1499090672902%,65.8222915042868%,2508,5616,8268,30.33381712627%,67.9245283018868%,0.64371832954744,0.707978203157748,0.691285081240768,5723,7157,8124
882,15,IOWA,MITCHELL,2650,2388,5162,51.3366912049593%,46.2611390933747%,1888,3190,5417,34.8532398006277%,58.8886837733063%,2053,3684,5822,35.2627962899347%,63.277224321539%,0.473997618102422,0.62820007877117,0.642147463831271,5038,5078,5737
883,15,IOWA,MONONA,2086,2304,4560,45.7456140350877%,50.5263157894737%,1247,3120,4572,27.2747156605424%,68.241469816273%,1407,3262,4728,29.758883248731%,68.9932318104907%,0.524829157175399,0.714449278681017,0.698650674662669,4390,4367,4669
884,15,IOWA,MONROE,1699,1858,3647,46.5862352618591%,50.9459829997258%,1056,2638,3865,27.3221216041397%,68.2535575679172%,1078,2978,4088,26.3698630136986%,72.8473581213307%,0.522350295192578,0.714131023280996,0.73422090729783,3557,3694,4056
885,15,IOWA,MONTGOMERY,1838,3417,5394,34.0748980348535%,63.3481646273637%,1314,3436,5044,26.050753370341%,68.1205392545599%,1583,3666,5327,29.7165383893373%,68.8192228271072%,0.65023786869648,0.723368421052632,0.698418746427891,5255,4750,5249
886,15,IOWA,MUSCATINE,8058,7483,16076,50.1244090569793%,46.5476486688231%,8368,9584,19434,43.0585571678502%,49.3156323968303%,9372,10865,20671,45.3388805573025%,52.5615596729718%,0.481500546940351,0.533868092691622,0.536887878638138,15541,17952,20237
887,15,IOWA,O'BRIEN,2170,4674,7044,30.8063600227144%,66.3543441226576%,1315,5752,7406,17.755873615987%,77.6667566837699%,1569,5871,7551,20.7787048073103%,77.751291219706%,0.682933956750438,0.813923871515494,0.789112903225806,6844,7067,7440
888,15,IOWA,OSCEOLA,913,2064,3063,29.8073783872021%,67.384916748286%,552,2531,3213,17.1802054154995%,78.7737317149082%,601,2695,3328,18.0588942307692%,80.9795673076923%,0.693315418206248,0.820953616607201,0.817657766990291,2977,3083,3296
889,15,IOWA,PAGE,2293,4588,7059,32.4833545828021%,64.9950417906219%,1807,4893,7044,25.6530380465645%,69.4633730834753%,2086,5328,7528,27.7098831030818%,70.7757704569607%,0.66676355180933,0.730298507462687,0.718640410035069,6881,6700,7414
890,15,IOWA,PALO ALTO,2326,2341,4823,48.2272444536596%,48.5382541986316%,1398,3081,4703,29.7257069955348%,65.511375717627%,1519,3378,4958,30.6373537716821%,68.1323114158935%,0.501607028069424,0.687876758204956,0.689810087808863,4667,4479,4897
891,15,IOWA,PLYMOUTH,3499,6189,10118,34.5819331883771%,61.1682150622653%,2885,9680,13190,21.8726307808946%,73.3889310083397%,3494,10515,14188,24.6264448829997%,74.111925570905%,0.638831544178365,0.770393951452447,0.75058890713113,9688,12565,14009
892,15,IOWA,POCAHONTAS,1736,2242,4141,41.9222410045883%,54.1415117121468%,963,2702,3865,24.9159120310479%,69.9094437257439%,933,2832,3823,24.4049176039759%,74.0779492545122%,0.563599798893917,0.737244201909959,0.752191235059761,3978,3665,3765
893,15,IOWA,POLK,89715,79927,174167,51.5109061992226%,45.8910126487796%,119804,93492,231555,51.7388957267172%,40.3757206711149%,146250,107564,258755,56.5206469440204%,41.5698247376862%,0.47115101213143,0.438320456079814,0.42379064984595,169642,213296,253814
894,15,IOWA,POTTAWATTAMIE,14726,18783,34467,42.7249252908579%,54.4956044912525%,15355,24447,42680,35.977038425492%,57.2797563261481%,18575,26352,45744,40.6064183280868%,57.607555089192%,0.560535975409591,0.614215366062007,0.586551516905202,33509,39802,44927
895,15,IOWA,POWESHIEK,4222,4396,8980,47.0155902004454%,48.9532293986637%,4304,4946,9833,43.7709752872979%,50.3000101698363%,4306,5673,10140,42.465483234714%,55.9467455621302%,0.510095149686702,0.534702702702703,0.568493837057821,8618,9250,9979
896,15,IOWA,RINGGOLD,1246,1369,2692,46.2852897473997%,50.8543833580981%,753,1824,2707,27.8167713335796%,67.3808644255634%,709,1974,2714,26.1238025055269%,72.7339719970523%,0.523518164435946,0.707799767171129,0.735743570629892,2615,2577,2683
897,15,IOWA,SAC,2099,2776,5033,41.7047486588516%,55.1559705940791%,1270,3703,5212,24.3668457405986%,71.0475825019187%,1389,4069,5535,25.0948509485095%,73.5140018066847%,0.569435897435897,0.744620953146994,0.745511176255038,4875,4973,5458
898,15,IOWA,SCOTT,35857,32801,70568,50.8119827683936%,46.4814080036277%,40440,39149,86220,46.9032707028532%,45.4059382973788%,46926,43958,92599,50.6765731811359%,47.4713549822352%,0.47774476390224,0.491889582731282,0.48367149333216,68658,79589,90884
899,15,IOWA,SHELBY,2179,3655,6009,36.2622732567815%,60.8254285238809%,1662,4362,6370,26.0910518053375%,68.4772370486656%,1959,4711,6795,28.8300220750552%,69.3303899926417%,0.626499828591018,0.724103585657371,0.706296851574213,5834,6024,6670
900,15,IOWA,SIOUX,2148,12241,14692,14.6202014701879%,83.3174516743806%,2300,14785,18194,12.6415301747829%,81.2630537539848%,3019,15775,19051,15.8469371686526%,82.8040522807202%,0.850719299464869,0.865378987415862,0.839363626689369,14389,17085,18794
901,15,IOWA,STORY,17478,16228,35364,49.4231421784866%,45.8884741545074%,25709,19458,50667,50.7411135453056%,38.4036947125348%,29175,20541,51038,57.1632900975744%,40.2464830126572%,0.481457307304338,0.430801248699272,0.41316678735216,33706,45167,49716
902,15,IOWA,TAMA,4045,4034,8315,48.6470234515935%,48.5147324113049%,3196,4971,8752,36.5173674588665%,56.7984460694698%,3577,5325,9048,39.5335985853227%,58.8527851458886%,0.499319222676074,0.608669033916983,0.598180184228263,8079,8167,8902
903,15,IOWA,TAYLOR,1247,1770,3096,40.2777777777778%,57.1705426356589%,758,2111,3029,25.0247606470782%,69.6929679762298%,746,2470,3249,22.9609110495537%,76.0233918128655%,0.586675505469009,0.73579644475427,0.768034825870647,3017,2869,3216
904,15,IOWA,UNION,2540,3003,5740,44.2508710801394%,52.3170731707317%,1922,3525,5832,32.9561042524005%,60.4423868312757%,2061,4024,6185,33.322554567502%,65.0606305578011%,0.541764387515786,0.647145217550945,0.661298274445357,5543,5447,6085
905,15,IOWA,VAN BUREN,1440,2016,3561,40.4380791912384%,56.6133108677338%,845,2527,3561,23.7292895254142%,70.9632125807357%,875,2870,3791,23.0809812714323%,75.7056185702981%,0.583333333333333,0.749406880189798,0.766355140186916,3456,3372,3745
906,15,IOWA,WAPELLO,8355,6313,15139,55.1885857718475%,41.7002444018759%,5594,8715,15149,36.9265298039475%,57.5285497392567%,5821,9536,15633,37.2353355082198%,60.999168425766%,0.430392691573493,0.609057236704172,0.620954613531289,14668,14309,15357
907,15,IOWA,WARREN,9521,9621,19653,48.4455299445377%,48.9543581132652%,10411,14814,27300,38.1355311355311%,54.2637362637363%,12574,17868,31039,40.5103257192564%,57.5662875736976%,0.502612057256295,0.587274529236868,0.58695223704093,19142,25225,30442
908,15,IOWA,WASHINGTON,3932,4827,9094,43.2372993182318%,53.078953155927%,3943,6173,10929,36.078323725867%,56.4827523103669%,4561,6991,11765,38.7675308117297%,59.4220144496388%,0.551090307112684,0.610221431395809,0.605176592797784,8759,10116,11552
909,15,IOWA,WAYNE,1300,1666,3021,43.0321085733201%,55.1473022178087%,719,2069,2940,24.4557823129252%,70.374149659864%,727,2344,3109,23.383724670312%,75.3940173689289%,0.561699258260283,0.742109038737446,0.763269293389775,2966,2788,3071
910,15,IOWA,WEBSTER,8479,8172,17048,49.7360394181136%,47.9352416705772%,6305,10056,17430,36.1732644865175%,57.6936316695353%,6613,10970,17822,37.1058242621479%,61.5531365727752%,0.490781334454387,0.614632357435365,0.623898083375988,16651,16361,17583
911,15,IOWA,WINNEBAGO,2691,2662,5527,48.6882576442917%,48.1635607020083%,1931,3447,5787,33.3678935545187%,59.5645412130638%,2135,3726,5970,35.7621440536013%,62.4120603015075%,0.497291238557818,0.640944589066567,0.635727691520218,5353,5378,5861
912,15,IOWA,WINNESHIEK,4339,4647,9417,46.0762450886694%,49.346925772539%,5254,5344,11362,46.2418588276712%,47.0339728920965%,5617,6263,12064,46.5600132625995%,51.9147877984085%,0.517137769864233,0.504246084166824,0.527188552188552,8986,10598,11880
913,15,IOWA,WOODBURY,17691,18864,37896,46.6830272324256%,49.7783407219759%,16210,24727,43718,37.0785488814676%,56.5602269088247%,18704,25926,45362,41.2327498787531%,57.153564657643%,0.51604431678293,0.604025698023793,0.580909701994174,36555,40937,44630
914,15,IOWA,WORTH,2208,1659,4004,55.1448551448551%,41.4335664335664%,1530,2453,4257,35.9408033826638%,57.6227390180879%,1596,2742,4418,36.1249434133092%,62.0642824807605%,0.429014740108611,0.615867436605574,0.632088520055325,3867,3983,4338
915,15,IOWA,WRIGHT,2796,3384,6336,44.1287878787879%,53.4090909090909%,1896,3800,6026,31.463657484235%,63.0600730169267%,1996,4148,6254,31.9155740326191%,66.325551646946%,0.547572815533981,0.667134831460674,0.675130208333333,6180,5696,6144
917,16,KANSAS,ALLEN,2132,3379,5766,36.9753728754769%,58.6021505376344%,1433,3651,5454,26.2742940960763%,66.941694169417%,1570,4218,5892,26.6463000678887%,71.5885947046843%,0.613137361640356,0.718135326514555,0.728749136143746,5511,5084,5788
918,16,KANSAS,ANDERSON,1327,1984,3478,38.1541115583669%,57.0442783208741%,672,2435,3350,20.0597014925373%,72.6865671641791%,782,2929,3792,20.6223628691983%,77.2415611814346%,0.599214738749622,0.783714193756035,0.789275127997844,3311,3107,3711
919,16,KANSAS,ATCHISON,3171,3378,6900,45.9565217391304%,48.9565217391304%,1989,4049,6575,30.2509505703422%,61.5817490494297%,2359,4906,7440,31.7069892473118%,65.9408602150538%,0.515803939532753,0.67058628684995,0.675292498279422,6549,6038,7265
920,16,KANSAS,BARBER,637,1755,2498,25.5004003202562%,70.2562049639712%,286,1850,2252,12.6998223801066%,82.1492007104796%,291,2014,2342,12.4252775405636%,85.9948761742101%,0.733695652173913,0.866104868913858,0.873752711496746,2392,2136,2305
921,16,KANSAS,BARTON,3238,7302,10955,29.557279780922%,66.6544956640803%,1839,7888,10269,17.9082676015191%,76.8137111695394%,2340,8608,11130,21.0242587601078%,77.340521114106%,0.692789373814042,0.810938624447414,0.786262331019364,10540,9727,10948
922,16,KANSAS,BOURBON,2211,3852,6308,35.0507292327204%,61.0653138871275%,1336,4424,6093,21.926801247333%,72.6079107172165%,1541,5023,6676,23.0826842420611%,75.2396644697424%,0.635329045027214,0.768055555555556,0.765234613040829,6063,5760,6564
923,16,KANSAS,BROWN,1512,2985,4691,32.231933489661%,63.6324877424856%,863,2906,4036,21.382556987116%,72.001982160555%,1104,3262,4471,24.6924625363453%,72.9590695593827%,0.663775850567045,0.771026797559034,0.74713696747595,4497,3769,4366
924,16,KANSAS,BUTLER,6755,13377,21002,32.1636034663365%,63.6939339110561%,6573,19073,27657,23.7661351556568%,68.9626496004628%,9181,22634,32520,28.2318573185732%,69.60024600246%,0.664464534075104,0.743702721671996,0.711425428257111,20132,25646,31815
925,16,KANSAS,CHASE,391,848,1317,29.6886864085042%,64.3887623386484%,316,969,1369,23.0825420014609%,70.781592403214%,345,1123,1491,23.1388329979879%,75.3185781354795%,0.684422921711057,0.75408560311284,0.764986376021798,1239,1285,1468
926,16,KANSAS,CHAUTAUQUA,443,1347,1880,23.563829787234%,71.6489361702128%,197,1236,1481,13.3018230925051%,83.4571235651587%,212,1402,1639,12.934716290421%,85.5399633923124%,0.752513966480447,0.862526168876483,0.868649318463445,1790,1433,1614
927,16,KANSAS,CHEROKEE,3783,5014,9130,41.434830230011%,54.9178532311062%,2005,6182,8620,23.2598607888631%,71.7169373549884%,2194,6766,9128,24.0359333917616%,74.1235758106924%,0.56996703421621,0.755099548064004,0.755133928571429,8797,8187,8960
928,16,KANSAS,CHEYENNE,350,1312,1727,20.2663578459757%,75.9698899826288%,181,1173,1407,12.864250177683%,83.3688699360341%,224,1183,1429,15.6752974107768%,82.7851644506648%,0.789410348977136,0.866322008862629,0.840796019900497,1662,1354,1407
929,16,KANSAS,CLARK,292,926,1261,23.1562252180809%,73.4337827121332%,120,825,1005,11.9402985074627%,82.089552238806%,143,904,1067,13.4020618556701%,84.7235238987816%,0.760262725779967,0.873015873015873,0.86341929321872,1218,945,1047
930,16,KANSAS,CLAY,951,2998,4088,23.2632093933464%,73.3365949119374%,677,2891,3820,17.7225130890052%,75.6806282722513%,894,3177,4182,21.377331420373%,75.9684361549498%,0.759179539123829,0.810257847533632,0.780397936624908,3949,3568,4071
931,16,KANSAS,CLOUD,1314,2918,4503,29.180546302465%,64.8012436153675%,761,2919,3930,19.3638676844784%,74.2748091603053%,920,3242,4263,21.5810462115881%,76.0497302369224%,0.689508506616257,0.79320652173913,0.778952426717924,4232,3680,4162
932,16,KANSAS,COFFEY,1196,2700,4040,29.6039603960396%,66.8316831683168%,727,3050,4068,17.8711897738446%,74.9754178957719%,964,3489,4565,21.1171960569551%,76.4293537787514%,0.693018480492813,0.807519195128409,0.783516730294184,3896,3777,4453
933,16,KANSAS,COMANCHE,211,760,1006,20.9741550695825%,75.5467196819085%,102,715,867,11.7647058823529%,82.4682814302192%,126,762,916,13.7554585152838%,83.1877729257642%,0.7826982492276,0.87515299877601,0.858108108108108,971,817,888
934,16,KANSAS,COWLEY,5535,8080,14210,38.9514426460239%,56.8613652357495%,3551,8270,12621,28.1356469376436%,65.5257111163933%,4273,9656,14231,30.0259995783852%,67.8518726723351%,0.593463092177745,0.699602402504018,0.693229951898916,13615,11821,13929
935,16,KANSAS,CRAWFORD,7076,7160,15034,47.0666489290941%,47.6253824664095%,5199,8624,14891,34.9137062655295%,57.9141763481297%,6179,10045,16645,37.1222589366176%,60.3484529888855%,0.502950266928913,0.623887723359618,0.619144477317554,14236,13823,16224
936,16,KANSAS,DECATUR,424,1255,1759,24.1046048891416%,71.3473564525298%,178,1210,1452,12.2589531680441%,83.3333333333333%,218,1260,1498,14.5527369826435%,84.1121495327103%,0.747468731387731,0.871757925072046,0.852503382949932,1679,1388,1478
937,16,KANSAS,DICKINSON,2413,5243,8092,29.819574888779%,64.7923875432526%,1609,6029,8210,19.5980511571255%,73.4348355663825%,2060,7126,9349,22.0344421863301%,76.2220558348487%,0.684822361546499,0.789342759884787,0.775745699978228,7656,7638,9186
938,16,KANSAS,DONIPHAN,1134,2350,3649,31.0770073992875%,64.4012058098109%,587,2606,3378,17.3771462403789%,77.1462403789224%,686,2976,3709,18.495551361553%,80.2372607171744%,0.67451205510907,0.816160350767303,0.812670671764063,3484,3193,3662
939,16,KANSAS,DOUGLAS,18249,17062,39838,45.8080224910889%,42.8284552437371%,31195,14688,50087,62.2816299638629%,29.3249745442929%,40785,17286,59495,68.5519791579124%,29.0545423985209%,0.483192206394608,0.32011856243053,0.297670093506225,35311,45883,58071
940,16,KANSAS,EDWARDS,447,1062,1563,28.5988483685221%,67.9462571976967%,212,1037,1319,16.0727824109174%,78.620166793025%,271,1141,1431,18.9378057302586%,79.7344514325646%,0.703777335984095,0.830264211369095,0.808073654390935,1509,1249,1412
941,16,KANSAS,ELK,402,1080,1550,25.9354838709677%,69.6774193548387%,160,1048,1259,12.7084988085782%,83.2406671961875%,195,1140,1361,14.3277002204262%,83.7619397501837%,0.728744939271255,0.867549668874172,0.853932584269663,1482,1208,1335
942,16,KANSAS,ELLIS,3926,6516,11160,35.1792114695341%,58.3870967741935%,2742,8466,11947,22.9513685444045%,70.8629781535114%,3737,9758,13800,27.0797101449275%,70.7101449275362%,0.62401838728213,0.755353319057816,0.723082623193776,10442,11208,13495
943,16,KANSAS,ELLSWORTH,825,1845,2839,29.0595280028179%,64.9876717153928%,521,1969,2679,19.4475550578574%,73.4975737215379%,648,2148,2853,22.7129337539432%,75.2891692954784%,0.691011235955056,0.790763052208835,0.768240343347639,2670,2490,2796
944,16,KANSAS,FINNEY,2431,6442,9150,26.568306010929%,70.4043715846994%,3195,6350,10159,31.4499458608131%,62.5061521803327%,4325,7236,11800,36.6525423728814%,61.3220338983051%,0.726022765693677,0.665269774751179,0.625897413718536,8873,9545,11561
945,16,KANSAS,FORD,2566,6050,8917,28.7764943366603%,67.8479309184703%,2149,5114,7718,27.844001036538%,66.2606892977455%,2947,5803,8915,33.0566461020752%,65.0925406618059%,0.702181987000929,0.704116756161366,0.6632,8616,7263,8750
946,16,KANSAS,FRANKLIN,3321,5925,9658,34.3860012424933%,61.3481051977635%,2892,7185,10965,26.374829001368%,65.5266757865937%,3690,8479,12477,29.5744169271459%,67.9570409553579%,0.640817650876054,0.713009824352486,0.696770482373243,9246,10077,12169
947,16,KANSAS,GEARY,2660,3977,6866,38.7416254005243%,57.9230993300321%,2722,4274,7504,36.273987206823%,56.956289978678%,3983,5323,9603,41.476621888993%,55.4305946058523%,0.599216513485008,0.610920526014866,0.571996561358263,6637,6996,9306
948,16,KANSAS,GOVE,296,1122,1495,19.7993311036789%,75.0501672240803%,149,1140,1343,11.0945644080417%,84.8845867460908%,166,1291,1471,11.2848402447315%,87.7634262406526%,0.791255289139633,0.884406516679597,0.886067261496225,1418,1289,1457
949,16,KANSAS,GRAHAM,346,1058,1474,23.4735413839891%,71.7774762550882%,188,1025,1284,14.6417445482866%,79.8286604361371%,228,1080,1337,17.0531039640987%,80.7778608825729%,0.753561253561254,0.845012366034625,0.825688073394495,1404,1213,1308
950,16,KANSAS,GRANT,683,2126,2856,23.9145658263305%,74.4397759103642%,441,1804,2389,18.4596065299288%,75.5127668480536%,518,1936,2501,20.7117153138744%,77.4090363854458%,0.75685297258811,0.803563474387528,0.788916055419723,2809,2245,2454
951,16,KANSAS,GRAY,482,1631,2160,22.3148148148148%,75.5092592592593%,263,1698,2066,12.729912875121%,82.187802516941%,341,1911,2288,14.9038461538462%,83.5227272727273%,0.771888310459063,0.865884752677206,0.848579040852576,2113,1961,2252
952,16,KANSAS,GREELEY,143,628,803,17.8082191780822%,78.2067247820673%,83,534,650,12.7692307692308%,82.1538461538462%,78,549,641,12.1684867394696%,85.6474258970359%,0.814526588845655,0.86547811993517,0.875598086124402,771,617,627
953,16,KANSAS,GREENWOOD,1027,2392,3561,28.8402134231957%,67.1721426565571%,485,2160,2840,17.0774647887324%,76.056338028169%,569,2444,3077,18.4920376990575%,79.4280142996425%,0.699619771863118,0.816635160680529,0.811151676070362,3419,2645,3013
954,16,KANSAS,HAMILTON,264,901,1192,22.1476510067114%,75.5872483221476%,121,705,876,13.8127853881279%,80.4794520547945%,141,698,859,16.4144353899884%,81.2572759022119%,0.773390557939914,0.853510895883777,0.831942789034565,1165,826,839
955,16,KANSAS,HARPER,869,2076,3055,28.4451718494272%,67.9541734860884%,393,1996,2578,15.244375484872%,77.4243599689682%,461,2168,2678,17.2143390589993%,80.9559372666169%,0.704923599320883,0.83549602344077,0.824648155192088,2945,2389,2629
956,16,KANSAS,HARVEY,4591,8271,13684,33.5501315404852%,60.4428529669687%,5068,8668,14916,33.9769375167605%,58.1120943952802%,6747,10182,17309,38.9797215321509%,58.8248887861806%,0.64305706733012,0.631042516016308,0.601453127768917,12862,13736,16929
957,16,KANSAS,HASKELL,263,1323,1616,16.2747524752475%,81.8688118811881%,245,1040,1354,18.0945347119646%,76.8094534711964%,268,1122,1410,19.0070921985816%,79.5744680851064%,0.834174022698613,0.809338521400778,0.807194244604317,1586,1285,1390
958,16,KANSAS,HODGEMAN,217,835,1088,19.9448529411765%,76.7463235294118%,124,855,1017,12.1927236971485%,84.070796460177%,154,875,1045,14.7368421052632%,83.7320574162679%,0.793726235741445,0.873340143003064,0.850340136054422,1052,979,1029
959,16,KANSAS,JACKSON,1990,3001,5250,37.9047619047619%,57.1619047619048%,1512,3939,5818,25.9883121347542%,67.703678239945%,1881,4517,6584,28.5692588092345%,68.6057108140948%,0.601282308154678,0.722619702806824,0.706001875586121,4991,5451,6398
960,16,KANSAS,JEFFERSON,3000,4423,7877,38.0855655706487%,56.1508188396598%,2518,5213,8337,30.2027108072448%,62.5284874655152%,3194,6334,9782,32.6518094459211%,64.7515845430382%,0.5958507342045,0.674298279653344,0.664777497900924,7423,7731,9528
961,16,KANSAS,JEWELL,380,1400,1877,20.2450719232818%,74.5871070857752%,180,1223,1494,12.0481927710843%,81.8607764390897%,212,1387,1628,13.022113022113%,85.1965601965602%,0.786516853932584,0.871703492516037,0.867417135709819,1780,1403,1599
962,16,KANSAS,JOHNSON,79118,129965,217536,36.3700720800235%,59.7441343042071%,129852,137490,290090,44.7626598641801%,47.395635837154%,184259,155631,347214,53.067848646656%,44.8227894036531%,0.621595251646475,0.514285073052495,0.457886375003678,209083,267342,339890
963,16,KANSAS,KEARNY,320,1084,1435,22.2996515679443%,75.5400696864111%,174,1075,1316,13.2218844984802%,81.6869300911854%,267,1164,1455,18.3505154639175%,80%,0.772079772079772,0.860688550840673,0.813417190775681,1404,1249,1431
964,16,KANSAS,KINGMAN,991,2672,3808,26.0241596638655%,70.1680672268908%,599,2530,3334,17.9664067186563%,75.8848230353929%,752,3130,3949,19.042795644467%,79.260572296784%,0.729456729456729,0.808565036752956,0.806285419886656,3663,3129,3882
965,16,KANSAS,KIOWA,294,1262,1608,18.2835820895522%,78.4825870646766%,114,900,1079,10.5653382761817%,83.4105653382762%,156,980,1165,13.3905579399142%,84.1201716738197%,0.811053984575835,0.887573964497041,0.862676056338028,1556,1014,1136
966,16,KANSAS,LABETTE,3745,4475,8538,43.86273131881%,52.4127430311548%,2291,5335,8107,28.2595288022696%,65.8073270013569%,2655,5735,8563,31.0054887305851%,66.9741912881%,0.544403892944039,0.699580382900603,0.683551847437425,8220,7626,8390
967,16,KANSAS,LANE,252,846,1133,22.2418358340688%,74.6690203000883%,106,718,871,12.1699196326062%,82.4339839265212%,115,762,895,12.8491620111732%,85.1396648044693%,0.770491803278688,0.871359223300971,0.868871151653364,1098,824,877
968,16,KANSAS,LEAVENWORTH,9733,12583,23271,41.824588543681%,54.0715912509132%,10209,17638,30301,33.6919573611432%,58.2093000231015%,13886,21610,36490,38.0542614414908%,59.2217045765963%,0.563855529664814,0.63338959313391,0.608800991661032,22316,27847,35496
969,16,KANSAS,LINCOLN,469,1295,1890,24.8148148148148%,68.5185185185185%,215,1179,1464,14.6857923497268%,80.5327868852459%,266,1283,1579,16.846105129829%,81.2539582013933%,0.734126984126984,0.845767575322812,0.828276307295029,1764,1394,1549
970,16,KANSAS,LINN,1587,2513,4259,37.2622681380606%,59.0044611411129%,736,3484,4427,16.6252541224305%,78.6988931556359%,896,4048,5046,17.7566389219184%,80.221957986524%,0.612926829268293,0.825592417061611,0.818770226537217,4100,4220,4944
971,16,KANSAS,LOGAN,231,1088,1397,16.5354330708661%,77.8811739441661%,149,1132,1357,10.9801031687546%,83.4193072955048%,186,1249,1458,12.7572016460905%,85.6652949245542%,0.824867323730098,0.883684621389539,0.870383275261324,1319,1281,1435
972,16,KANSAS,LYON,5190,6652,12455,41.6700120433561%,53.4082697711762%,4649,6552,12288,37.8336588541667%,53.3203125%,6055,7550,13988,43.2871032313412%,53.9748355733486%,0.561729437595001,0.584947772520311,0.554943035648659,11842,11201,13605
973,16,KANSAS,MARION,1475,4156,5903,24.9872945959682%,70.4048788751482%,1204,4003,5624,21.4082503556188%,71.1770981507824%,1516,4465,6111,24.8077237767959%,73.0649648175421%,0.738057183448766,0.768772805838295,0.746530680488213,5631,5207,5981
974,16,KANSAS,MARSHALL,1831,3066,5115,35.7966764418377%,59.941348973607%,1072,3307,4673,22.9402953135031%,70.7682430986518%,1259,3729,5114,24.6186937817755%,72.9174814235432%,0.626097610782111,0.755195250057091,0.747594226142743,4897,4379,4988
975,16,KANSAS,MCPHERSON,3272,8501,12461,26.2579247251424%,68.220849049033%,3226,8549,12742,25.3178464919165%,67.0930780097316%,4134,9964,14438,28.6327746225239%,69.0123285773653%,0.722075936464792,0.726029723991507,0.706766917293233,11773,11775,14098
976,16,KANSAS,MEADE,400,1604,2053,19.4836824159766%,78.1295664880662%,210,1415,1720,12.2093023255814%,82.2674418604651%,263,1523,1825,14.4109589041096%,83.4520547945206%,0.800399201596806,0.870769230769231,0.852743561030235,2004,1625,1786
977,16,KANSAS,MIAMI,4554,6611,11607,39.2349444300853%,56.9570087016456%,3991,10003,15022,26.5677007056317%,66.5890027958993%,5247,12308,17937,29.2523833416959%,68.617940569772%,0.592118226600985,0.714806345576676,0.7011107946454,11165,13994,17555
978,16,KANSAS,MITCHELL,751,2350,3266,22.9944886711574%,71.9534598897734%,477,2308,2942,16.2134602311353%,78.4500339904827%,558,2504,3101,17.994195420832%,80.7481457594325%,0.757820058045792,0.828725314183124,0.817766165904637,3101,2785,3062
979,16,KANSAS,MONTGOMERY,4770,8496,13745,34.7035285558385%,61.8115678428519%,2637,8679,12004,21.967677440853%,72.3008997001%,3228,9931,13426,24.0429018322658%,73.9684194845821%,0.640434192672999,0.766967126193001,0.754692605821111,13266,11316,13159
980,16,KANSAS,MORRIS,882,1599,2641,33.3964407421431%,60.5452480121166%,601,1820,2624,22.9039634146341%,69.359756097561%,729,2124,2899,25.1466022766471%,73.2666436702311%,0.644498186215236,0.751755472945064,0.744479495268139,2481,2421,2853
981,16,KANSAS,MORTON,321,1203,1557,20.616570327553%,77.2639691714836%,147,995,1192,12.3322147651007%,83.4731543624161%,150,1034,1198,12.5208681135225%,86.3105175292154%,0.789370078740158,0.871278458844133,0.873310810810811,1524,1142,1184
982,16,KANSAS,NEMAHA,1494,3578,5290,28.241965973535%,67.6370510396975%,725,4124,5122,14.1546270987895%,80.5154236626318%,927,4664,5684,16.3089373680507%,82.054890921886%,0.705441640378549,0.850484636007424,0.83419781792166,5072,4849,5591
983,16,KANSAS,NEOSHO,2588,4014,6886,37.5835027592216%,58.2921870461807%,1501,4431,6314,23.7725688945201%,70.1773835920177%,1796,4970,6877,26.1160389704813%,72.2698851243275%,0.607997576491972,0.746965610249494,0.734555128584097,6602,5932,6766
984,16,KANSAS,NESS,383,1420,1876,20.4157782515991%,75.6929637526653%,162,1228,1454,11.1416781292985%,84.4566712517194%,149,1339,1513,9.84798413747521%,88.4996695307336%,0.787576261785912,0.883453237410072,0.899865591397849,1803,1390,1488
985,16,KANSAS,NORTON,598,1744,2451,24.3982048143615%,71.1546307629539%,281,1840,2234,12.5783348254252%,82.3634735899731%,364,2007,2415,15.0724637681159%,83.1055900621118%,0.74466268146883,0.867515322960868,0.846478279207086,2342,2121,2371
986,16,KANSAS,OSAGE,2530,3770,6613,38.2579767125359%,57.0089218206563%,1753,4826,7046,24.8793641782572%,68.4927618506954%,2136,5705,8035,26.5836963285625%,71.0018668326073%,0.598412698412698,0.733546131630947,0.727585767121541,6300,6579,7841
987,16,KANSAS,OSBORNE,484,1432,2030,23.8423645320197%,70.5418719211823%,233,1460,1788,13.0313199105145%,81.6554809843401%,281,1629,1945,14.4473007712082%,83.7532133676093%,0.747390396659708,0.862374483165977,0.852879581151833,1916,1693,1910
988,16,KANSAS,OTTAWA,631,1977,2791,22.6083840917234%,70.8348262271587%,424,2283,2903,14.6055804340338%,78.6427833275921%,506,2610,3191,15.8570980883736%,81.7925415230335%,0.758052147239264,0.843369043221278,0.837612323491656,2608,2707,3116
989,16,KANSAS,PAWNEE,968,1850,2940,32.9251700680272%,62.9251700680272%,579,1904,2661,21.7587373167982%,71.5520481022172%,643,2045,2739,23.4757210660825%,74.662285505659%,0.656493967352732,0.766814337494966,0.76078869047619,2818,2483,2688
990,16,KANSAS,PHILLIPS,611,2057,2792,21.8839541547278%,73.6747851002865%,300,2233,2664,11.2612612612613%,83.8213213213213%,318,2418,2781,11.4347357065804%,86.9471413160734%,0.770989505247376,0.881563363600474,0.883771929824561,2668,2533,2736
991,16,KANSAS,POTTAWATOMIE,2037,4985,7731,26.348467209934%,64.480662268788%,2225,7612,10693,20.808005237071%,71.186757691948%,3313,9452,13083,25.3229381640297%,72.2464266605519%,0.709911706066648,0.773813154416997,0.740462201331767,7022,9837,12765
992,16,KANSAS,PRATT,1314,2885,4416,29.7554347826087%,65.330615942029%,771,2838,3842,20.0676730869339%,73.8677771993753%,933,3108,4137,22.5525743292241%,75.1269035532995%,0.687068349607049,0.786367414796342,0.769116555308092,4199,3609,4041
993,16,KANSAS,RAWLINS,306,1349,1740,17.5862068965517%,77.5287356321839%,163,1220,1472,11.0733695652174%,82.8804347826087%,214,1261,1504,14.2287234042553%,83.843085106383%,0.815105740181269,0.882140274765004,0.854915254237288,1655,1383,1475
994,16,KANSAS,RENO,9025,15179,25430,35.4895792371215%,59.6893432953205%,6837,15513,24210,28.2403965303594%,64.0768277571252%,8886,18443,27941,31.802727175119%,66.0069432017465%,0.627127747479755,0.694093959731544,0.674850890994914,24204,22350,27329
995,16,KANSAS,REPUBLIC,604,2239,2985,20.2345058626466%,75.0083752093802%,375,2024,2529,14.8279952550415%,80.0316330565441%,424,2182,2657,15.9578471960858%,82.1226947685359%,0.787548364403799,0.84368486869529,0.837298541826554,2843,2399,2606
996,16,KANSAS,RICE,1422,2903,4520,31.4601769911504%,64.2256637168142%,695,2837,3804,18.2702418506835%,74.5793901156677%,965,3262,4319,22.3431349849502%,75.5267423014587%,0.67121387283237,0.803227633069083,0.771705701443104,4325,3532,4227
997,16,KANSAS,RILEY,6188,10672,18253,33.9012765024927%,58.4671012984167%,9341,10107,21532,43.3819431543749%,46.9394389745495%,12765,11610,25171,50.713122243852%,46.1245083627985%,0.632977461447212,0.519693541752365,0.476307692307692,16860,19448,24375
998,16,KANSAS,ROOKS,597,2016,2775,21.5135135135135%,72.6486486486486%,275,2031,2419,11.3683340223233%,83.960314179413%,339,2325,2699,12.5602074842534%,86.1430159318266%,0.771526980482204,0.880745880312229,0.872747747747748,2613,2306,2664
999,16,KANSAS,RUSH,505,1235,1854,27.2384034519957%,66.6127292340885%,233,1197,1503,15.5023286759814%,79.6407185628742%,295,1350,1677,17.5909361955874%,80.5008944543828%,0.709770114942529,0.837062937062937,0.820668693009118,1740,1430,1645
1000,16,KANSAS,RUSSELL,886,2434,3482,25.4451464675474%,69.902354968409%,461,2574,3193,14.4378327591607%,80.6138427810836%,600,2790,3467,17.3060282665128%,80.4730314392847%,0.733132530120482,0.848105436573311,0.823008849557522,3320,3035,3390
1001,16,KANSAS,SALINE,7487,12412,21527,34.7795791331816%,57.6578250569053%,6317,13828,22064,28.6303480783176%,62.6722262509064%,8214,15722,24531,33.4841628959276%,64.09033467857%,0.623749937182773,0.686423430131546,0.656834893048128,19899,20145,23936
1002,16,KANSAS,SCOTT,418,1811,2303,18.1502388189318%,78.6365610073817%,236,1865,2202,10.7175295186194%,84.6957311534968%,299,2014,2354,12.7017841971113%,85.5564995751912%,0.812471960520413,0.887672536887197,0.87073065283182,2229,2101,2313
1003,16,KANSAS,SEDGWICK,62561,93724,163417,38.2830427678883%,57.3526622077262%,69627,104353,188783,36.882028572488%,55.2766933463289%,95870,122416,223688,42.8588033332141%,54.7262258145274%,0.59969926736411,0.599798827451431,0.560805548683837,156285,173980,218286
1004,16,KANSAS,SEWARD,1126,3869,5096,22.0957613814757%,75.9222919937206%,1628,3159,5038,32.3144104803493%,62.7034537514887%,1833,3372,5294,34.6241027578391%,63.6947487721949%,0.774574574574575,0.659912262377272,0.647838616714697,4995,4787,5205
1005,16,KANSAS,SHAWNEE,34818,35894,74373,46.8153765479408%,48.2621381415299%,33926,35934,75406,44.9911147654033%,47.6540328355834%,43015,40443,85657,50.2177288487806%,47.2150553953559%,0.507608326733793,0.514371600343544,0.484591051786527,70712,69860,83458
1006,16,KANSAS,SHERIDAN,281,1132,1489,18.8717259905977%,76.0241773002015%,127,1197,1374,9.24308588064047%,87.117903930131%,147,1282,1445,10.1730103806228%,88.719723183391%,0.801132342533616,0.904078549848943,0.897130860741778,1413,1324,1429
1007,16,KANSAS,SHERMAN,681,1894,2682,25.3914988814318%,70.6189410887397%,347,2089,2612,13.2848392036753%,79.9770290964778%,396,2269,2727,14.5214521452145%,83.2049871653832%,0.735533980582524,0.857553366174056,0.85140712945591,2575,2436,2665
1008,16,KANSAS,SMITH,534,1534,2184,24.4505494505494%,70.2380952380952%,297,1661,2042,14.5445641527914%,81.3418217433888%,336,1763,2129,15.7820573038985%,82.8088304368248%,0.741779497098646,0.848314606741573,0.839923773225345,2068,1958,2099
1009,16,KANSAS,STAFFORD,567,1546,2200,25.7727272727273%,70.2727272727273%,304,1490,1896,16.0337552742616%,78.5864978902954%,357,1645,2034,17.5516224188791%,80.8751229105211%,0.731661145291055,0.830546265328874,0.821678321678322,2113,1794,2002
1010,16,KANSAS,STANTON,215,785,1029,20.8940719144801%,76.287657920311%,115,492,637,18.0533751962323%,77.2370486656201%,148,614,776,19.0721649484536%,79.1237113402062%,0.785,0.810543657331137,0.805774278215223,1000,607,762
1011,16,KANSAS,STEVENS,345,1714,2111,16.3429654192326%,81.1937470393179%,220,1599,1891,11.6340560549974%,84.5584346906399%,237,1760,2031,11.6691285081241%,86.656819300837%,0.832442933462846,0.879054425508521,0.881321982974462,2059,1819,1997
1012,16,KANSAS,SUMNER,3549,6176,10232,34.6853010164191%,60.3596559812353%,2076,6984,9722,21.3536309401358%,71.8370705616128%,2591,8105,10928,23.7097364568082%,74.1672767203514%,0.635064267352185,0.770860927152318,0.757759910246821,9725,9060,10696
1013,16,KANSAS,THOMAS,807,2822,3780,21.3492063492063%,74.6560846560847%,473,2908,3576,13.2270693512304%,81.3199105145414%,625,3130,3810,16.4041994750656%,82.1522309711286%,0.777624689997244,0.860100561963916,0.833555259653795,3629,3381,3755
1014,16,KANSAS,TREGO,516,1220,1837,28.0892759934676%,66.4126292868808%,198,1227,1482,13.3603238866397%,82.7935222672065%,242,1363,1630,14.8466257668712%,83.6196319018405%,0.702764976958525,0.861052631578947,0.849221183800623,1736,1425,1605
1015,16,KANSAS,WABAUNSEE,1025,2182,3420,29.9707602339181%,63.8011695906433%,776,2372,3380,22.9585798816568%,70.1775147928994%,964,2845,3902,24.7052793439262%,72.9113275243465%,0.680386654193951,0.753494282083863,0.746915200840116,3207,3148,3809
1016,16,KANSAS,WALLACE,103,737,861,11.9628339140534%,85.5981416957027%,46,721,798,5.76441102756892%,90.3508771929825%,44,770,825,5.33333333333333%,93.3333333333333%,0.877380952380952,0.940026075619296,0.945945945945946,840,767,814
1017,16,KANSAS,WASHINGTON,687,2446,3267,21.0284664830119%,74.8699112335476%,387,2194,2765,13.996383363472%,79.3490054249548%,475,2363,2883,16.4758931668401%,81.9632327436698%,0.780721353335461,0.850058117008911,0.832628611698379,3133,2581,2838
1018,16,KANSAS,WICHITA,207,859,1090,18.9908256880734%,78.8073394495413%,140,769,956,14.6443514644351%,80.4393305439331%,149,808,968,15.3925619834711%,83.4710743801653%,0.805816135084428,0.845984598459846,0.844305120167189,1066,909,957
1019,16,KANSAS,WILSON,1186,2748,4095,28.962148962149%,67.1062271062271%,594,2788,3591,16.5413533834586%,77.6385407964355%,723,3153,3954,18.2852807283763%,79.742033383915%,0.698525673614642,0.824364281490242,0.813467492260062,3934,3382,3876
1020,16,KANSAS,WOODSON,521,974,1595,32.6645768025078%,61.0658307210031%,273,1082,1443,18.9189189189189%,74.982674982675%,294,1228,1546,19.0168175937904%,79.4307891332471%,0.651505016722408,0.798523985239852,0.806833114323259,1495,1355,1522
1021,16,KANSAS,WYANDOTTE,32411,14024,48272,67.1424428239974%,29.0520384487902%,30146,15806,48781,61.7986511141633%,32.4019597794223%,36788,18934,56785,64.7847142731355%,33.3433124944968%,0.302013567352213,0.343967618384401,0.339793977244176,46435,45952,55722
1023,17,KENTUCKY,ADAIR,1779,5460,7328,24.2767467248908%,74.5087336244542%,1323,6637,8233,16.0694764970242%,80.6145997813677%,1392,7276,8763,15.8849709003766%,83.0309254821408%,0.754247824285122,0.833793969849246,0.839409321642824,7239,7960,8668
1024,17,KENTUCKY,ALLEN,1950,4415,6429,30.3313112459169%,68.6731995644735%,1349,6466,8096,16.6625494071146%,79.8666007905138%,1642,7586,9363,17.5371141728079%,81.0210402648724%,0.693637077769049,0.827383237364043,0.822063285652362,6365,7815,9228
1025,17,KENTUCKY,ANDERSON,2902,4909,7967,36.4252541734655%,61.6166687586293%,2634,8242,11422,23.0607599369638%,72.1589914200665%,3347,9657,13240,25.2794561933535%,72.9380664652568%,0.628472666752016,0.757815373299007,0.742617656105814,7811,10876,13004
1026,17,KENTUCKY,BALLARD,1880,1824,3770,49.867374005305%,48.3819628647215%,816,3161,4101,19.8975859546452%,77.0787612777371%,825,3356,4225,19.5266272189349%,79.4319526627219%,0.49244060475162,0.7948202162434,0.80267878497967,3704,3977,4181
1027,17,KENTUCKY,BARREN,4930,8741,13844,35.6110950592314%,63.1392661080613%,4275,13483,18488,23.1231068801385%,72.9283859800952%,5127,14654,20055,25.5646970830217%,73.0690600847669%,0.63938263477434,0.759263430566505,0.740811890197664,13671,17758,19781
1028,17,KENTUCKY,BATH,2087,2303,4473,46.6577241225129%,51.4866979655712%,1361,3082,4587,29.6708088074995%,67.1898844560715%,1573,3986,5627,27.9545050648658%,70.8370357206327%,0.524601366742597,0.693675444519469,0.717035438028422,4390,4443,5559
1029,17,KENTUCKY,BELL,4787,5585,10611,45.1135613985487%,52.6340589953822%,1720,7764,9718,17.6991150442478%,79.8929820950813%,1789,8140,10044,17.8116288331342%,81.0434090003982%,0.538468954878519,0.81864192323914,0.819820727162856,10372,9484,9929
1030,17,KENTUCKY,BOONE,9248,22016,31984,28.9144572286143%,68.8344172086043%,15026,39082,57618,26.0786559755632%,67.8294977264049%,20897,44811,66953,31.2114468358401%,66.9290397741699%,0.704196519959058,0.722296148443853,0.681971753819931,31264,54108,65708
1031,17,KENTUCKY,BOURBON,3048,3881,7102,42.9174880315404%,54.6465784286117%,2791,5569,8803,31.7051005339089%,63.2625241394979%,3296,6190,9643,34.1802343668983%,64.1916416053095%,0.560109683937076,0.666148325358852,0.652540586126924,6929,8360,9486
1032,17,KENTUCKY,BOYD,9541,9247,19182,49.7393389636117%,48.2066520696486%,6021,13591,20454,29.4367849809328%,66.4466607998435%,7083,14295,21741,32.5789982061543%,65.751345384297%,0.492175856929955,0.692994085253926,0.668678080269436,18788,19612,21378
1033,17,KENTUCKY,BOYLE,3963,6126,10326,38.3788495061011%,59.3259732713539%,4281,8040,12946,33.0681291518616%,62.1041248262011%,5298,8872,14467,36.6212760074653%,61.325775903781%,0.607195955991674,0.65254443632822,0.626111503175723,10089,12321,14170
1034,17,KENTUCKY,BRACKEN,888,2065,3019,29.4137131500497%,68.4001324942034%,705,2711,3527,19.9886589169266%,76.8641905301956%,800,3398,4244,18.8501413760603%,80.0659754948162%,0.699288858787674,0.793618266978923,0.809433063363506,2953,3416,4198
1035,17,KENTUCKY,BREATHITT,2902,2084,5073,57.2048097772521%,41.0802286615415%,1537,3991,5738,26.7863367026839%,69.5538515162077%,1301,4265,5661,22.9818053347465%,75.3400459282812%,0.417970316887284,0.721960926193922,0.766259432267337,4986,5528,5566
1036,17,KENTUCKY,BRECKINRIDGE,2595,4763,7453,34.8181940158325%,63.9071514826245%,1960,6484,8774,22.3387280601778%,73.9001595623433%,2350,7701,10197,23.0459939197803%,75.5222124154163%,0.647322642022289,0.767882520132639,0.766192418664809,7358,8444,10051
1037,17,KENTUCKY,BULLITT,8195,14054,22701,36.0997312893705%,61.9091669970486%,8255,26210,36069,22.8866894008706%,72.6662785217223%,10551,30708,41964,25.142979696883%,73.1770088647412%,0.631668839048946,0.760481648048745,0.744273976586926,22249,34465,41259
1038,17,KENTUCKY,BUTLER,1299,3654,5010,25.9281437125748%,72.9341317365269%,947,4428,5576,16.9835007173601%,79.4117647058823%,1079,4960,6122,17.624959163672%,81.0192747468148%,0.737734706238643,0.823813953488372,0.821328034442788,4953,5375,6039
1039,17,KENTUCKY,CALDWELL,2223,3161,5482,40.550893834367%,57.6614374315943%,1260,4507,5975,21.0878661087866%,75.4309623430962%,1433,4906,6428,22.2930927193528%,76.3223397635345%,0.587109955423477,0.781515519334143,0.773939107114687,5384,5767,6339
1040,17,KENTUCKY,CALLOWAY,5635,7705,13673,41.212608791048%,56.3519344693922%,4749,10367,16049,29.5906286996075%,64.5959249797495%,5794,11351,17443,33.2167631714728%,65.0748151120794%,0.577586206896552,0.685829584546176,0.662058909303004,13340,15116,17145
1041,17,KENTUCKY,CAMPBELL,12040,20789,33829,35.5907653196961%,61.4531910490999%,14658,25050,42510,34.4812985179958%,58.9273112208892%,19373,28482,48833,39.6719431531956%,58.32531280077%,0.63325108897621,0.630855243275914,0.595172918190367,32829,39708,47855
1042,17,KENTUCKY,CARLISLE,1149,1405,2593,44.3116081758581%,54.1843424604705%,432,2094,2601,16.6089965397924%,80.5074971164937%,463,2159,2638,17.5511751326763%,81.8423047763457%,0.550117462803446,0.828978622327791,0.823417238749046,2554,2526,2622
1043,17,KENTUCKY,CARROLL,1601,1818,3499,45.7559302657902%,51.9577022006288%,1106,2588,3855,28.6900129701686%,67.1335927367056%,1116,2954,4135,26.9891172914148%,71.4389359129383%,0.531734425270547,0.700595560368165,0.725798525798526,3419,3694,4070
1044,17,KENTUCKY,CARTER,4182,4617,8959,46.6793168880455%,51.5347695055252%,2276,7587,10278,22.1443860673283%,73.8178633975482%,2642,8775,11585,22.8053517479499%,75.7444971946483%,0.52471871803614,0.769238568386901,0.768590698081808,8799,9863,11417
1045,17,KENTUCKY,CASEY,1122,4284,5469,20.5156335710368%,78.3324190894131%,767,5482,6439,11.9117875446498%,85.1374437024383%,918,6179,7171,12.8015618463255%,86.1665039743411%,0.792452830188679,0.877260361657865,0.870649570240947,5406,6249,7097
1046,17,KENTUCKY,CHRISTIAN,6778,10787,17773,38.1364991841557%,60.6931862938165%,7188,14108,22083,32.549925281891%,63.8862473395825%,8296,15080,23863,34.7651175459917%,63.1940661274777%,0.614118986621121,0.662471825694966,0.645106091718001,17565,21296,23376
1047,17,KENTUCKY,CLARK,4918,7297,12473,39.4291670007216%,58.5023651086347%,4706,10710,16205,29.040419623573%,66.0907127429806%,6004,11811,18128,33.1200353045013%,65.1533539276258%,0.59738027015964,0.694732745199792,0.662980634296941,12215,15416,17815
1048,17,KENTUCKY,CLAY,1723,4926,6719,25.6436969787171%,73.3144813216253%,752,5861,6767,11.1127530663514%,86.6114969705926%,831,6677,7590,10.9486166007905%,87.9710144927536%,0.740863287712438,0.886284590957205,0.889318060735216,6649,6613,7508
1049,17,KENTUCKY,CLINTON,1032,3224,4305,23.9721254355401%,74.8896631823461%,547,3809,4462,12.2590766472434%,85.3653070372031%,603,4280,4932,12.2262773722628%,86.7802108678021%,0.757518796992481,0.874426078971534,0.876510342002867,4256,4356,4883
1050,17,KENTUCKY,CRITTENDEN,1610,2469,4154,38.7578237843043%,59.4366875300915%,617,3290,4037,15.2836264552886%,81.4961605152341%,731,3451,4242,17.2324375294672%,81.3531353135314%,0.605295415543025,0.842078320962375,0.82520325203252,4079,3907,4182
1051,17,KENTUCKY,CUMBERLAND,736,2220,3006,24.4843646041251%,73.8522954091816%,459,2502,3066,14.9706457925636%,81.6046966731898%,508,2769,3309,15.3520701118163%,83.6808703535811%,0.751014884979702,0.844984802431611,0.844980164784864,2956,2961,3277
1052,17,KENTUCKY,DAVIESS,14126,21361,36240,38.9790286975717%,58.9431567328918%,14163,28907,45807,30.918855196804%,63.1060754906455%,17283,31023,49240,35.0995125913891%,63.0036555645816%,0.601938738129456,0.671163222660785,0.642218357967954,35487,43070,48306
1053,17,KENTUCKY,EDMONSON,1710,3250,4995,34.2342342342342%,65.0650650650651%,979,4135,5244,18.6689549961861%,78.8520213577422%,1227,4828,6131,20.0130484423422%,78.7473495351492%,0.655241935483871,0.808564724286273,0.797357555739059,4960,5114,6055
1054,17,KENTUCKY,ELLIOTT,1525,827,2381,64.0487190256195%,34.7333053338933%,740,2000,2855,25.9194395796848%,70.0525394045534%,712,2246,2995,23.7729549248748%,74.991652754591%,0.351615646258503,0.72992700729927,0.759296822177147,2352,2740,2958
1055,17,KENTUCKY,ESTILL,1591,3033,4710,33.7791932059448%,64.3949044585987%,1108,4236,5545,19.9819657348963%,76.3931469792606%,1355,5100,6538,20.7249923524013%,78.0055062710309%,0.655925605536332,0.792664670658683,0.790085205267235,4624,5344,6455
1056,17,KENTUCKY,FAYETTE,47277,54495,105477,44.8220939162092%,51.6652919593845%,69778,56894,136315,51.1887906686718%,41.737152917874%,90566,58845,152664,59.3237436461772%,38.5454331080019%,0.53546162009197,0.44914424655804,0.3938465039388,101772,126672,149411
1057,17,KENTUCKY,FLEMING,1813,3282,5179,35.0067580614018%,63.3713072021626%,1348,4722,6260,21.5335463258786%,75.4313099041534%,1474,5534,7066,20.8604585338239%,78.3187093121993%,0.644160942100098,0.777924217462932,0.789668949771689,5095,6070,7008
1058,17,KENTUCKY,FLOYD,10088,5068,15394,65.5320254644667%,32.9219176302456%,4015,11993,16540,24.2744860943168%,72.5090689238211%,3884,12250,16351,23.7538988441074%,74.9189652009051%,0.334389020849828,0.749187906046976,0.759266146027024,15156,16008,16134
1059,17,KENTUCKY,FRANKLIN,10853,10209,21654,50.1200701948832%,47.1460238293156%,10717,11819,23865,44.9067672323486%,49.5244081290593%,12650,12900,26059,48.5436893203884%,49.5030507694079%,0.484711803247555,0.524449769258076,0.504892367906067,21062,22536,25550
1060,17,KENTUCKY,FULTON,1452,1293,2788,52.0803443328551%,46.377331420373%,774,1549,2382,32.4937027707809%,65.0293870696893%,791,1605,2421,32.6724494010739%,66.2949194547708%,0.47103825136612,0.666810159276797,0.669866444073456,2745,2323,2396
1061,17,KENTUCKY,GALLATIN,1049,1345,2459,42.6596177307849%,54.6970313135421%,749,2443,3338,22.4385859796285%,73.1875374475734%,822,2955,3849,21.3561964146532%,76.7731878409977%,0.561821219715957,0.765350877192982,0.782366957903098,2394,3192,3777
1062,17,KENTUCKY,GARRARD,1713,4043,5823,29.4178258629572%,69.4315644856603%,1453,5904,7623,19.0607372425554%,77.4498229043684%,1830,6754,8703,21.0272319889693%,77.6054234172125%,0.702397498262682,0.80250101943727,0.786812674743709,5756,7357,8584
1063,17,KENTUCKY,GRANT,2568,4405,7103,36.1537378572434%,62.0160495565254%,1910,7268,9559,19.9811695784078%,76.0330578512397%,2205,8725,11106,19.8541329011345%,78.5611381235368%,0.63172235766528,0.791893658749183,0.798261665141812,6973,9178,10930
1064,17,KENTUCKY,GRAVES,6097,7849,14231,42.8430890309887%,55.154240742042%,3308,12671,16606,19.920510658798%,76.3037456341082%,3559,13206,17018,20.9131507815254%,77.600188036197%,0.56281371002438,0.792978283997747,0.787712496271995,13946,15979,16765
1065,17,KENTUCKY,GRAYSON,2604,5843,8558,30.427670016359%,68.2752979668147%,1959,8219,10576,18.5230711043873%,77.713691376702%,2400,9453,11983,20.0283735291663%,78.8867562380038%,0.691724872735883,0.80752603654942,0.797519615287269,8447,10178,11853
1066,17,KENTUCKY,GREEN,1085,3615,4756,22.8132884777124%,76.0092514718251%,832,4372,5333,15.6009750609413%,81.9801237577349%,920,4838,5812,15.8293186510668%,83.2415691672402%,0.769148936170213,0.840122982321291,0.840222299409517,4700,5204,5758
1067,17,KENTUCKY,GREENUP,7164,7233,14663,48.8576689626952%,49.3282411511969%,4146,11546,16277,25.4715242366529%,70.9344473797383%,4873,13064,18176,26.8100792253521%,71.875%,0.502396332569285,0.735788937037981,0.728326922004795,14397,15692,17937
1068,17,KENTUCKY,HANCOCK,1508,2032,3610,41.7728531855956%,56.2880886426593%,1244,2788,4295,28.9639115250291%,64.9126891734575%,1351,3145,4587,29.4528013952474%,68.5633311532592%,0.574011299435028,0.691468253968254,0.699510676156584,3540,4032,4496
1069,17,KENTUCKY,HARDIN,11095,18964,30690,36.1518409905507%,61.7921146953405%,13944,26971,43156,32.3106868106405%,62.4965242376495%,18101,29832,48941,36.9853497067898%,60.9550274820702%,0.630892577930071,0.659195893926433,0.6223687230092,30059,40915,47933
1070,17,KENTUCKY,HARLAN,5365,4980,10535,50.9254864736592%,47.2710014238253%,1372,9129,10757,12.754485451334%,84.8656688667844%,1494,9367,10971,13.6177194421657%,85.3796372254125%,0.481391976800387,0.869345776592705,0.862443605561182,10345,10501,10861
1071,17,KENTUCKY,HARRISON,2658,3793,6611,40.2057177431554%,57.3740735138406%,2031,5435,7781,26.1020434391466%,69.8496337231718%,2400,6334,8853,27.1094544222297%,71.546368462668%,0.587970857231437,0.72796678274846,0.725211815891917,6451,7466,8734
1072,17,KENTUCKY,HART,2201,3725,6019,36.5675361355707%,61.8873567037714%,1730,5320,7264,23.8160792951542%,73.2378854625551%,1908,6345,8369,22.7984227506273%,75.8155096188314%,0.628585892676342,0.754609929078014,0.768811341330425,5926,7050,8253
1073,17,KENTUCKY,HENDERSON,8054,7698,16039,50.2151006920631%,47.9955109420787%,6707,12159,19710,34.0284119736175%,61.689497716895%,7639,12730,20688,36.9247873163186%,61.5332559938129%,0.488699847638395,0.644492738259302,0.62496931611763,15752,18866,20369
1074,17,KENTUCKY,HENRY,2117,3244,5473,38.6807966380413%,59.2727937145989%,1828,4944,7149,25.5700097915792%,69.1565253881662%,2142,5843,8107,26.421610953497%,72.0735167139509%,0.605110986756202,0.730064973419965,0.731747025673137,5361,6772,7985
1075,17,KENTUCKY,HICKMAN,940,1151,2124,44.256120527307%,54.1902071563089%,449,1657,2157,20.8159480760315%,76.8196569309226%,458,1714,2199,20.8276489313324%,77.9445202364711%,0.550454328072692,0.786799620132953,0.789134438305709,2091,2106,2172
1076,17,KENTUCKY,HOPKINS,6734,9490,16489,40.8393474437504%,57.5535205288374%,4310,15277,20345,21.1845662324896%,75.0897026296387%,5439,15757,21509,25.2870891254824%,73.2577060765261%,0.584935897435897,0.779956093327207,0.743394980184941,16224,19587,21196
1077,17,KENTUCKY,JACKSON,701,4079,4855,14.4387229660144%,84.0164778578785%,482,4889,5501,8.76204326486094%,88.8747500454463%,605,5453,6113,9.89694094552593%,89.2033371503353%,0.853347280334728,0.910258797244461,0.900132056784417,4780,5371,6058
1078,17,KENTUCKY,JEFFERSON,149901,145052,302362,49.5766663800345%,47.9729595650247%,190836,143768,353099,54.0460324158381%,40.7160598019252%,228288,150619,386093,59.1277231133432%,39.0110672817171%,0.491780046312463,0.42966611277809,0.397509151322092,294953,334604,378907
1079,17,KENTUCKY,JESSAMINE,4633,10074,15061,30.7615696168913%,66.8879888453622%,6144,15474,23326,26.3397067649833%,66.3379919403241%,8567,17096,26251,32.6349472401051%,65.1251380899775%,0.684979941524444,0.7157923952262,0.666173089662159,14707,21618,25663
1080,17,KENTUCKY,JOHNSON,3251,4783,8180,39.7432762836186%,58.4718826405868%,1250,8043,9572,13.0589218554116%,84.0263267864605%,1608,8450,10192,15.7770800627943%,82.9081632653061%,0.595344784665173,0.865490153879264,0.84012726188109,8034,9293,10058
1081,17,KENTUCKY,KENTON,19100,35363,56249,33.9561592206084%,62.8686732208573%,24214,42958,71998,33.6314897636045%,59.665546265174%,32265,48123,82108,39.2958055244312%,58.6093925074292%,0.649303196665626,0.639522420055976,0.598634124496193,54463,67172,80388
1082,17,KENTUCKY,KNOTT,4349,2029,6458,67.3428305977083%,31.4183957881697%,1245,4357,5763,21.603331598126%,75.6029845566545%,1412,4779,6251,22.5883858582627%,76.4517677171653%,0.318124804013797,0.777757943591574,0.771926990793087,6378,5602,6191
1083,17,KENTUCKY,KNOX,3690,6058,9910,37.2351160443996%,61.1301715438951%,1761,9885,12012,14.6603396603397%,82.2927072927073%,2114,11012,13273,15.9270699917125%,82.9654185187976%,0.621460812474354,0.848789283874292,0.838945604144446,9748,11646,13126
1084,17,KENTUCKY,LARUE,1727,3384,5179,33.3462058312416%,65.3407993821201%,1278,4799,6367,20.0722475263075%,75.3730171195225%,1504,5685,7301,20.5999178194768%,77.8660457471579%,0.662101350029348,0.789698864571335,0.790791486994019,5111,6077,7189
1085,17,KENTUCKY,LAUREL,4856,13029,18120,26.7991169977925%,71.9039735099338%,3440,20592,24833,13.8525349333548%,82.9219184150123%,4474,23234,28097,15.9234081930455%,82.6921023596825%,0.728487559407325,0.856857523302264,0.838530388335499,17885,24032,27708
1086,17,KENTUCKY,LAWRENCE,2258,2969,5307,42.5475786696816%,55.9449783305069%,1045,4816,6042,17.2955974842767%,79.7087057265806%,1238,5633,6955,17.8001437814522%,80.9920920201294%,0.568012244117084,0.821702781095376,0.819822442148159,5227,5861,6871
1087,17,KENTUCKY,LEE,836,1893,2764,30.246020260492%,68.4876989869754%,444,2151,2667,16.6479190101237%,80.6524184476941%,459,2159,2659,17.2621286197819%,81.1959383226777%,0.69366068156834,0.828901734104046,0.824675324675325,2729,2595,2618
1088,17,KENTUCKY,LESLIE,1210,3159,4434,27.2891294542174%,71.2449255751015%,400,4015,4492,8.90471950133571%,89.3811219946572%,446,4321,4811,9.27042194969861%,89.8150072749948%,0.72304875257496,0.909399773499434,0.906440109083281,4369,4415,4767
1089,17,KENTUCKY,LETCHER,4698,4092,8985,52.2871452420701%,45.542570951586%,1542,7293,9134,16.8819794175608%,79.8445368951171%,1799,7226,9135,19.6934865900383%,79.1023535851122%,0.465529010238908,0.825466893039049,0.800664819944598,8790,8835,9025
1090,17,KENTUCKY,LEWIS,1293,3217,4568,28.3056042031524%,70.4246935201401%,785,4363,5298,14.8169120422801%,82.3518308795772%,823,4986,5883,13.9894611592725%,84.7526772055074%,0.71330376940133,0.847513597513598,0.858323291444311,4510,5148,5809
1091,17,KENTUCKY,LINCOLN,2678,4795,7597,35.2507568777149%,63.1170198762669%,1865,7338,9561,19.5063277899801%,76.749294006903%,2254,8489,10913,20.6542655548428%,77.7879593145789%,0.641643249029841,0.797348690644355,0.790188960253188,7473,9203,10743
1092,17,KENTUCKY,LIVINGSTON,2022,2118,4230,47.8014184397163%,50.0709219858156%,887,3570,4645,19.0958019375673%,76.8568353067815%,939,4010,5003,18.768738756746%,80.1519088546872%,0.511594202898551,0.800987211128562,0.810264699939382,4140,4457,4949
1093,17,KENTUCKY,LOGAN,3885,5344,9332,41.6309472781826%,57.2653236176597%,2755,7778,10899,25.2775483989357%,71.3643453527847%,3094,9067,12346,25.0607484205411%,73.440790539446%,0.579044316827392,0.738441089907908,0.745580133212729,9229,10533,12161
1094,17,KENTUCKY,LYON,1680,1688,3420,49.1228070175439%,49.3567251461988%,1045,2789,3962,26.3755678950025%,70.3937405350833%,1092,3100,4228,25.8278145695364%,73.3207190160833%,0.501187648456057,0.727438706311946,0.739503816793893,3368,3834,4192
1095,17,KENTUCKY,MADISON,9309,13682,23666,39.3349108425589%,57.8128961379194%,11793,23431,37371,31.5565545476439%,62.6983489871826%,15580,27353,43903,35.4873243286336%,62.3032594583514%,0.595102431386195,0.665199863729276,0.637108983765402,22991,35224,42933
1096,17,KENTUCKY,MAGOFFIN,2603,2785,5453,47.7351916376307%,51.0728039611223%,1172,3824,5116,22.9085222830336%,74.7458952306489%,1213,4174,5446,22.2732280572898%,76.6434080058759%,0.516889383815887,0.765412329863891,0.774828290328569,5388,4996,5387
1097,17,KENTUCKY,MARION,2778,3259,6176,44.9805699481865%,52.7687823834197%,2679,5122,8111,33.0292195783504%,63.1488102576748%,2722,6113,8928,30.4883512544803%,68.469982078853%,0.539837667715753,0.656582489424433,0.691907187323147,6037,7801,8835
1098,17,KENTUCKY,MARSHALL,6203,7294,13761,45.0766659399753%,53.004868832207%,3672,12322,16698,21.9906575637801%,73.7932686549287%,4071,13297,17601,23.1293676495654%,75.5468439293222%,0.540416388827147,0.770413905214455,0.76560340856748,13497,15994,17368
1099,17,KENTUCKY,MARTIN,1714,2667,4456,38.4649910233393%,59.8518850987433%,363,3503,3953,9.18289906400202%,88.6162408297496%,403,3496,3930,10.2544529262087%,88.9567430025445%,0.608765122118238,0.906104500775996,0.896640164144653,4381,3866,3899
1100,17,KENTUCKY,MASON,2178,3572,5873,37.0849650945003%,60.8207049208241%,1970,4944,7219,27.2890982130489%,68.4859398808699%,2362,5477,7958,29.6808243277205%,68.8238250816788%,0.621217391304348,0.715070870697136,0.698686056895012,5750,6914,7839
1101,17,KENTUCKY,MCCRACKEN,11412,14745,26689,42.7591891790625%,55.2474802353029%,9134,20774,31307,29.1755837352669%,66.3557670808445%,11190,21820,33521,33.3820590077862%,65.0935234629038%,0.563711434797569,0.694596763407784,0.661011814601636,26157,29908,33010
1102,17,KENTUCKY,MCCREARY,1418,3321,4799,29.5478224630131%,69.2019170660554%,664,5012,5776,11.4958448753463%,86.7728531855956%,725,5664,6435,11.2665112665113%,88.018648018648%,0.700780755433636,0.883016208597604,0.886523712631085,4739,5676,6389
1103,17,KENTUCKY,MCLEAN,1747,2219,4022,43.4361014420686%,55.1715564395823%,988,3381,4566,21.6381953569864%,74.0473061760841%,1074,3633,4782,22.4592220828105%,75.9723964868256%,0.559505799293999,0.773861295490959,0.77182919056724,3966,4369,4707
1104,17,KENTUCKY,MEADE,3596,5319,9071,39.6428177709183%,58.6374159409106%,3026,8660,12231,24.7404137028861%,70.8036955277573%,3632,10184,14110,25.7406094968108%,72.1757618710135%,0.596634885025238,0.741057675851446,0.737116386797915,8915,11686,13816
1105,17,KENTUCKY,MENIFEE,1038,1170,2249,46.1538461538462%,52.0231213872832%,700,2010,2779,25.1889168765743%,72.3281756027348%,750,2311,3102,24.1779497098646%,74.5003223726628%,0.529891304347826,0.74169741697417,0.754982032015681,2208,2710,3061
1106,17,KENTUCKY,MERCER,3092,5362,8632,35.820203892493%,62.1177015755329%,2395,7740,10585,22.6263580538498%,73.12234293812%,3033,8506,11735,25.8457605453771%,72.4840221559438%,0.634255973503667,0.763690182535767,0.737152266227576,8454,10135,11539
1107,17,KENTUCKY,METCALFE,1318,2476,3849,34.2426604312809%,64.3283969862302%,976,3491,4620,21.1255411255411%,75.5627705627706%,975,3959,5012,19.4533120510774%,78.9904229848364%,0.65260938323669,0.781508842623685,0.802391568706931,3794,4467,4934
1108,17,KENTUCKY,MONROE,1158,4377,5569,20.7936792961034%,78.5957981684324%,601,4278,4991,12.0416750150271%,85.7142857142857%,657,4628,5330,12.3264540337711%,86.8292682926829%,0.790785907859079,0.876819020291043,0.875685903500473,5535,4879,5285
1109,17,KENTUCKY,MONTGOMERY,3833,4534,8519,44.9935438431741%,53.2222091794812%,3158,7856,11452,27.5759692630108%,68.5993712888579%,3630,8993,12837,28.2776349614396%,70.0553088727896%,0.54189076132425,0.71327401489014,0.712429691832369,8367,11014,12623
1110,17,KENTUCKY,MORGAN,1875,2295,4240,44.2216981132076%,54.127358490566%,1006,3628,4775,21.0680628272251%,75.979057591623%,1172,4297,5535,21.1743450767841%,77.6332429990967%,0.550359712230216,0.782908933966336,0.785701225086853,4170,4634,5469
1111,17,KENTUCKY,MUHLENBERG,6295,5518,11956,52.6513884242222%,46.1525593844095%,3272,9393,13060,25.0535987748851%,71.9218989280245%,3544,10496,14229,24.90688031485%,73.7648464403683%,0.467112503174469,0.741650217133833,0.747578347578348,11813,12665,14040
1112,17,KENTUCKY,NELSON,5481,7714,13488,40.6361209964413%,57.1915776986951%,6434,13431,20802,30.9297182963177%,64.565907124315%,7188,15703,23245,30.9227790922779%,67.5543127554313%,0.584615384615385,0.676113767933552,0.685990127124197,13195,19865,22891
1113,17,KENTUCKY,NICHOLAS,994,1613,2673,37.1866816311261%,60.3441825664048%,787,1957,2841,27.7015135515663%,68.8841957057374%,955,2408,3396,28.1213191990577%,70.906949352179%,0.618718833908707,0.713192419825073,0.71602735652691,2607,2744,3363
1114,17,KENTUCKY,OHIO,3303,5413,8882,37.1875703670345%,60.9434811979284%,2080,7942,10398,20.0038468936334%,76.380073090979%,2404,8582,11127,21.6051047002786%,77.1277073784488%,0.621041762276273,0.792456595489922,0.781176042235573,8716,10022,10986
1115,17,KENTUCKY,OLDHAM,6236,13580,20268,30.7677126504835%,67.0021709098086%,10268,20469,32853,31.2543755517%,62.3048123459045%,14504,22651,37936,38.2328131590046%,59.7084563475327%,0.685304804198627,0.665940072225656,0.609635311532768,19816,30737,37155
1116,17,KENTUCKY,OWEN,1394,2582,4070,34.2506142506143%,63.4398034398034%,1062,3745,5001,21.2357528494301%,74.8850229954009%,1098,4292,5456,20.124633431085%,78.6656891495601%,0.649396378269618,0.779072186394841,0.796289424860853,3976,4807,5390
1117,17,KENTUCKY,OWSLEY,339,1466,1826,18.565169769989%,80.2847754654984%,256,1474,1759,14.5537237066515%,83.7976122797044%,216,1670,1895,11.3984168865435%,88.1266490765172%,0.81218836565097,0.852023121387283,0.885471898197243,1805,1730,1886
1118,17,KENTUCKY,PENDLETON,1670,3044,4803,34.769935457006%,63.3770560066625%,1164,4604,6007,19.3773930414516%,76.643915431996%,1322,5515,6925,19.0902527075812%,79.6389891696751%,0.645736105218498,0.798196948682386,0.806640339330115,4714,5768,6837
1119,17,KENTUCKY,PERRY,5514,5300,11000,50.1272727272727%,48.1818181818182%,2136,8158,10572,20.2043132803632%,77.1660991297768%,2350,8118,10606,22.1572694701113%,76.5415802376014%,0.490105418901424,0.792500485719837,0.775506304929308,10814,10294,10468
1120,17,KENTUCKY,PIKE,13611,11005,24935,54.5859234008422%,44.1347503509124%,4280,19747,24665,17.352523819177%,80.060814919927%,4862,20279,25368,19.1658782718385%,79.939293598234%,0.447066948326292,0.821867066217172,0.806610715564218,24616,24027,25141
1121,17,KENTUCKY,POWELL,2008,2258,4362,46.033929390188%,51.765245300321%,1272,3513,4957,25.6606818640307%,70.8694775065564%,1367,4041,5505,24.8319709355132%,73.4059945504087%,0.529301453352086,0.734169278996865,0.747226331360947,4266,4785,5408
1122,17,KENTUCKY,PULASKI,5415,15845,21541,25.1381087229005%,73.5574021633165%,4208,22902,28041,15.0065974822581%,81.6732641489248%,5664,25441,31537,17.959856676285%,80.6703237467102%,0.745296331138288,0.844780523791959,0.817907088892461,21260,27110,31105
1123,17,KENTUCKY,ROBERTSON,341,630,998,34.1683366733467%,63.12625250501%,222,759,1013,21.9151036525173%,74.9259624876604%,253,884,1146,22.0767888307155%,77.1378708551483%,0.648815653964985,0.773700305810397,0.777484608619173,971,981,1137
1124,17,KENTUCKY,ROCKCASTLE,1174,3992,5247,22.3746902992186%,76.0815704211931%,915,5609,6691,13.6750859363324%,83.8290240621731%,1134,6577,7783,14.5702171399203%,84.5046897083387%,0.772744870305846,0.859748620478234,0.85293736220983,5166,6524,7711
1125,17,KENTUCKY,ROWAN,3505,3546,7226,48.5053971768613%,49.0727926930529%,3295,5174,8848,37.2400542495479%,58.4764918625678%,3880,5994,10058,38.5762577053092%,59.5943527540266%,0.502907389022834,0.610933994568426,0.60704881506988,7051,8469,9874
1126,17,KENTUCKY,RUSSELL,1710,5268,7074,24.1730279898219%,74.4698897370653%,1093,6863,8174,13.3716662588696%,83.9613408367996%,1329,7506,8939,14.8674348361114%,83.9691240630943%,0.754944110060189,0.862619406737054,0.849575551782682,6978,7956,8835
1127,17,KENTUCKY,SCOTT,5472,7952,13786,39.6924416074278%,57.6817060786305%,7715,15052,24200,31.8801652892562%,62.198347107438%,10564,17764,28950,36.4905008635579%,61.3609671848014%,0.592371871275328,0.661132340668511,0.627082744987292,13424,22767,28328
1128,17,KENTUCKY,SHELBY,4435,8068,12738,34.8170827445439%,63.3380436489245%,6276,13196,20580,30.4956268221574%,64.1205053449951%,8076,15054,23542,34.3046470138476%,63.9452892702404%,0.645285131568424,0.677691043549712,0.650843060959793,12503,19472,23130
1129,17,KENTUCKY,SIMPSON,2583,3169,5824,44.3509615384615%,54.4127747252747%,2144,5077,7531,28.4689948214049%,67.4146859646793%,2681,5888,8732,30.7031607879065%,67.4301420064132%,0.550938803894298,0.70308821492868,0.687128019605555,5752,7221,8569
1130,17,KENTUCKY,SPENCER,1554,3150,4772,32.5649622799665%,66.0100586756077%,1921,7196,9515,20.1891749868628%,75.6279558591697%,2530,8737,11429,22.1366698748797%,76.445883279377%,0.669642857142857,0.789294724141713,0.775450430460637,4704,9117,11267
1131,17,KENTUCKY,TAYLOR,2790,6151,9051,30.8253231687106%,67.9593415092255%,2553,8320,11306,22.5809304793915%,73.589244648859%,2961,9376,12510,23.6690647482014%,74.9480415667466%,0.687954367520412,0.765198197369631,0.759990273162033,8941,10873,12337
1132,17,KENTUCKY,TODD,1496,2646,4187,35.7296393599236%,63.1956054454263%,1042,3612,4779,21.8037246285834%,75.5806654111739%,1202,4060,5351,22.463091011026%,75.8736684731826%,0.638821825205215,0.776106574989256,0.771569745343976,4142,4654,5262
1133,17,KENTUCKY,TRIGG,2110,3130,5344,39.4835329341317%,58.5703592814371%,1587,4931,6751,23.5076284994816%,73.0410309583765%,1791,5487,7375,24.2847457627119%,74.4%,0.597328244274809,0.756520405032219,0.753915910964551,5240,6518,7278
1134,17,KENTUCKY,TRIMBLE,1181,1837,3081,38.3317104836092%,59.6234988640052%,879,2771,3798,23.1437598736177%,72.9594523433386%,1012,3227,4319,23.4313498495022%,74.7163695299838%,0.608681245858184,0.759178082191781,0.761264449162538,3018,3650,4239
1135,17,KENTUCKY,UNION,2547,2749,5368,47.4478390461997%,51.2108792846498%,1331,4701,6211,21.4297214619224%,75.6882949605539%,1529,4965,6576,23.2512165450122%,75.5018248175183%,0.519070996978852,0.77934350132626,0.764551894056052,5296,6032,6494
1136,17,KENTUCKY,WARREN,12180,20235,32975,36.937073540561%,61.3646702047005%,16966,28673,48454,35.0146530730177%,59.1757130474264%,22477,31790,55351,40.608119094506%,57.433470036675%,0.624248033317908,0.628256534981047,0.58580721248641,32415,45639,54267
1137,17,KENTUCKY,WASHINGTON,1458,3044,4588,31.7785527462947%,66.3469921534438%,1420,4013,5636,25.1951738821859%,71.2029808374734%,1644,4482,6223,26.4181263056404%,72.0231399646473%,0.676143936028432,0.73863427204123,0.731635651322233,4502,5433,6126
1138,17,KENTUCKY,WAYNE,2312,4069,6474,35.7120790855731%,62.85140562249%,1431,6371,7992,17.9054054054054%,79.7172172172172%,1700,7430,9240,18.3982683982684%,80.4112554112554%,0.637674345713838,0.816585490899769,0.813800657174151,6381,7802,9130
1139,17,KENTUCKY,WEBSTER,2388,2599,5072,47.0820189274448%,51.2421135646688%,1240,4397,5805,21.3608957795004%,75.7450473729544%,1412,4506,5991,23.5686863628776%,75.2128192288433%,0.52115500300782,0.780024835905624,0.761405880364988,4987,5637,5918
1140,17,KENTUCKY,WHITLEY,4101,7502,11774,34.8309835230168%,63.7166638355699%,2067,11312,13774,15.0065340496588%,82.1257441556556%,2552,12567,15347,16.6286570665277%,81.8857105623249%,0.646556924933207,0.8455041482921,0.831205767577221,11603,13379,15119
1141,17,KENTUCKY,WOLFE,1136,1267,2425,46.8453608247423%,52.2474226804124%,753,1804,2635,28.5768500948767%,68.4629981024668%,839,2097,2979,28.163813360188%,70.392749244713%,0.527257594673325,0.705514274540477,0.714237057220708,2403,2557,2936
1142,17,KENTUCKY,WOODFORD,3995,5890,10137,39.4100818782677%,58.1039755351682%,4958,7697,13563,36.5553343655533%,56.7499815674998%,6530,8362,15211,42.9294589441851%,54.973374531589%,0.595852301466869,0.608218095614382,0.561509535320978,9885,12655,14892
1144,18,LOUISIANA,ACADIA,8892,13814,23238,38.2649109217661%,59.4457354333419%,5638,21162,27389,20.5849063492643%,77.2645952754756%,5443,22596,28425,19.1486367634125%,79.4934036939314%,0.608385448780058,0.789626865671642,0.805877527729234,22706,26800,28039
1145,18,LOUISIANA,ALLEN,3914,4035,8292,47.2021225277376%,48.6613603473227%,2106,6867,9245,22.7798810167658%,74.2779881016766%,2108,7574,9810,21.4882772680938%,77.2069317023446%,0.50761102025412,0.765295887662989,0.78227638917579,7949,8973,9682
1146,18,LOUISIANA,ASCENSION,13385,16818,30844,43.3957982103489%,54.5260018155881%,16476,36143,54678,30.132777351037%,66.1015399246498%,20399,40687,62325,32.7300441235459%,65.2819895707982%,0.556832102771248,0.686881164598339,0.666060963232164,30203,52619,61086
1147,18,LOUISIANA,ASSUMPTION,5222,4388,10053,51.9446931264299%,43.6486620909181%,3931,6714,10904,36.0509904622157%,61.573734409391%,3833,7271,11235,34.1165999109924%,64.7174009790832%,0.456607700312175,0.630718647252231,0.654809077809798,9610,10645,11104
1148,18,LOUISIANA,AVOYELLES,6701,7329,14653,45.7312495734662%,50.017061352624%,5035,11165,16586,30.3569275292415%,67.3158085132039%,4979,12028,17292,28.793661808929%,69.558177191765%,0.522380612972202,0.689197530864198,0.707238196036926,14030,16200,17007
1149,18,LOUISIANA,BEAUREGARD,3958,7862,12205,32.4293322408849%,64.4162228594838%,2393,12238,15078,15.8708051465712%,81.1646106910731%,2542,13575,16357,15.5407470807605%,82.9919911964297%,0.665143824027073,0.836443168614585,0.842278339641372,11820,14631,16117
1150,18,LOUISIANA,BIENVILLE,3413,3269,7006,48.7153868113046%,46.660005709392%,3129,3756,7005,44.6680942184154%,53.6188436830835%,3067,3891,7050,43.5035460992908%,55.1914893617021%,0.489224782999102,0.545533769063181,0.559212417361311,6682,6885,6958
1151,18,LOUISIANA,BOSSIER,11933,23224,35915,33.225671724906%,64.6637895029932%,12641,35474,49848,25.3590916385813%,71.1643395923608%,15662,38074,54655,28.6561156344342%,69.662427957186%,0.660579685411156,0.73727527797984,0.708538037814501,35157,48115,53736
1152,18,LOUISIANA,CADDO,47530,46807,95639,49.6972992189379%,48.9413314651973%,53483,49006,105804,50.5491285773695%,46.3177195569166%,55110,48021,104912,52.5297392100046%,45.7726475522343%,0.496167993470218,0.478158631658032,0.465631090554731,94337,102489,103131
1153,18,LOUISIANA,CALCASIEU,33919,38086,73636,46.0630669781085%,51.7219838122657%,26296,54191,83785,31.38509279704%,64.6786417616518%,25982,55066,82663,31.4312328369403%,66.6150514740573%,0.528935490590931,0.673288854100662,0.67942453854506,72005,80487,81048
1154,18,LOUISIANA,CALDWELL,1359,2817,4328,31.4001848428836%,65.0878003696858%,788,3822,4692,16.7945439045183%,81.457800511509%,745,3976,4762,15.6446871062579%,83.4943301133977%,0.674568965517241,0.829067245119306,0.84219445032832,4176,4610,4721
1155,18,LOUISIANA,CAMERON,1435,2593,4183,34.3055223523787%,61.9890031078174%,323,3256,3692,8.74864572047671%,88.1906825568797%,324,3671,4039,8.02178757118099%,90.8888338697697%,0.643743793445879,0.909751327186365,0.918898623279099,4028,3579,3995
1156,18,LOUISIANA,CATAHOULA,1718,2912,4765,36.0545645330535%,61.112277019937%,1322,3479,4856,27.2240527182867%,71.6433278418451%,1269,3541,4858,26.1218608480856%,72.8900782214903%,0.628941684665227,0.724640699854197,0.736174636174636,4630,4801,4810
1157,18,LOUISIANA,CLAIBORNE,2721,3384,6281,43.3211272090431%,53.8767712147747%,2717,3585,6421,42.3142812646005%,55.8324248559414%,2731,3770,6580,41.5045592705167%,57.2948328267477%,0.554299754299754,0.568867026340844,0.579910782956468,6105,6302,6501
1158,18,LOUISIANA,CONCORDIA,3569,4627,8499,41.9931756677256%,54.4416990234145%,3272,5477,8872,36.8800721370604%,61.7335437330929%,3177,5550,8828,35.9877661984594%,62.8681468056185%,0.564543679843826,0.626014401645902,0.635957373667927,8196,8749,8727
1159,18,LOUISIANA,DE SOTO,5036,5260,10596,47.5273688184221%,49.6413741034353%,5165,8068,13500,38.2592592592593%,59.762962962963%,5457,9112,14736,37.0317589576547%,61.8349619978285%,0.510878010878011,0.609687901458475,0.625437572928822,10296,13233,14569
1160,18,LOUISIANA,EAST BATON ROUGE,76516,89128,168989,45.2786867784294%,52.7418944428336%,102828,84660,196491,52.332167885552%,43.0859428676123%,115577,88420,208182,55.5172877578273%,42.4724519891249%,0.538069595035136,0.451548899129544,0.433437746633529,165644,187488,203997
1161,18,LOUISIANA,EAST CARROLL,1876,1280,3245,57.8120184899846%,39.4453004622496%,1838,1059,2939,62.5382783259612%,36.0326641714869%,1900,1080,3036,62.5823451910408%,35.5731225296443%,0.405576679340938,0.365550569554712,0.36241610738255,3156,2897,2980
1162,18,LOUISIANA,EAST FELICIANA,3870,4051,8099,47.7836769971601%,50.0185208050377%,4235,5569,10042,42.1728739294961%,55.4570802628958%,4280,6064,10509,40.7269959082691%,57.7029213055476%,0.511425325085217,0.568033455732354,0.586233565351895,7921,9804,10344
1163,18,LOUISIANA,EVANGELINE,5763,7290,13612,42.3376432559506%,53.5556861592712%,4208,10360,14882,28.2757693858352%,69.6142991533396%,4158,11053,15412,26.9789774201921%,71.7168440176486%,0.558492300620547,0.7111477210324,0.726645190980212,13053,14568,15211
1164,18,LOUISIANA,FRANKLIN,2792,5363,8356,33.4131163235998%,64.181426519866%,2506,6514,9162,27.3521065269592%,71.0980135341629%,2658,6970,9720,27.3456790123457%,71.7078189300412%,0.657633353770693,0.722172949002217,0.723930203572912,8155,9020,9628
1165,18,LOUISIANA,GRANT,2099,4784,7055,29.75194897236%,67.81006378455%,1181,7408,8821,13.388504704682%,83.9814080036277%,1157,8117,9392,12.3189948892675%,86.4246166950596%,0.695045764928084,0.862498544650134,0.875242613758896,6883,8589,9274
1166,18,LOUISIANA,IBERIA,11762,17236,30020,39.180546302465%,57.4150566289141%,10698,20903,32454,32.9635792198188%,64.4080852899488%,11027,21251,32713,33.7083116803717%,64.9619417357014%,0.594385819711704,0.661466409290845,0.658374124790879,28998,31601,32278
1167,18,LOUISIANA,IBERVILLE,8355,5573,14503,57.6087705991864%,38.4265324415638%,8324,7320,16043,51.8855575640466%,45.6273764258555%,8514,7893,16719,50.9240983312399%,47.209761349363%,0.400129236071223,0.467911020199437,0.481075150850247,13928,15644,16407
1168,18,LOUISIANA,JACKSON,2582,4347,7106,36.3354911342527%,61.1736560652969%,2139,5169,7464,28.6575562700965%,69.2524115755627%,2143,5394,7632,28.0791404612159%,70.6761006289308%,0.62736325588108,0.707307060755337,0.715669364468621,6929,7308,7537
1169,18,LOUISIANA,JEFFERSON,70411,105003,179151,39.3025994831176%,58.611450675687%,73670,100398,181639,40.5584703725522%,55.2733719080153%,84477,105949,193733,43.6048582327224%,54.6881532831268%,0.598601023863546,0.576774593836891,0.556378855828511,175414,174068,190426
1170,18,LOUISIANA,JEFFERSON DAVIS,5162,6945,12546,41.1445879164674%,55.3562888570062%,3080,10775,14277,21.5731596273727%,75.471037332773%,3208,11423,14841,21.6157940839566%,76.969206926757%,0.573635087139671,0.777697582100325,0.780739525664685,12107,13855,14631
1171,18,LOUISIANA,LA SALLE,1397,4564,6108,22.871643745907%,74.7216764898494%,605,5836,6569,9.20992540721571%,88.8415283909271%,638,6378,7077,9.01511940087608%,90.1229334463756%,0.765643348431471,0.906070485949387,0.909064994298746,5961,6441,7016
1172,18,LOUISIANA,LAFAYETTE,27190,48491,78293,34.7285197910413%,61.9352943430447%,32726,68195,105603,30.9896499152486%,64.5767639176917%,39685,72519,114521,34.6530330681709%,63.323757214834%,0.640728848720286,0.675726558397162,0.646313856903497,75681,100921,112204
1173,18,LOUISIANA,LAFOURCHE,14627,18575,34449,42.4598682109786%,53.9202879619147%,8423,31959,41645,20.225717373034%,76.7415055829031%,8672,36024,45388,19.1063717282101%,79.3689962104521%,0.559454249743991,0.79141696795602,0.805978163594058,33202,40382,44696
1174,18,LOUISIANA,LINCOLN,6851,9246,16551,41.3932692888647%,55.8636940366141%,7107,10761,18669,38.0684557287482%,57.6410091595693%,7559,11311,19275,39.2166018158236%,58.6822308690013%,0.574392743989563,0.602249832102082,0.599417064122946,16097,17868,18870
1175,18,LOUISIANA,LIVINGSTON,11008,24889,36865,29.860301098603%,67.513902075139%,6950,48824,57730,12.0388013164732%,84.5730122986316%,9249,54877,65230,14.179058715315%,84.1284684960908%,0.693344847758866,0.875389966651128,0.85576833109815,35897,55774,64126
1176,18,LOUISIANA,MADISON,2489,2127,4743,52.4773350200295%,44.8450347881088%,2744,1927,4732,57.9881656804734%,40.7227387996619%,2654,1930,4670,56.830835117773%,41.3276231263383%,0.46078856152513,0.412545493470349,0.421029668411867,4616,4671,4584
1177,18,LOUISIANA,MOREHOUSE,5289,6641,12321,42.9267104942781%,53.8998457917377%,5155,6502,11852,43.4947688153898%,54.8599392507594%,4946,6510,11574,42.7337134957664%,56.2467599792639%,0.556663872590109,0.557776443338766,0.568261173184358,11930,11657,11456
1178,18,LOUISIANA,NATCHITOCHES,6924,7332,14857,46.6042942720603%,49.3504745237935%,7144,8968,16621,42.9817700499368%,53.9558389988569%,6896,9358,16554,41.6576054125891%,56.530143771898%,0.514309764309764,0.556603773584906,0.57573520364218,14256,16112,16254
1179,18,LOUISIANA,ORLEANS,137630,39404,181221,75.945944454561%,21.74361690974%,133996,24292,165812,80.8120039562879%,14.6503268762213%,147854,26664,177819,83.148594919553%,14.9950230290351%,0.222578713693415,0.153467097948044,0.15278653204827,177034,158288,174518
1180,18,LOUISIANA,OUACHITA,21457,35107,58211,36.8607307897133%,60.3099070622391%,24428,41734,68017,35.9145507740712%,61.3581898642986%,25913,42255,69166,37.4649394211029%,61.0921551051094%,0.620659783607948,0.630785042773798,0.619865626100223,56564,66162,68168
1181,18,LOUISIANA,PLAQUEMINES,4425,6302,10931,40.4812002561522%,57.6525477998353%,3347,6900,10573,31.6561051735553%,65.2605693748227%,3414,7412,11014,30.996913019793%,67.2961685128019%,0.587489512445232,0.673367814970235,0.684648069462405,10727,10247,10826
1182,18,LOUISIANA,POINTE COUPEE,5813,4710,10832,53.6650664697194%,43.4822747415067%,4764,6789,11761,40.5067596292832%,57.7246832752317%,4683,7503,12371,37.854660092151%,60.6499070406596%,0.447590991162216,0.587639574136588,0.615706548498277,10523,11553,12186
1183,18,LOUISIANA,RAPIDES,18898,28831,49024,38.5484660574413%,58.8099706266319%,18322,36816,56844,32.23207374569%,64.766729997889%,19475,38347,58865,33.0841756561624%,65.1439734986834%,0.604056234155335,0.667706481918096,0.663190481131749,47729,55138,57822
1184,18,LOUISIANA,RED RIVER,2177,2200,4522,48.1424148606811%,48.6510393631137%,1938,2391,4422,43.8263229308005%,54.0705563093623%,1644,2413,4132,39.7870280735721%,58.3978702807357%,0.502627370344985,0.552321552321552,0.594774463889574,4377,4329,4057
1185,18,LOUISIANA,RICHLAND,3282,4895,8485,38.6800235710077%,57.6900412492634%,3157,6287,9597,32.8956965718454%,65.5100552255913%,3225,6607,9940,32.4446680080483%,66.4688128772636%,0.598630304512657,0.665713680643795,0.671989422294548,8177,9444,9832
1186,18,LOUISIANA,SABINE,2846,5754,8862,32.1146468065899%,64.9289099526066%,1703,7879,9787,17.4006334934096%,80.5047512005722%,1731,8776,10596,16.3363533408834%,82.8237070592676%,0.66906976744186,0.822270924650386,0.835252688683735,8600,9582,10507
1187,18,LOUISIANA,ST. BERNARD,11682,16255,28621,40.8161839208973%,56.7939624751057%,4960,10237,15815,31.3626304141638%,64.729687006007%,6151,11179,17650,34.8498583569405%,63.3371104815864%,0.581844865232487,0.673619793380272,0.645066358915176,27937,15197,17330
1188,18,LOUISIANA,ST. CHARLES,8918,11981,21510,41.4597861459786%,55.6996745699675%,8559,16621,26192,32.6779169211973%,63.4583078802688%,9800,18233,28517,34.365466213136%,63.9373005575622%,0.573281018230537,0.660087370929309,0.650412014411586,20899,25180,28033
1189,18,LOUISIANA,ST. HELENA,3059,1965,5254,58.2223068138561%,37.4000761324705%,3353,2497,5964,56.2206572769953%,41.8678739101274%,3346,2714,6158,54.3358233192595%,44.0727508931471%,0.391122611464968,0.426837606837607,0.447854785478548,5024,5850,6060
1190,18,LOUISIANA,ST. JAMES,6523,3813,10705,60.9341429238673%,35.6188696870621%,6418,5456,12085,53.1071576334299%,45.1468762929251%,6510,5954,12590,51.7077045274027%,47.2915011914218%,0.36890479876161,0.459491325585312,0.477695763799743,10336,11874,12464
1191,18,LOUISIANA,ST. JOHN THE BAPTIST,9745,7423,17713,55.0160898774911%,41.907073900525%,12661,7569,20743,61.0374584197079%,36.4894181169551%,13582,7538,21432,63.3725270623367%,35.1717058603957%,0.432374184529357,0.374147305981216,0.356912878787879,17168,20230,21120
1192,18,LOUISIANA,ST. LANDRY,18067,15449,34151,52.9032824807473%,45.2373283359199%,17209,21971,39977,43.0472521699978%,54.9591014833529%,17372,23171,41154,42.2121786460611%,56.3031540069009%,0.4609440267335,0.560770801429301,0.571516661322546,33516,39180,40543
1193,18,LOUISIANA,ST. MARTIN,9853,9961,20778,47.4203484454712%,47.9401289825777%,8266,16873,25750,32.1009708737864%,65.526213592233%,8439,18203,27038,31.2116280789999%,67.3237665507804%,0.502725345715151,0.671188193643343,0.683244501163576,19814,25139,26642
1194,18,LOUISIANA,ST. MARY,9851,11325,21810,45.1673544245759%,51.9257221458047%,8050,14359,22877,35.1881802683918%,62.7660969532718%,8055,14811,23186,34.7407918571552%,63.8790649529889%,0.534803551190026,0.640769333749833,0.647730254526371,21176,22409,22866
1195,18,LOUISIANA,ST. TAMMANY,22722,59193,83737,27.134958262178%,70.6891816043087%,27717,90915,124392,22.281979548524%,73.0874975882693%,37746,99666,140110,26.9402612233245%,71.1341089144244%,0.722614905694928,0.766361521343314,0.725307833376998,81915,118632,137412
1196,18,LOUISIANA,TANGIPAHOA,15843,20421,37155,42.6402906742027%,54.9616471538151%,16878,33959,52416,32.2000915750916%,64.7874694749695%,18887,37806,57661,32.7552418445743%,65.5659804720695%,0.563120450033091,0.667997718197376,0.666854814527367,36264,50837,56693
1197,18,LOUISIANA,TENSAS,1580,1330,3010,52.4916943521595%,44.1860465116279%,1332,1182,2548,52.276295133438%,46.3893249607535%,1329,1197,2554,52.03602192639%,46.8676585747847%,0.457044673539519,0.470167064439141,0.473871733966746,2910,2514,2526
1198,18,LOUISIANA,TERREBONNE,14414,21314,36675,39.3019768234492%,58.1158827539196%,10665,31902,43896,24.2960634226353%,72.6763258611263%,11198,34339,46240,24.2171280276817%,74.2625432525952%,0.596562919838782,0.749453802241173,0.754090080593803,35728,42567,45537
1199,18,LOUISIANA,UNION,3205,5772,9343,34.3037568232902%,61.7788718826929%,2691,7972,10894,24.7016706443914%,73.1778960895906%,2654,8407,11201,23.6943130077672%,75.0557985894117%,0.642976495488471,0.747631998499484,0.760057860952897,8977,10663,11061
1200,18,LOUISIANA,VERMILION,8704,12495,22235,39.1454913424781%,56.195187767034%,4857,20063,25632,18.9489700374532%,78.273252184769%,5009,21930,27324,18.3318694188259%,80.2591128678085%,0.589414595028067,0.805096308186196,0.814061397973199,21199,24920,26939
1201,18,LOUISIANA,VERNON,4655,8794,13827,33.6660157662544%,63.6002025023505%,2665,13471,16633,16.0223651776589%,80.9895989899597%,2898,14107,17268,16.7824878387769%,81.6944637479731%,0.653877611718343,0.834841348537432,0.829579535430756,13449,16136,17005
1202,18,LOUISIANA,WASHINGTON,7399,8983,16887,43.814768757032%,53.1947652040031%,5692,12556,18628,30.5561520292034%,67.4039080953403%,5970,13307,19513,30.5949879567468%,68.1955619330703%,0.548345745330241,0.688075405523893,0.690304507962857,16382,18248,19277
1203,18,LOUISIANA,WEBSTER,7197,9420,17090,42.1123464014043%,55.1199531889994%,6260,11542,18145,34.4998622209975%,63.6098098649766%,6172,11830,18216,33.8823012736056%,64.9429073342117%,0.566889330204008,0.648354117514886,0.657149205643817,16617,17802,18002
1204,18,LOUISIANA,WEST BATON ROUGE,5058,4924,10169,49.7394040711968%,48.4216737142295%,5383,6927,12712,42.3458149779736%,54.4918187539333%,6200,7684,14097,43.9809888628786%,54.5080513584451%,0.493287918252855,0.562713241267262,0.553442811869778,9982,12310,13884
1205,18,LOUISIANA,WEST CARROLL,1319,3220,4675,28.2139037433155%,68.8770053475936%,715,3970,4759,15.0241647404917%,83.420886740912%,710,4317,5052,14.0538400633413%,85.4513064133017%,0.709407358448998,0.847385272145144,0.858762681519793,4539,4685,5027
1206,18,LOUISIANA,WEST FELICIANA,2187,2512,4860,45%,51.6872427983539%,2248,3390,5799,38.7653043628212%,58.4583548887739%,2298,3863,6268,36.6624122527122%,61.6305041480536%,0.534581825920409,0.601277048598794,0.627008602499594,4699,5638,6161
1207,18,LOUISIANA,WINN,2167,4028,6361,34.0669706021066%,63.3233768275428%,1644,4608,6372,25.8003766478343%,72.316384180791%,1543,4619,6225,24.7871485943775%,74.2008032128514%,0.650201775625504,0.737044145873321,0.749594287568971,6195,6252,6162
1209,19,MAINE,ANDROSCOGGIN,26251,19948,49245,53.3069347141842%,40.5076657528683%,23009,28227,55601,41.3823492383231%,50.7670725346666%,27617,29268,59361,46.523811930392%,49.3050993076262%,0.431784237754064,0.550921227262081,0.51451173420058,46199,51236,56885
1210,19,MAINE,AROOSTOOK,17196,16555,35143,48.9315084085024%,47.1075320832029%,13386,19419,35097,38.1400119668348%,55.3295153431917%,13956,21080,36210,38.5418392709196%,58.2159624413146%,0.490503985067109,0.591952446273434,0.60166685694714,33751,32805,35036
1211,19,MAINE,CUMBERLAND,74203,58543,142620,52.0284672556444%,41.0482400785304%,102981,57709,171818,59.9360951704711%,33.5872842193484%,128759,59584,195914,65.7222046408118%,30.4133446308074%,0.44101517183192,0.359132491131993,0.316358983344218,132746,160690,188343
1212,19,MAINE,FRANKLIN,7593,6459,15448,49.1519937856033%,41.8112377006732%,7016,7918,16488,42.5521591460456%,48.0228044638525%,8069,8754,17599,45.8491959770442%,49.7414625831013%,0.459649871904355,0.530199544663185,0.520359032277239,14052,14934,16823
1213,19,MAINE,HANCOCK,12983,12732,28574,45.4364107230349%,44.5579897809197%,16117,13705,32130,50.1618425147837%,42.6548397136632%,19369,14982,35676,54.2914003812087%,41.9946182307434%,0.495119580011666,0.45956005633425,0.436144508165701,25715,29822,34351
1214,19,MAINE,KENNEBEC,31198,23967,58907,52.9614477057056%,40.6861663299778%,29302,31675,66208,44.2574915418076%,47.8416505558241%,34902,34721,72615,48.0644494939062%,47.815189699098%,0.434460255596846,0.519458156354035,0.49870014219439,55165,60977,69623
1215,19,MAINE,KNOX,9453,8968,20501,46.1099458562997%,43.7442075996293%,12443,9148,23147,53.7564263187454%,39.5213202574848%,15110,9982,26032,58.0439459127228%,38.3451137062077%,0.486835676673362,0.423695058126071,0.397816036983899,18421,21591,25092
1216,19,MAINE,LINCOLN,8634,9457,19671,43.892023791368%,48.0758476945758%,10241,9727,21503,47.6259126633493%,45.2355485281124%,12684,10256,23857,53.1667854298529%,42.989478978916%,0.522746116853684,0.487129407051282,0.447079337401918,18091,19968,22940
1217,19,MAINE,MAINE UOCAVA,0,0,0,#DIV/0!,#DIV/0!,3017,648,3986,75.6899147014551%,16.2568991470146%,0,0,0,#DIV/0!,#DIV/0!,#DIV/0!,0.176807639836289,#DIV/0!,0,3665,0
1218,19,MAINE,OXFORD,13649,11835,27493,49.6453642745426%,43.0473211362892%,12172,16210,31201,39.0115701419826%,51.9534630300311%,14755,17698,33810,43.6409346347235%,52.3454599230997%,0.464409040966881,0.57113663589599,0.545342495300897,25484,28382,32453
1219,19,MAINE,PENOBSCOT,32868,35620,73206,44.8979591836735%,48.6572138895719%,32838,41622,80540,40.7722870623293%,51.6786689843556%,37713,44825,86133,43.7846121695517%,52.0416100681504%,0.520091110851536,0.558984689766317,0.543083185926482,68488,74460,82538
1220,19,MAINE,PISCATAQUIS,3745,4845,9256,40.4602420051858%,52.3444252376837%,3098,5406,9182,33.7399259420606%,58.8760618601612%,3517,6143,9996,35.1840736294518%,61.4545818327331%,0.564027939464494,0.635700846660395,0.63592132505176,8590,8504,9660
1221,19,MAINE,SAGADAHOC,8844,8052,18406,48.0495490600891%,43.7466043681408%,10664,9304,21616,49.3338267949667%,43.0421909696521%,13528,9755,24280,55.7166392092257%,40.1771004942339%,0.4765625,0.465945512820513,0.418975217970193,16896,19968,23283
1222,19,MAINE,SOMERSET,11538,10684,23951,48.1733539309423%,44.6077408041418%,9092,15001,26064,34.8833640270104%,57.554481276857%,10199,16644,27873,36.5909661679762%,59.7137014314928%,0.480784807848078,0.622628979371602,0.620049919904631,22222,24093,26843
1223,19,MAINE,WALDO,8477,8689,19138,44.2940746159473%,45.4018183718257%,10440,10378,22707,45.9770114942529%,45.703967939402%,12345,11196,24566,50.2523813400635%,45.5751852153383%,0.506174997087266,0.498510904025363,0.475595769083726,17166,20818,23541
1224,19,MAINE,WASHINGTON,6701,7958,15708,42.659791189203%,50.6620830150242%,6075,9093,16365,37.121906507791%,55.5637030247479%,6761,10194,17570,38.4803642572567%,58.0193511667615%,0.542874684494167,0.599485759493671,0.601238572692421,14659,15168,16955
1225,19,MAINE,YORK,46618,42304,94550,49.3051295610788%,44.7424643046007%,55844,50403,114274,48.8685090221748%,44.1071459824632%,71189,54817,131042,54.3253308099693%,41.831626501427%,0.475742785812285,0.474394571140832,0.435034839610812,88922,106247,126006
1227,20,MARYLAND,ALLEGANY,10894,14656,26371,41.3105305069963%,55.5762011300292%,7875,21270,30654,25.6899588960658%,69.3873556468976%,9158,20886,30641,29.8880584837309%,68.1635716849972%,0.573620352250489,0.729799279464745,0.695180402076954,25550,29145,30044
1228,20,MARYLAND,ANNE ARUNDEL,89624,104209,200657,44.6652745730276%,51.9338971478692%,128419,122403,270081,47.5483280941644%,45.3208481899875%,172823,127821,309617,55.818317469648%,41.2835858496142%,0.537622592644183,0.488007431565014,0.425157328933889,193833,250822,300644
1229,20,MARYLAND,BALTIMORE,160635,133033,304084,52.825863906026%,43.7487667881243%,218412,149477,390682,55.9053142965379%,38.2605290236049%,258409,146202,414932,62.2774334107757%,35.2351710641744%,0.453004753667407,0.406310055478691,0.361339657102748,293668,367889,404611
1230,20,MARYLAND,BALTIMORE CITY,158765,27150,192404,82.5164757489449%,14.1109332446311%,202673,25205,239402,84.6580229070768%,10.5283163883343%,207260,25374,237461,87.2817009951108%,10.6855441525135%,0.146034478121722,0.110607430291647,0.109072620511189,185915,227878,232634
1231,20,MARYLAND,CALVERT,12986,16004,29806,43.5684090451587%,53.6938871368181%,18225,26176,47408,38.4428788390145%,55.2143098211272%,22587,25346,49113,45.9898601185022%,51.6075173579297%,0.55205243187306,0.589536271705592,0.528779755074792,28990,44401,47933
1232,20,MARYLAND,CAROLINE,3396,5300,8952,37.9356568364611%,59.2046470062556%,4009,9368,14113,28.406433784454%,66.3785162616028%,5095,10283,15794,32.2590857287578%,65.1070026592377%,0.609475620975161,0.700306496224864,0.6686825334894,8696,13377,15378
1233,20,MARYLAND,CARROLL,20146,41742,64027,31.4648507660831%,65.1943711246818%,26567,58215,91848,28.9249629823186%,63.3818918212699%,36456,60218,100327,36.3371774298045%,60.0217289463455%,0.674476473629783,0.686643391285886,0.622897573287544,61888,84782,96674
1234,20,MARYLAND,CECIL,12327,15494,28876,42.6894306690677%,53.6570162072309%,13650,28868,45269,30.1530848925313%,63.7699087675893%,16809,29439,47462,35.4157009818381%,62.0264632758839%,0.556917436468854,0.678959499506092,0.636546445251687,27821,42518,46248
1235,20,MARYLAND,CHARLES,21873,21768,44592,49.0513993541442%,48.8159311087191%,49341,25614,78303,63.0129113827056%,32.7113903681851%,62171,25579,89498,69.4663567900959%,28.5805269391495%,0.498797002818451,0.341725035021013,0.291498575498575,43641,74955,87750
1236,20,MARYLAND,DORCHESTER,5232,5847,11392,45.9269662921348%,51.3254915730337%,6245,8413,15225,41.0180623973727%,55.2577996715928%,6857,8764,15977,42.9179445452838%,54.8538524128435%,0.527755212564311,0.573952790285169,0.561039626144293,11079,14658,15621
1237,20,MARYLAND,FREDERICK,30725,45350,78661,39.0600170351254%,57.6524580160435%,56522,59522,125677,44.9740207038679%,47.3610923239734%,77675,63682,145615,53.3427188133091%,43.7331318888851%,0.596122247781794,0.512926131467374,0.45050475038378,76075,116044,141357
1238,20,MARYLAND,GARRETT,2872,7514,10655,26.9544814641014%,70.5208822149226%,2567,10776,14011,18.3213189636714%,76.9109985011776%,3281,12002,15611,21.0172314393697%,76.8816859906476%,0.723473907182746,0.807614479502361,0.7853170189099,10386,13343,15283
1239,20,MARYLAND,HARFORD,35665,52862,91424,39.0105442772139%,57.8207035351768%,47077,77860,133672,35.2182955293554%,58.2470524866838%,63095,80930,148186,42.5782462580811%,54.6137961750773%,0.597128559648469,0.62319408982127,0.561916333969797,88527,124937,144025
1240,20,MARYLAND,HOWARD,58556,49809,112779,51.9210136638913%,44.1651371265927%,102597,47484,162193,63.2561207943623%,29.276232636427%,129433,48390,183062,70.7044607837782%,26.433667282123%,0.459641028007198,0.316389149859076,0.272124528323108,108365,150081,177823
1241,20,MARYLAND,KENT,3627,4155,8085,44.860853432282%,51.39146567718%,4575,4876,10021,45.6541263346971%,48.6578185809799%,5329,5195,10794,49.3700203816935%,48.1285899573837%,0.533924441017733,0.515924240821077,0.493633599391866,7782,9451,10524
1242,20,MARYLAND,MONTGOMERY,232453,124580,371688,62.5398183422656%,33.517358644885%,357837,92704,478873,74.724822656529%,19.3587861499813%,419569,101222,533743,78.6088061108061%,18.9645578490022%,0.348931331277501,0.205761517819688,0.194362037746428,357033,450541,520791
1243,20,MARYLAND,PRINCE GEORGE'S,216119,49987,271909,79.4821061458061%,18.3837239664741%,344049,32811,390385,88.1306914968557%,8.40477989676857%,379208,37090,424855,89.2558637652846%,8.73003730684587%,0.187846196628411,0.0870641617576819,0.0890948311065631,266106,376860,416298
1244,20,MARYLAND,QUEEN ANNE'S,6257,9970,16761,37.3307081916353%,59.4833243839866%,7973,16993,26523,30.0607020321985%,64.0689213135769%,10709,18741,30290,35.3549026081215%,61.8719049191152%,0.614408085289949,0.680645678122246,0.636366723259762,16227,24966,29450
1245,20,MARYLAND,SOMERSET,3785,3609,7604,49.7764334560758%,47.4618621778012%,4196,5341,9900,42.3838383838384%,53.949494949495%,4241,5739,10147,41.7956046122007%,56.558588745442%,0.488098458209359,0.560029359337318,0.575050100200401,7394,9537,9980
1246,20,MARYLAND,ST. MARY'S,11912,16856,29501,40.3782922612793%,57.1370462018237%,17534,28663,49842,35.1791661650817%,57.5077244091329%,23138,30826,55665,41.5665139674841%,55.3777059193389%,0.585928809788654,0.620451544472585,0.571232673634275,28768,46197,53964
1247,20,MARYLAND,TALBOT,5854,8874,15234,38.427202310621%,58.2512800315085%,8653,10724,20553,42.1009098428453%,52.1772977180947%,11062,10946,22555,49.0445577477278%,48.5302593659942%,0.602525801195003,0.553439644939877,0.497364594692839,14728,19377,22008
1248,20,MARYLAND,WASHINGTON,18221,27948,47470,38.3842426795871%,58.8750789972614%,21129,40998,65991,32.0180024548802%,62.1266536345865%,26044,40224,67779,38.4248808628041%,59.3458150754659%,0.605341246290801,0.65990632092327,0.606989798998008,46169,62127,66268
1249,20,MARYLAND,WICOMICO,14469,16338,31795,45.5071552130838%,51.3854379619437%,18050,22198,42547,42.4236726443698%,52.1728911556632%,22054,22944,46216,47.7194045352259%,49.6451445386879%,0.530334014996592,0.551530510832836,0.509889328414596,30807,40248,44998
1250,20,MARYLAND,WORCESTER,9389,10742,20753,45.241651809377%,51.7611911530863%,9753,17210,28273,34.4958087221024%,60.8707954585647%,12560,18571,31691,39.6327032911552%,58.6002335047805%,0.533604887983707,0.638282090271854,0.596543638174167,20131,26963,31131
1252,21,MASSACHUSETTS,BARNSTABLE,62363,49686,121086,51.5030639380275%,41.0336455081512%,72430,54099,133862,54.1079619309438%,40.4140084564701%,91994,55311,151512,60.7173029199007%,36.506019325202%,0.443430998937965,0.427562060871421,0.375486236040868,112049,126529,147305
1253,21,MASSACHUSETTS,BERKSHIRE,37934,15805,59411,63.8501287640336%,26.6028176600293%,43714,16839,64803,67.4567535453606%,25.9849081061062%,51705,18064,71771,72.0416324142063%,25.1689401011551%,0.294106700906232,0.278086965137978,0.258911550975362,53739,60553,69769
1254,21,MASSACHUSETTS,BRISTOL,136325,62848,211337,64.5059786028949%,29.7382852978892%,129540,105443,248959,52.0326640129499%,42.353560224776%,153377,119872,281364,54.5119489344763%,42.603886780114%,0.315544777655606,0.44872607805671,0.438691449922964,199173,234983,273249
1255,21,MASSACHUSETTS,DUKES,5474,2315,8856,61.8112014453478%,26.1404697380307%,8400,2477,11502,73.0307772561294%,21.5353851504086%,9914,2631,12873,77.0139050726326%,20.4381263108832%,0.297214019771473,0.227728233888021,0.209724990035871,7789,10877,12545
1256,21,MASSACHUSETTS,ESSEX,178400,110010,310333,57.4866353239907%,35.4490176681178%,222310,136316,379868,58.5229606073689%,35.8850969284067%,267198,144837,424599,62.92949347502%,34.111479301647%,0.381436149925453,0.380106294579869,0.351516254687102,288410,358626,412035
1257,21,MASSACHUSETTS,FRANKLIN,17945,10176,33366,53.7822933525145%,30.4981118503866%,24478,10364,38177,64.1171385912984%,27.1472352463525%,30030,11201,43003,69.8323372787945%,26.0470199753506%,0.361864798549127,0.297457092015384,0.271664524265722,28121,34842,41231
1258,21,MASSACHUSETTS,HAMPDEN,100103,59558,172093,58.1679673199956%,34.6080317037881%,112590,78685,203117,55.4311062097215%,38.7387564802552%,125948,87318,220793,57.0434751101711%,39.5474494209508%,0.373027852763042,0.411371062606195,0.409432352086127,159661,191275,213266
1259,21,MASSACHUSETTS,HAMPSHIRE,38543,19202,68626,56.1638446070003%,27.9806487337161%,55367,21790,82956,66.7426105405275%,26.2669366893293%,63362,22281,88332,71.7316487796042%,25.2241543268578%,0.332530955061044,0.282411187578574,0.260161367537335,57745,77157,85643
1260,21,MASSACHUSETTS,MIDDLESEX,404043,198914,657048,61.4936808269715%,30.2738917095859%,520360,219793,784034,66.3695707073928%,28.0336056854677%,617196,226956,869347,70.9953562846596%,26.1064914240229%,0.329897488543959,0.296956169872986,0.268856793563245,602957,740153,844152
1261,21,MASSACHUSETTS,NANTUCKET,2874,1624,4926,58.3434835566382%,32.9679252943565%,4146,1892,6406,64.7205744614424%,29.5348111145801%,5241,1914,7338,71.4227309893704%,26.0834014717907%,0.361049355269008,0.313348790990394,0.267505241090147,4498,6038,7155
1262,21,MASSACHUSETTS,NORFOLK,188450,107033,317177,59.414774715695%,33.7455111814539%,221819,119723,361562,61.350197199927%,33.1127164912242%,273312,125294,411042,66.4924752215102%,30.4820431975321%,0.362230652863278,0.350536683628953,0.314330441588937,295483,341542,398606
1263,21,MASSACHUSETTS,PLYMOUTH,115376,82751,211577,54.5314471799865%,39.1115291359647%,135513,115369,266863,50.779988233663%,43.2315457744236%,173630,121227,303870,57.1395662618883%,39.8943627209004%,0.417666446269312,0.459853636370884,0.411138280590252,198127,250882,294857
1264,21,MASSACHUSETTS,SUFFOLK,154888,44441,217000,71.3769585253456%,20.4797235023041%,245751,50421,308741,79.597785846389%,16.331164309243%,270522,58613,337240,80.2164630530186%,17.3802040090144%,0.222953007339624,0.170242291641344,0.178081942060249,199329,296172,329135
1265,21,MASSACHUSETTS,WORCESTER,173769,114139,310148,56.0277673884726%,36.8014625275675%,198778,157682,383705,51.8049022035157%,41.0945908966524%,248773,171683,434921,57.1995833726125%,39.4745252586102%,0.396442613612682,0.442355383493239,0.408325722548852,287908,356460,420456
1267,22,MICHIGAN,ALCONA,2696,3152,5997,44.9558112389528%,52.5596131399033%,1732,4201,6198,27.9444982252339%,67.7799290093579%,2142,4848,7064,30.3227633069083%,68.6296715741789%,0.538987688098495,0.708073487274566,0.693562231759657,5848,5933,6990
1268,22,MICHIGAN,ALGER,2071,2142,4366,47.4347228584517%,49.0609253321118%,1663,2585,4518,36.8083222664896%,57.2155821159805%,2053,3014,5128,40.0351014040562%,58.7753510140406%,0.508426299549015,0.608521657250471,0.594829287546872,4213,4248,5067
1269,22,MICHIGAN,ALLEGAN,15495,28197,44891,34.5169410349513%,62.81214497338%,18050,34183,55786,32.3557881905854%,61.2752303445309%,24449,41392,67094,36.4399201120816%,61.6925507496945%,0.645358418017028,0.654433021270078,0.62866602876627,43692,52233,65841
1270,22,MICHIGAN,ALPENA,7053,6769,14132,49.9080101896405%,47.8983866402491%,4877,9090,14698,33.1813852224793%,61.8451489998639%,6000,10686,16969,35.3585950851553%,62.9736578466616%,0.489726522934452,0.65081978950383,0.640417116145272,13822,13967,16686
1271,22,MICHIGAN,ANTRIM,4329,6780,11507,37.620578778135%,58.9206569913965%,4448,8469,13582,32.7492269179797%,62.3545869533206%,5960,9748,15949,37.3691140510377%,61.1198194244153%,0.610315960032406,0.655647596191066,0.620575502928444,11109,12917,15708
1272,22,MICHIGAN,ARENAC,3685,3421,7267,50.7086830879318%,47.0758222099904%,2384,4950,7696,30.977130977131%,64.3191268191268%,2774,5928,8831,31.4120711131242%,67.1271656664024%,0.481424148606811,0.674938641941642,0.681222707423581,7106,7334,8702
1273,22,MICHIGAN,BARAGA,1400,1836,3393,41.2614205717654%,54.1114058355438%,1156,2158,3490,33.1232091690544%,61.8338108882522%,1478,2512,4038,36.6022783556216%,62.2090143635463%,0.567367119901112,0.651176825588413,0.629573934837093,3236,3314,3990
1274,22,MICHIGAN,BARRY,9769,15716,26244,37.223746380125%,59.8841639993903%,9114,19202,30329,30.0504467671206%,63.3123413234858%,11797,23471,35905,32.8561481687787%,65.3697256649492%,0.616676476358642,0.678132504591044,0.665504139730067,25485,28316,35268
1275,22,MICHIGAN,BAY,28251,22150,51636,54.711828956542%,42.8964288480905%,21642,28328,52977,40.8516903561923%,53.472261547464%,26151,33125,60255,43.4005476723923%,54.974690897021%,0.439475407233983,0.56690014008405,0.55882650651191,50401,49970,59276
1276,22,MICHIGAN,BENZIE,3546,4172,8072,43.9296333002973%,51.6848364717542%,4108,5539,10228,40.1642549863121%,54.155260070395%,5480,6601,12262,44.6909150220193%,53.8329799380199%,0.540554547810314,0.574168135171556,0.546395165963083,7718,9647,12081
1277,22,MICHIGAN,BERRIEN,28152,35689,65241,43.1507794178507%,54.7033307276099%,29495,38647,72031,40.9476475406422%,53.6532881675945%,37438,43519,82391,45.4394290638541%,52.8200895728902%,0.559029463824188,0.567153884535235,0.537556974690268,63841,68142,80957
1278,22,MICHIGAN,BRANCH,6691,8743,15783,42.3937147563835%,55.3950453019071%,5061,11786,17663,28.6531166845949%,66.7270565589084%,6159,14064,20536,29.9912349045578%,68.4846123880016%,0.566476610081638,0.699590431530836,0.695445779557929,15434,16847,20223
1279,22,MICHIGAN,CALHOUN,27312,26291,55080,49.5860566448802%,47.7323892519971%,24157,31494,58902,41.0121897388883%,53.468473056942%,28877,36221,66281,43.5675382085364%,54.6476365776014%,0.490476279312725,0.565919749869724,0.556407262895942,53603,55651,65098
1280,22,MICHIGAN,CASS,8808,10545,19825,44.4287515762926%,53.1904161412358%,7270,14243,22595,32.1752600132773%,63.036069926975%,9130,16699,26216,34.8260604211169%,63.6977418370461%,0.544876763292513,0.662064798029099,0.646521351968717,19353,21513,25829
1281,22,MICHIGAN,CHARLEVOIX,4958,7018,12487,39.7052935052454%,56.2024505485705%,5137,8674,14589,35.2114606895606%,59.4557543354582%,6939,9841,17000,40.8176470588235%,57.8882352941177%,0.586005344021376,0.628050104988777,0.586471990464839,11976,13811,16780
1282,22,MICHIGAN,CHEBOYGAN,5484,6815,12617,43.4651660458112%,54.0144249821669%,4302,8683,13672,31.4657694558221%,63.509362200117%,5437,10186,15868,34.2639274010587%,64.1920846987648%,0.55411009025124,0.668694647670389,0.651987454394163,12299,12985,15623
1283,22,MICHIGAN,CHIPPEWA,6370,7526,14354,44.3778737634109%,52.4313780130974%,5379,9122,15456,34.8020186335404%,59.0191511387164%,6648,10681,17642,37.6828024033556%,60.5430223330688%,0.541594703511802,0.629060064823116,0.616365629869006,13896,14501,17329
1284,22,MICHIGAN,CLARE,6287,5937,12607,49.8691203299754%,47.0928849052114%,4249,8505,13389,31.735006348495%,63.5222944207932%,5199,10861,16281,31.9329279528284%,66.7096615686997%,0.48568390052356,0.666849615806806,0.676276463262765,12224,12754,16060
1285,22,MICHIGAN,CLINTON,13394,18054,32199,41.5975651417746%,56.0700642877108%,16492,21636,40655,40.5657360718239%,53.2185463042676%,21968,25098,47927,45.836376155403%,52.3671416946606%,0.574090562197914,0.567456986991188,0.533251179195173,31448,38128,47066
1286,22,MICHIGAN,CRAWFORD,2790,3345,6364,43.8403519798869%,52.561282212445%,2110,4354,6844,30.8299240210403%,63.6177673874927%,2672,5087,7861,33.9905864393843%,64.7118687189925%,0.545232273838631,0.673576732673267,0.655625724964557,6135,6464,7759
1287,22,MICHIGAN,DELTA,7970,8871,17316,46.026796026796%,51.2300762300762%,6436,11121,18492,34.8042396712092%,60.1395197923426%,7606,13207,21151,35.9604746820481%,62.4414921280318%,0.526750192981414,0.633422566497693,0.634555325998174,16841,17557,20813
1288,22,MICHIGAN,DICKINSON,5533,6932,12832,43.1187655860349%,54.0211970074813%,3923,8580,13165,29.7987086973035%,65.1728066843904%,4744,9617,14589,32.5176502844609%,65.9195284118171%,0.556117127958283,0.686235303527153,0.669660887124852,12465,12503,14361
1289,22,MICHIGAN,EATON,23211,24803,49272,47.1078908913785%,50.3389348920279%,24938,27609,56221,44.3570907667953%,49.1079845609292%,31299,31798,64327,48.6560853140983%,49.4318093491069%,0.516578497938101,0.525415342455326,0.503954229202656,48014,52547,63097
1290,22,MICHIGAN,EMMET,5451,8602,14711,37.0539052409761%,58.4732513085446%,6972,10616,18802,37.0811615785555%,56.462078502287%,9662,12135,22177,43.5676601884836%,54.7188528655815%,0.612111292962357,0.603593359108483,0.556727990090379,14053,17588,21797
1291,22,MICHIGAN,GENESEE,119833,66641,190865,62.7841668194797%,34.9152542372881%,102751,84175,196296,52.344928067816%,42.8816685006317%,119390,98714,221360,53.9347668955548%,44.5943259848211%,0.357374218389695,0.450311888126852,0.452600594211936,186474,186926,218104
1292,22,MICHIGAN,GLADWIN,5573,5743,11629,47.9232952102502%,49.3851577951673%,3794,8124,12472,30.4201411161001%,65.1379089159718%,4524,9893,14603,30.9799356296651%,67.7463534890091%,0.50751148815836,0.681657996308105,0.686203787195672,11316,11918,14417
1293,22,MICHIGAN,GOGEBIC,4066,3929,8339,48.7588439860895%,47.1159611464204%,2925,4018,7329,39.9099467867376%,54.8233046800382%,3570,4600,8266,43.1889668521655%,55.6496491652553%,0.491432145090682,0.578712372173412,0.563035495716034,7995,6943,8170
1294,22,MICHIGAN,GRAND TRAVERSE,14371,22358,38229,37.5918805095608%,58.4843966622198%,20965,27413,51589,40.6385082091143%,53.1372967105391%,28683,30502,60236,47.6177036987848%,50.6374925293844%,0.608728797408043,0.56664186200339,0.51536706935879,36729,48378,59185
1295,22,MICHIGAN,GRATIOT,6538,8312,15179,43.0726661835431%,54.7598656037947%,5666,9880,16465,34.4123899180079%,60.0060734892196%,6693,12102,19127,34.9924190934281%,63.271814712187%,0.55973063973064,0.635533256143059,0.6438946528332,14850,15546,18795
1296,22,MICHIGAN,HILLSDALE,6495,10483,17473,37.1716362387684%,59.9954215074687%,4799,14095,19940,24.0672016048144%,70.6870611835507%,5883,17037,23302,25.2467599347695%,73.1138958029354%,0.617446106726352,0.746004022440987,0.743324607329843,16978,18894,22920
1297,22,MICHIGAN,HOUGHTON,5688,7895,14216,40.0112549240293%,55.5360157568936%,6018,8475,15624,38.5176651305684%,54.2434715821813%,7750,10378,18501,41.889627587698%,56.0942651748554%,0.581241257454171,0.584765058993997,0.572484554280671,13583,14493,18128
1298,22,MICHIGAN,HURON,6899,8911,16095,42.8642435538987%,55.3650201926064%,4579,10692,15917,28.7679839165672%,67.1734623358673%,5490,12731,18437,29.7770787004393%,69.0513641047893%,0.563630613535737,0.700150612271626,0.698699303002031,15810,15271,18221
1299,22,MICHIGAN,INGHAM,69231,47314,120595,57.4078527302127%,39.2337990795638%,79110,43868,131138,60.3257636993091%,33.4517836172582%,94212,47639,144550,65.1760636457973%,32.9567623659633%,0.405971942168261,0.35671420904552,0.335838309211779,116545,122978,141851
1300,22,MICHIGAN,IONIA,9481,13915,23970,39.5536086775136%,58.0517313308302%,8352,16635,26854,31.1015118790497%,61.9460787964549%,10901,20657,32209,33.8445776025335%,64.1342481914993%,0.594759787997948,0.665746188017769,0.654572533113632,23396,24987,31558
1301,22,MICHIGAN,IOSCO,6505,6345,13222,49.1983058538799%,47.9882014823779%,4345,8345,13361,32.5200209565152%,62.4578998577951%,5373,9759,15363,34.9736379613357%,63.5227494629955%,0.493774319066148,0.657604412923562,0.6449246629659,12850,12690,15132
1302,22,MICHIGAN,IRON,3014,2967,6188,48.7071751777634%,47.9476405946994%,2004,3675,5910,33.9086294416244%,62.1827411167513%,2493,4216,6789,36.7211665930181%,62.1004566210046%,0.496070891155325,0.647120972002113,0.628409599046057,5981,5679,6709
1303,22,MICHIGAN,ISABELLA,10228,10053,21069,48.5452560634107%,47.7146518581803%,11404,12338,25392,44.9117832388154%,48.5901071203529%,14072,14815,29421,47.8297814486251%,50.3551884708202%,0.495685617080026,0.519669783506023,0.512860456260602,20281,23742,28887
1304,22,MICHIGAN,JACKSON,28160,32066,61946,45.4589481161011%,51.7644399961257%,25795,39793,69677,37.0208246623707%,57.1106677956858%,31995,47372,80861,39.5679004711789%,58.5844844857224%,0.532427855079202,0.606711593584192,0.596872755679313,60226,65588,79367
1305,22,MICHIGAN,KALAMAZOO,48807,48254,100656,48.488912732475%,47.9395167699889%,67148,51034,126299,53.1658999675374%,40.407287468626%,83686,56823,143414,58.3527410155215%,39.62165478963%,0.49715127600169,0.431825489499247,0.404408258545716,97061,118182,140509
1306,22,MICHIGAN,KALKASKA,2774,3842,6849,40.5022631041028%,56.0957804058987%,2280,6116,8833,25.8122948035775%,69.2403486924035%,3002,7436,10631,28.2381713855705%,69.9463832188882%,0.580713422007255,0.728442115292997,0.712397010921633,6616,8396,10438
1307,22,MICHIGAN,KENT,95442,148602,250318,38.1283008013806%,59.3652873544851%,138683,148180,308184,45.0000648962957%,48.0816654985333%,187915,165741,361048,52.0470962309721%,45.9055305665729%,0.608914785858288,0.516553197867972,0.46865032687131,244044,286863,353656
1308,22,MICHIGAN,KEWEENAW,540,740,1343,40.2084884586746%,55.1005212211467%,527,814,1434,36.7503486750349%,56.7642956764296%,672,862,1557,43.1599229287091%,55.3628773281953%,0.578125,0.607009694258016,0.561929595827901,1280,1341,1534
1309,22,MICHIGAN,LAKE,2584,1961,4693,55.0607287449393%,41.7856381845302%,1939,3159,5328,36.3926426426426%,59.2905405405405%,2288,3946,6323,36.1853550529812%,62.407085244346%,0.431463146314631,0.619654766575128,0.632980429900545,4545,5098,6234
1310,22,MICHIGAN,LAPEER,15749,20351,37234,42.2973626255573%,54.657033893753%,12734,30037,45183,28.1831662350884%,66.4785428147755%,16367,35482,52650,31.0864197530864%,67.3922127255461%,0.563739612188366,0.702274905894181,0.684333352620108,36100,42771,51849
1311,22,MICHIGAN,LEELANAU,4635,6840,12009,38.5960529602798%,56.9572820384712%,6774,7239,14757,45.9036389510063%,49.0546859117707%,8795,7916,16900,52.0414201183432%,46.8402366863905%,0.596078431372549,0.516591736244915,0.473699958111424,11475,14013,16711
1312,22,MICHIGAN,LENAWEE,18365,20681,40093,45.8060010475644%,51.5825705235328%,16750,26430,45939,36.461394457868%,57.5328152550121%,20918,31541,53375,39.1906323185012%,59.0932084309133%,0.529657327255033,0.612088930060213,0.601250500390781,39046,43180,52459
1313,22,MICHIGAN,LIVINGSTON,28780,44637,75475,38.1318317323617%,59.1414375621067%,34384,65680,105866,32.4787939470652%,62.0406929514669%,48220,76982,127197,37.9096991281241%,60.5218676541113%,0.607992699238596,0.656379916853214,0.614862382390058,73417,100064,125202
1314,22,MICHIGAN,LUCE,956,1480,2536,37.6971608832808%,58.3596214511041%,681,1756,2579,26.4055835595192%,68.0884063590539%,842,2109,3001,28.0573142285905%,70.276574475175%,0.607553366174056,0.72055806319245,0.714672992206032,2436,2437,2951
1315,22,MICHIGAN,MACKINAC,2533,3272,5970,42.428810720268%,54.8073701842546%,2085,3744,6097,34.1971461374446%,61.407249466951%,2632,4304,7015,37.51960085531%,61.3542409123307%,0.56365202411714,0.642305712815234,0.620530565167243,5805,5829,6936
1316,22,MICHIGAN,MACOMB,172625,164265,345559,49.9552898347316%,47.5360213451249%,176317,224665,419312,42.049118556111%,53.5794348838097%,223952,263863,494256,45.3109319866628%,53.3858971868829%,0.48759238920716,0.560286995426229,0.540907926160532,336890,400982,487815
1317,22,MICHIGAN,MANISTEE,5639,5401,11428,49.3437171858593%,47.2611130556528%,4979,6915,12599,39.5190094451941%,54.8853083578062%,6107,8321,14655,41.6717843739338%,56.7792562265438%,0.489221014492754,0.581385572557592,0.576725810923205,11040,11894,14428
1318,22,MICHIGAN,MARQUETTE,15503,12577,29179,53.130676171219%,43.1029164810309%,16042,14646,32976,48.6475012130034%,44.4141193595342%,20465,16286,37462,54.6286904062784%,43.4733863648497%,0.44789886039886,0.477254953076121,0.443144404233898,28080,30688,36751
1319,22,MICHIGAN,MASON,5579,7066,13016,42.8626306084819%,54.2870313460357%,5281,8505,14685,35.9618658495063%,57.9162410623085%,6802,10207,17254,39.4227425524516%,59.1572968586994%,0.558797943851325,0.616930219062817,0.600094067846434,12645,13786,17009
1320,22,MICHIGAN,MECOSTA,6300,8072,14754,42.7002846685645%,54.7105869594686%,5827,10305,17168,33.9410531220876%,60.0244641192917%,7375,13267,21049,35.0372939332035%,63.0291225236353%,0.561647648204843,0.638792462186958,0.642718728805348,14372,16132,20642
1321,22,MICHIGAN,MENOMINEE,4597,5529,10434,44.057887674909%,52.99022426682%,3539,6702,10768,32.8658989598811%,62.239970282318%,4316,8117,12607,34.2349488379472%,64.3848655508844%,0.546020146158404,0.654428278488429,0.652859325987292,10126,10241,12433
1322,22,MICHIGAN,MIDLAND,15959,21887,38888,41.0383665912364%,56.2821435918535%,15635,23846,42506,36.783042394015%,56.1003152496118%,20493,27675,49088,41.7474739243807%,56.3783409387223%,0.578317391534112,0.603986727793116,0.574551569506726,37846,39481,48168
1323,22,MICHIGAN,MISSAUKEE,2062,4274,6496,31.7426108374384%,65.7943349753695%,1565,5386,7317,21.3885472188055%,73.6094027606943%,1967,6648,8755,22.4671616219303%,75.9337521416334%,0.674558080808081,0.774852539202992,0.771677307022635,6336,6951,8615
1324,22,MICHIGAN,MONROE,31555,28940,61795,51.0640019419047%,46.8322679828465%,26863,43261,74218,36.1947236519443%,58.2890942897949%,32975,52710,87148,37.8379308762106%,60.4833157387433%,0.478386643524258,0.616921453425361,0.615160179728074,60495,70124,85685
1325,22,MICHIGAN,MONTCALM,9627,12696,22904,42.0319594830597%,55.4313657003144%,7874,16907,26609,29.5914916005863%,63.5386523356759%,9703,21815,32100,30.2274143302181%,67.9595015576324%,0.56874076065045,0.682256567531577,0.692144171584491,22323,24781,31518
1326,22,MICHIGAN,MONTMORENCY,2139,2750,5009,42.7031343581553%,54.9011778798163%,1287,3498,5009,25.693751247754%,69.8342982631264%,1628,4171,5859,27.7863116572794%,71.189622802526%,0.562487216199632,0.731034482758621,0.719261941714089,4889,4785,5799
1327,22,MICHIGAN,MUSKEGON,37865,30028,69270,54.662913238054%,43.3492132236177%,37304,36127,78088,47.7717446982891%,46.2644708533962%,45643,45133,92444,49.3736748734369%,48.8219895287958%,0.442284182463582,0.491985673625581,0.49719088745924,67893,73431,90776
1328,22,MICHIGAN,NEWAYGO,7677,11399,19557,39.2544868844915%,58.2860356905456%,6212,15173,22640,27.4381625441696%,67.0185512367491%,7873,18857,27161,28.9864143440963%,69.4267515923567%,0.597557139861606,0.709516015898995,0.70546202768425,19076,21385,26730
1329,22,MICHIGAN,OAKLAND,281201,274319,570265,49.3105836760103%,48.1037763145204%,343070,289203,664614,51.6194362441959%,43.5144309328422%,434148,325971,770351,56.357167057614%,42.3146072374801%,0.493805803571429,0.457402103205419,0.428842062887522,555520,632273,760119
1330,22,MICHIGAN,OCEANA,4597,5913,10772,42.6754548830301%,54.8923134051244%,3973,7228,11930,33.3025984911987%,60.5867560771165%,4944,8892,14062,35.1585834162992%,63.2342483288295%,0.562607040913416,0.645299526827962,0.642671292281006,10510,11201,13836
1331,22,MICHIGAN,OGEMAW,4896,4706,9855,49.6803652968037%,47.7524099441908%,3030,6827,10387,29.1710792336575%,65.7263887551747%,3475,8253,11907,29.1845133114974%,69.3121693121693%,0.490106227869194,0.692604240641169,0.703700545702592,9602,9857,11728
1332,22,MICHIGAN,ONTONAGON,1514,2472,4151,36.47313900265%,59.5519152011564%,1176,2066,3426,34.3257443082312%,60.3035610040864%,1391,2358,3804,36.5667718191377%,61.98738170347%,0.620170597089814,0.637260950030845,0.628967724726594,3986,3242,3749
1333,22,MICHIGAN,OSCEOLA,4006,5680,9930,40.3423967774421%,57.2004028197382%,2705,7336,10609,25.4972193420681%,69.1488358940522%,3214,8928,12329,26.0686187038689%,72.414632168059%,0.586413380136279,0.730604521462006,0.73529896227969,9686,10041,12142
1334,22,MICHIGAN,OSCODA,1677,2207,3992,42.0090180360721%,55.2855711422846%,1044,2843,4073,25.6322121286521%,69.801129388657%,1342,3466,4874,27.5338530980714%,71.1120229790726%,0.568228630278064,0.731412400308721,0.720881863560732,3884,3887,4808
1335,22,MICHIGAN,OTSEGO,4034,6108,10505,38.4007615421228%,58.1437410756782%,3556,8266,12538,28.3617801882278%,65.9275801563248%,4743,9779,14757,32.1406789997967%,66.2668564071288%,0.602248077302307,0.699204872272035,0.673392094752789,10142,11822,14522
1336,22,MICHIGAN,OTTAWA,29600,78703,110599,26.7633522907079%,71.160679572148%,44973,88467,142734,31.5082601202236%,61.9803270419101%,64705,100913,168713,38.3521127595384%,59.8134109404729%,0.726692704726554,0.662972122302158,0.609311789781304,108303,133440,165618
1337,22,MICHIGAN,PRESQUE ISLE,3242,3660,7080,45.7909604519774%,51.6949152542373%,2400,4488,7218,33.2502078137988%,62.1778886118038%,2911,5342,8344,34.8873441994247%,64.0220517737296%,0.530281077948421,0.651567944250871,0.647279777050769,6902,6888,8253
1338,22,MICHIGAN,ROSCOMMON,6433,6190,12928,49.7602103960396%,47.8805693069307%,4287,8141,13041,32.8732459167242%,62.4261943102523%,5166,9670,15018,34.398721534159%,64.3893993874018%,0.490374712825794,0.655053105889926,0.651792936101375,12623,12428,14836
1339,22,MICHIGAN,SAGINAW,50825,41152,93756,54.2098639020436%,43.8926575365843%,44396,45469,94320,47.069550466497%,48.2071670907549%,51088,50785,103349,49.4325053943434%,49.1393240379684%,0.447416201876556,0.505970066210427,0.498512854240083,91977,89865,101873
1340,22,MICHIGAN,SANILAC,7153,10966,18566,38.5274157061295%,59.0649574491005%,4873,13446,19249,25.3156008104317%,69.852979375552%,5966,16194,22446,26.5793459859218%,72.1464848970863%,0.605221038688669,0.733992030132649,0.730776173285198,18119,18319,22160
1341,22,MICHIGAN,SCHOOLCRAFT,2036,2088,4198,48.4992853739876%,49.7379704621248%,1369,2556,4154,32.956186807896%,61.5310544053924%,1589,3090,4745,33.4878819810327%,65.1211801896733%,0.506304558680892,0.651210191082803,0.660397520837786,4124,3925,4679
1342,22,MICHIGAN,SHIAWASSEE,15520,15816,32218,48.1718294121299%,49.0905704885468%,12546,19230,34111,36.7799243645745%,56.3747764650699%,15347,23149,39224,39.1265551703039%,59.0174383030798%,0.504723002297677,0.605173716012085,0.601335203657523,31336,31776,38496
1343,22,MICHIGAN,ST. CLAIR,33002,33571,68516,48.1668515383268%,48.9973144958842%,24553,49051,78003,31.4769944745715%,62.8834788405574%,31363,59185,92064,34.0665189433438%,64.286800486618%,0.504273504273504,0.666417586000761,0.653631223218624,66573,73604,90548
1344,22,MICHIGAN,ST. JOSEPH,8574,12906,22024,38.9302579004722%,58.5997094079186%,7526,14884,23757,31.6790840594351%,62.6510081239214%,9262,18127,27936,33.1543528064147%,64.8876002290951%,0.600837988826816,0.664167782240071,0.661835043265545,21480,22410,27389
1345,22,MICHIGAN,TUSCOLA,10845,13213,24652,43.9923738439072%,53.5980853480448%,7429,17102,25796,28.7990386106373%,66.2971003256319%,8712,20297,29445,29.587366276108%,68.931906945152%,0.549214398536869,0.697158697158697,0.699679409838326,24058,24531,29009
1346,22,MICHIGAN,VAN BUREN,13796,14792,29482,46.7946543653755%,50.1729869072654%,13258,17890,33274,39.8449239646571%,53.7657029512532%,16803,21591,39066,43.0118261403778%,55.2680079864844%,0.517419896460053,0.574354693720303,0.56235349273324,28588,31148,38394
1347,22,MICHIGAN,WASHTENAW,86647,52459,144940,59.7812888091624%,36.1935973506278%,128483,50631,188578,68.1325499262904%,26.8488370859803%,157136,56241,216418,72.607638920977%,25.9872099363269%,0.377115293373399,0.282674721127327,0.263575736841365,139106,179114,213377
1348,22,MICHIGAN,WAYNE,530414,223021,768627,69.0079843669296%,29.015504269301%,519444,228993,777838,66.7804864251939%,29.4396776706718%,597170,264553,872469,68.4459849003231%,30.3223381002649%,0.296005627559113,0.305961624024467,0.307004687121035,753435,748437,861723
1349,22,MICHIGAN,WEXFORD,5326,7215,12982,41.0260360499153%,55.5769527037436%,4436,10000,15298,28.9972545430775%,65.3680219636554%,5838,12102,18265,31.9627703257596%,66.2578702436354%,0.575312973447094,0.692712662787476,0.674581939799331,12541,14436,17940
1351,23,MINNESOTA,AITKIN,3830,3755,8260,46.3680387409201%,45.4600484261501%,3134,5516,9231,33.9508178962193%,59.755172787347%,3607,6258,10025,35.9800498753117%,62.4239401496259%,0.495056031641397,0.637687861271676,0.634363912823112,7585,8650,9865
1352,23,MINNESOTA,ANOKA,68008,69256,145619,46.7026967634718%,47.5597277827756%,75500,93339,185758,40.6442791158389%,50.2476340184541%,100893,104902,211132,47.7866926851448%,49.6855048026827%,0.504545984380464,0.552828434188783,0.509740275516898,137264,168839,205795
1353,23,MINNESOTA,BECKER,5253,8152,14333,36.6496895276634%,56.8757412963092%,5208,10880,17222,30.2403901985832%,63.1750087097898%,6589,12438,19401,33.9621668986135%,64.1100974176589%,0.608131294293174,0.676280457483839,0.653702633100331,13405,16088,19027
1354,23,MINNESOTA,BELTRAMI,7301,8346,17217,42.4057617471104%,48.4753441366092%,8688,10783,21564,40.2893711741792%,50.0046373585606%,11426,12188,24189,47.2363470999215%,50.3865393360618%,0.533392982680386,0.553797955934467,0.516134496485136,15647,19471,23614
1355,23,MINNESOTA,BENTON,6009,7663,14908,40.3072176012879%,51.4019318486719%,5640,12872,20058,28.118456476219%,64.1738957024629%,7280,14382,22260,32.7044025157233%,64.6091644204852%,0.560488589818607,0.69533275713051,0.663927615178654,13672,18512,21662
1356,23,MINNESOTA,BIG STONE,1430,1370,2980,47.9865771812081%,45.9731543624161%,921,1608,2755,33.4301270417423%,58.3666061705989%,1053,1863,2974,35.4068594485541%,62.6429051782112%,0.489285714285714,0.63582443653618,0.638888888888889,2800,2529,2916
1357,23,MINNESOTA,BLUE EARTH,12329,12942,27402,44.9930661995475%,47.2301291876505%,14428,15667,33593,42.9494239871402%,46.6376923763879%,18330,16731,36051,50.8446367645835%,46.4092535574603%,0.512128526769815,0.520584814753281,0.477196885428254,25271,30095,35061
1358,23,MINNESOTA,BROWN,4650,7370,12834,36.231884057971%,57.4255882811283%,3763,8708,13779,27.30967414181%,63.1976195660062%,4753,9552,14635,32.476938845234%,65.2681926887598%,0.613144758735441,0.698259963114425,0.667738552953513,12020,12471,14305
1359,23,MINNESOTA,CARLTON,8620,5578,15081,57.1580133943372%,36.9869372057556%,8460,8160,18211,46.4554390203723%,44.8080830267421%,10098,9791,20369,49.5753350679955%,48.0681427659679%,0.39287223552613,0.490974729241877,0.492282166021419,14198,16620,19889
1360,23,MINNESOTA,CARVER,12462,20790,35021,35.5843636675138%,59.3643813711773%,21508,29056,55696,38.6167767882792%,52.1689169778799%,30774,34009,66361,46.3736230617381%,51.2484742544567%,0.625225550342837,0.574638082430187,0.524967969992128,33252,50564,64783
1361,23,MINNESOTA,CASS,5534,7134,13593,40.7121312440227%,52.4828956080335%,4949,9982,15999,30.9331833239577%,62.3913994624664%,6342,11620,18289,34.6765815517524%,63.5354584723058%,0.563151247237133,0.6685419596812,0.646921278254092,12668,14931,17962
1362,23,MINNESOTA,CHIPPEWA,2952,2977,6352,46.4735516372796%,46.8671284634761%,1978,3764,6222,31.7904210864674%,60.4950176792028%,2226,4250,6611,33.6711541370443%,64.286794736046%,0.502108281329061,0.655520724486242,0.656269302038295,5929,5742,6476
1363,23,MINNESOTA,CHISAGO,9593,10937,21987,43.6303270114158%,49.7430299722563%,9278,18441,30228,30.6933968506021%,61.0063517268757%,11806,21916,34570,34.1509979751229%,63.3960080995082%,0.532732586458841,0.665283740394675,0.649902141035526,20530,27719,33722
1364,23,MINNESOTA,CLAY,10128,11712,23358,43.3598767017724%,50.1412792191112%,12971,13543,29398,44.1220491189877%,46.067759711545%,16357,15043,32239,50.7366853810602%,46.6608765780576%,0.536263736263736,0.51078675416761,0.479076433121019,21840,26514,31400
1365,23,MINNESOTA,CLEARWATER,1466,2137,3824,38.336820083682%,55.8838912133891%,1100,2925,4245,25.9128386336867%,68.904593639576%,1260,3372,4708,26.7629566694987%,71.6227697536109%,0.593116847071885,0.726708074534162,0.727979274611399,3603,4025,4632
1366,23,MINNESOTA,COOK,1171,1295,2820,41.5248226950355%,45.9219858156028%,1912,1156,3395,56.3181148748159%,34.0500736377025%,2496,1203,3806,65.580662112454%,31.6079873883342%,0.525141930251419,0.376792698826597,0.32522303325223,2466,3068,3699
1367,23,MINNESOTA,COTTONWOOD,2503,3369,6181,40.4950655233781%,54.5057434072157%,1678,3679,5721,29.3305366194721%,64.3069393462681%,1834,4165,6107,30.0311118388734%,68.200425740953%,0.573739782016349,0.686764980399477,0.694282380396733,5872,5357,5999
1368,23,MINNESOTA,CROW WING,11255,15035,28128,40.0135096700796%,53.4520762229807%,10982,22287,35842,30.6400312482562%,62.1812398861671%,13726,25676,40173,34.1672267443308%,63.9135737933438%,0.571890452643591,0.669902912621359,0.651642048626973,26290,33269,39402
1369,23,MINNESOTA,DAKOTA,85446,87250,182249,46.8842078694533%,47.8740624091216%,110483,99583,231440,47.7372105081231%,43.027566539924%,146155,109638,262259,55.7292600063296%,41.8052383330982%,0.50522305091027,0.47405577294755,0.428620016966844,172696,210066,255793
1370,23,MINNESOTA,DODGE,3370,4213,8050,41.8633540372671%,52.3354037267081%,3102,6527,10654,29.1158250422377%,61.263375258119%,4079,7783,12187,33.4700910806597%,63.8631328464758%,0.555584860873005,0.677848166995534,0.656128814702411,7583,9629,11862
1371,23,MINNESOTA,DOUGLAS,6352,9811,17205,36.9195001453066%,57.0241208950886%,6227,13966,21785,28.5838879963277%,64.1083314207023%,7868,15799,24165,32.5594868611628%,65.379681357335%,0.607003650312442,0.691625810924578,0.667553978112984,16163,20193,23667
1372,23,MINNESOTA,FARIBAULT,3624,4336,8424,43.019943019943%,51.4719848053181%,2153,4659,7412,29.0474905558554%,62.8575283324339%,2531,5191,7914,31.9812989638615%,65.5926206722264%,0.544723618090452,0.683940105695831,0.672235172235172,7960,6812,7722
1373,23,MINNESOTA,FILLMORE,5020,4646,10223,49.1049594052626%,45.4465421109263%,3872,6271,11055,35.0248756218906%,56.7254635911352%,4551,7301,12141,37.4845564615765%,60.1350794827444%,0.480653838195738,0.618258897762003,0.616014174822815,9666,10143,11852
1374,23,MINNESOTA,FREEBORN,8514,6843,16139,52.7541979056943%,42.4003965549291%,6041,8808,16051,37.6362843436546%,54.8750856644446%,6889,9578,16818,40.9620644547509%,56.9508859555238%,0.445594842742723,0.593171257323726,0.581648144774397,15357,14849,16467
1375,23,MINNESOTA,GOODHUE,9981,10852,22257,44.8443186413263%,48.7576942085636%,9446,14041,25717,36.7305673290042%,54.5981257533927%,11806,16052,28636,41.2278251152396%,56.0553149881268%,0.520904334469351,0.597820070677396,0.576207911551439,20833,23487,27858
1376,23,MINNESOTA,GRANT,1507,1804,3624,41.583885209713%,49.7792494481236%,1105,2063,3473,31.8168730204434%,59.4010941549093%,1300,2269,3654,35.5774493705528%,62.096332785988%,0.54485049833887,0.651199494949495,0.635752311571869,3311,3168,3569
1377,23,MINNESOTA,HENNEPIN,307599,225657,573846,53.6030572662352%,39.3236164406478%,429288,191770,679977,63.1327236068279%,28.2024244937696%,532623,205973,755969,70.4556668328992%,27.2462230594112%,0.423168234393987,0.308779534278602,0.278870993073345,533256,621058,738596
1378,23,MINNESOTA,HOUSTON,4502,5077,10167,44.2805153929379%,49.9360676699125%,4145,5616,10604,39.0890230101848%,52.9611467370803%,4853,6334,11440,42.4213286713287%,55.3671328671329%,0.530013571354004,0.575350886179695,0.566192902476088,9579,9761,11187
1379,23,MINNESOTA,HUBBARD,3632,5307,9613,37.7821699781546%,55.20649120982%,3423,7261,11505,29.7522816166884%,63.1116905693177%,4462,8202,12965,34.4157346702661%,63.262630158118%,0.593690569414923,0.679614376637963,0.647662665824384,8939,10684,12664
1380,23,MINNESOTA,ISANTI,6247,7668,14929,41.8447317301896%,51.3631187621408%,5657,13635,21016,26.9175866006852%,64.8791397030834%,7138,16491,24235,29.4532700639571%,68.0462141530844%,0.551060007186489,0.706769645448891,0.697913580769394,13915,19292,23629
1381,23,MINNESOTA,ITASCA,10583,9545,21714,48.7381412913328%,43.957815234411%,9015,12920,23880,37.751256281407%,54.1038525963149%,10786,15239,26561,40.6084108279056%,57.3735928617145%,0.474215023847377,0.589012992933668,0.585552353506244,20128,21935,26025
1382,23,MINNESOTA,JACKSON,2364,2773,5438,43.4718646561236%,50.993012136815%,1492,3609,5484,27.2064186725018%,65.8096280087527%,1745,3948,5819,29.9879704416566%,67.8467090565389%,0.539809227175394,0.707508331699667,0.693483225013174,5137,5101,5693
1383,23,MINNESOTA,KANABEC,2831,3480,6811,41.565115254735%,51.093818822493%,2327,5230,8177,28.4578696343402%,63.9598874892993%,2774,6278,9242,30.0151482363125%,67.9290196927072%,0.551418158770401,0.692073574169644,0.693548387096774,6311,7557,9052
1384,23,MINNESOTA,KANDIYOHI,8220,10026,19285,42.6238008815141%,51.9885921700804%,7266,12785,21772,33.3731398126033%,58.7222120154327%,8440,14437,23367,36.1193135618607%,61.783712072581%,0.54949029924367,0.637624058650441,0.631070507496612,18246,20051,22877
1385,23,MINNESOTA,KITTSON,1107,1353,2637,41.9795221843003%,51.3083048919226%,823,1349,2385,34.5073375262054%,56.5618448637317%,1006,1546,2639,38.1205001894657%,58.582796513831%,0.55,0.621086556169429,0.605799373040752,2460,2172,2552
1386,23,MINNESOTA,KOOCHICHING,2903,3523,6879,42.2009012937927%,51.213839220817%,2306,3569,6363,36.2407669338362%,56.0898947037561%,2659,4131,6922,38.4137532505056%,59.6792834440913%,0.548241518829754,0.607489361702128,0.60839469808542,6426,5875,6790
1387,23,MINNESOTA,LAC QUI PARLE,2244,1941,4453,50.3929934875365%,43.5885919604761%,1305,2293,3860,33.8082901554404%,59.4041450777202%,1446,2528,4040,35.7920792079208%,62.5742574257426%,0.463799283154122,0.637298499166203,0.63613487669854,4185,3598,3974
1388,23,MINNESOTA,LAKE,3579,2465,6563,54.5329879628219%,37.5590431205242%,3077,2932,6521,47.186014414967%,44.9624290752952%,3647,3393,7202,50.6387114690364%,47.1119133574007%,0.407842488418266,0.487934764519887,0.481960227272727,6044,6009,7040
1389,23,MINNESOTA,LAKE OF THE WOODS,848,1216,2187,38.774577046182%,55.6012802926383%,553,1540,2242,24.6654772524532%,68.6886708296164%,671,1704,2408,27.8654485049834%,70.7641196013289%,0.589147286821705,0.735785953177258,0.717473684210526,2064,2093,2375
1390,23,MINNESOTA,LE SUEUR,5361,6138,12331,43.4757927175412%,49.7769848349688%,4623,9182,14971,30.8797007547926%,61.3319083561552%,5672,10775,16818,33.7257700083244%,64.0682601974075%,0.533785546569267,0.665121332850416,0.65513467501672,11499,13805,16447
1391,23,MINNESOTA,LINCOLN,1590,1513,3284,48.4165651644336%,46.0718635809988%,860,1931,3019,28.4862537263995%,63.9615766810202%,937,2121,3115,30.0802568218299%,68.0898876404495%,0.487592652271995,0.691866714439269,0.693590582079791,3103,2791,3058
1392,23,MINNESOTA,LYON,4737,6087,11489,41.2307424492993%,52.9811123683523%,3825,7256,12215,31.3139582480557%,59.4023741301678%,4634,7979,12893,35.9419840223377%,61.8862948886993%,0.562361419068736,0.654814547423518,0.632601284389122,10824,11081,12613
1393,23,MINNESOTA,MAHNOMEN,921,1122,2224,41.4118705035971%,50.4496402877698%,930,991,2088,44.5402298850575%,47.4616858237548%,1112,1142,2304,48.2638888888889%,49.5659722222222%,0.549192364170338,0.515877147319105,0.506654835847382,2043,1921,2254
1394,23,MINNESOTA,MARSHALL,1910,2912,5199,36.7378341988844%,56.0107713021735%,1225,3208,4817,25.4307660369525%,66.5974673033008%,1295,3721,5113,25.327596323098%,72.7752787013495%,0.603898797179594,0.723663433340853,0.74182615629984,4822,4433,5016
1395,23,MINNESOTA,MARTIN,4166,5686,10371,40.1697039822582%,54.8259569954681%,2733,7062,10531,25.9519513816352%,67.0591586743899%,3305,7480,11009,30.0208919974566%,67.9444091198111%,0.577141697117337,0.720980091883614,0.693555864626797,9852,9795,10785
1396,23,MINNESOTA,MCLEOD,5609,8782,15394,36.4362738729375%,57.0482005976354%,4978,12155,18807,26.4688679746903%,64.6301908863721%,6413,13986,20933,30.635838150289%,66.8131658147423%,0.610242512681537,0.709449600186774,0.685621844208049,14391,17133,20399
1397,23,MINNESOTA,MEEKER,4402,5520,10672,41.2481259370315%,51.7241379310345%,3191,8104,12282,25.9811105683114%,65.9827389675949%,3867,9359,13529,28.5830438317688%,69.1773227880849%,0.556339447691998,0.717485613103143,0.707621351882655,9922,11295,13226
1398,23,MINNESOTA,MILLE LACS,4376,5223,10253,42.6801911635619%,50.9411879449917%,3710,8340,13017,28.501190750557%,64.0700622263194%,4404,9952,14689,29.9816188984955%,67.7513785826128%,0.544119179081154,0.692116182572614,0.693229311786013,9599,12050,14356
1399,23,MINNESOTA,MORRISON,5274,8197,14677,35.9337739320024%,55.8492880016352%,3637,12925,17614,20.6483479050755%,73.3791302373112%,4367,14821,19558,22.3284589426322%,75.7797320789447%,0.608492316828743,0.780400917763555,0.77240983948301,13471,16562,19188
1400,23,MINNESOTA,MOWER,10693,6873,18480,57.8625541125541%,37.1915584415584%,7437,8823,17715,41.9813717188823%,49.805249788315%,8899,10025,19345,46.0015507883174%,51.8221762729388%,0.391267220767392,0.542619926199262,0.529750581272458,17566,16260,18924
1401,23,MINNESOTA,MURRAY,2093,2407,4753,44.0353460972018%,50.6416999789607%,1295,2974,4668,27.7420736932305%,63.7103684661525%,1449,3363,4896,29.5955882352941%,68.6887254901961%,0.534888888888889,0.696650269383931,0.698877805486284,4500,4269,4812
1402,23,MINNESOTA,NICOLLET,7041,7221,15327,45.9385398316696%,47.1129379526326%,7886,8437,18097,43.5762833618832%,46.6209869039067%,9622,9018,19125,50.3111111111111%,47.1529411764706%,0.506310475389146,0.516878024872879,0.483798283261803,14262,16323,18640
1403,23,MINNESOTA,NOBLES,3760,4766,8872,42.380522993688%,53.7195671776375%,2733,5299,8632,31.6612604263207%,61.387859128823%,2933,5600,8715,33.6546184738956%,64.2570281124498%,0.558996012197983,0.659736055776892,0.656275635767022,8526,8032,8533
1404,23,MINNESOTA,NORMAN,1575,1808,3641,43.2573468827245%,49.656687723153%,1264,1699,3261,38.7611162220178%,52.1005826433609%,1404,1953,3441,40.8020924149956%,56.7567567567568%,0.534436890334023,0.573405332433345,0.581769436997319,3383,2963,3357
1405,23,MINNESOTA,OLMSTED,25822,30641,59392,43.4772359913793%,51.5911233836207%,36268,35668,80129,45.2620150008112%,44.5132224288335%,49491,39692,91385,54.156590250041%,43.4338239317175%,0.542673963480509,0.49582962633452,0.445062399784712,56463,71936,89183
1406,23,MINNESOTA,OTTER TAIL,9844,16963,28511,34.5270246571499%,59.496334747992%,9340,20939,32500,28.7384615384615%,64.4276923076923%,11958,23800,36399,32.8525508942553%,65.3864117146075%,0.632782482187488,0.691535387562337,0.665585323563958,26807,30279,35758
1407,23,MINNESOTA,PENNINGTON,2458,3380,6320,38.8924050632911%,53.4810126582279%,2147,4000,6715,31.9731943410275%,59.5681310498883%,2568,4532,7277,35.2892675553113%,62.2784114332829%,0.578965399109284,0.650723930372539,0.63830985915493,5838,6147,7100
1408,23,MINNESOTA,PINE,6148,5854,13068,47.0462197734925%,44.7964493419039%,4580,8191,13811,33.1619723408877%,59.3077981319238%,5419,10256,16001,33.8666333354165%,64.095994000375%,0.487752041326446,0.6413749902122,0.654290271132376,12002,12771,15675
1409,23,MINNESOTA,PIPESTONE,1970,2693,4894,40.2533714752759%,55.026563138537%,1127,3338,4808,23.4400998336106%,69.4259567387687%,1306,3553,4940,26.4372469635628%,71.9230769230769%,0.577525198370148,0.747592385218365,0.7312204157234,4663,4465,4859
1410,23,MINNESOTA,POLK,5764,7609,14140,40.7637906647808%,53.8118811881188%,4712,8979,14796,31.8464449851311%,60.6853203568532%,5439,9865,15594,34.878799538284%,63.2615108375016%,0.568982277723772,0.655832298590315,0.644602718243597,13373,13691,15304
1411,23,MINNESOTA,POPE,2771,2808,5987,46.2836144980792%,46.9016201770503%,2106,3793,6319,33.3280582370628%,60.0253204620984%,2477,4417,7022,35.2748504699516%,62.9023070350328%,0.503316006452769,0.642990337345313,0.640702059762112,5579,5899,6894
1412,23,MINNESOTA,RAMSEY,138470,87669,244278,56.6854157967562%,35.8890280745708%,177738,70894,273143,65.0714094814804%,25.9549027432517%,211620,77376,295977,71.4987988931572%,26.1425718890319%,0.387677490393077,0.285136265645613,0.267740729975501,226139,248632,288996
1413,23,MINNESOTA,RED LAKE,830,1090,2090,39.7129186602871%,52.1531100478469%,540,1141,1881,28.7081339712919%,60.6592238171186%,691,1454,2196,31.4663023679417%,66.2112932604736%,0.567708333333333,0.678762641284949,0.677855477855478,1920,1681,2145
1414,23,MINNESOTA,REDWOOD,2681,4589,7748,34.6024780588539%,59.2281879194631%,1887,5137,7611,24.7930626724478%,67.4944159768756%,2355,5771,8284,28.4282955094157%,69.6644133268952%,0.631224209078404,0.731349658314351,0.710189515136599,7270,7024,8126
1415,23,MINNESOTA,RENVILLE,3533,4036,8122,43.4991381433145%,49.6921940408766%,2117,4890,7606,27.8332895082829%,64.2913489350513%,2496,5467,8128,30.7086614173228%,67.2613188976378%,0.533227639054036,0.697873555016412,0.686550295114906,7569,7007,7963
1416,23,MINNESOTA,RICE,13140,10876,26021,50.4976749548442%,41.7970101072211%,14437,15429,32443,44.499583885584%,47.5572542613199%,17402,17464,35686,48.7642212632405%,48.9379588634198%,0.452864756828781,0.516607513560571,0.500889118338783,24016,29866,34866
1417,23,MINNESOTA,ROCK,2081,2772,5010,41.5369261477046%,55.3293413173653%,1373,3091,4839,28.3736309154784%,63.8768340566233%,1556,3583,5240,29.6946564885496%,68.3778625954198%,0.571193076447558,0.692428315412186,0.697217357462541,4853,4464,5139
1418,23,MINNESOTA,ROSEAU,2128,4695,7166,29.6957856544795%,65.5177225788445%,1856,5451,7804,23.7826755509995%,69.8487954894926%,2188,6065,8421,25.9826623916399%,72.0223251395321%,0.68811373296204,0.745996989188449,0.734884284502605,6823,7307,8253
1419,23,MINNESOTA,SAINT LOUIS,64237,35420,107464,59.7753666344078%,32.9598749348619%,57771,44630,112422,51.3876287559375%,39.69863549839%,67704,49017,119531,56.6413733675783%,41.007772042399%,0.355419087470022,0.43583558754309,0.419950137507389,99657,102401,116721
1420,23,MINNESOTA,SCOTT,17503,23954,43793,39.9675747265545%,54.6982394446601%,28502,39948,75029,37.987977981847%,53.2434125471484%,40040,45872,87965,45.5181037912806%,52.1480134144262%,0.577803507248474,0.583608473338203,0.533941707794022,41457,68450,85912
1421,23,MINNESOTA,SHERBURNE,12109,16813,30835,39.2703097129885%,54.5257013134425%,13293,31053,48283,27.5314292815277%,64.314562061181%,18065,36222,55612,32.4839962598%,65.1334244407682%,0.581322176889565,0.700243539439859,0.667231565568184,28922,44346,54287
1422,23,MINNESOTA,SIBLEY,2687,4087,7335,36.6325835037492%,55.7191547375597%,1954,5193,7774,25.135065603293%,66.7995883714947%,2417,5864,8452,28.5967818267866%,69.380028395646%,0.603336285798642,0.72659857282776,0.708127037797367,6774,7147,8281
1423,23,MINNESOTA,STEARNS,24800,32402,62476,39.6952429733017%,51.8631154363276%,25576,47617,79592,32.1338828022917%,59.8263644587396%,31879,50959,84835,37.5776507337773%,60.0683680084871%,0.566448725569036,0.650567677236894,0.615164538013955,57202,73193,82838
1424,23,MINNESOTA,STEELE,6900,8223,16066,42.9478401593427%,51.1826216855471%,6241,11198,19179,32.5407998331508%,58.3867772042338%,7917,12656,21128,37.4716016660356%,59.9015524422567%,0.543741321166435,0.642123974998566,0.615175229669956,15123,17439,20573
1425,23,MINNESOTA,STEVENS,2434,2831,5752,42.3157162726008%,49.2176634214186%,2116,2799,5398,39.1997035939237%,51.8525379770285%,1922,3044,5085,37.7974434611603%,59.8623402163225%,0.537701804368471,0.569481180061038,0.612968183648812,5265,4915,4966
1426,23,MINNESOTA,SWIFT,2698,2376,5437,49.6229538348354%,43.7005701673717%,1686,2963,4994,33.7605126151382%,59.3311974369243%,1784,3316,5193,34.3539379934527%,63.8551896784132%,0.468269609775325,0.637341363734136,0.650196078431372,5074,4649,5100
1427,23,MINNESOTA,TODD,4132,6031,11092,37.2520735665344%,54.3725207356653%,2783,8485,11993,23.2052030351038%,70.7496039356291%,3286,9753,13257,24.7869050313042%,73.5686806969903%,0.593427137656204,0.753017394391196,0.747986808804356,10163,11268,13039
1428,23,MINNESOTA,TRAVERSE,884,1074,2106,41.9753086419753%,50.997150997151%,630,1049,1798,35.0389321468298%,58.3426028921023%,661,1172,1864,35.4613733905579%,62.8755364806867%,0.548518896833504,0.624776652769506,0.639388979814512,1958,1679,1833
1429,23,MINNESOTA,WABASHA,4522,5245,10531,42.9398917481721%,49.8053366252018%,3866,6989,11832,32.6741041244084%,59.0686274509804%,4696,8153,13123,35.7845004953136%,62.1275622952069%,0.537012388655677,0.643850760018425,0.634524087477625,9767,10855,12849
1430,23,MINNESOTA,WADENA,2251,3733,6382,35.271074898151%,58.4926355374491%,1684,4837,6934,24.2861263340063%,69.7577156042688%,2023,5520,7677,26.351439364335%,71.9030871434154%,0.623830213903743,0.741757399171906,0.731804321887843,5984,6521,7543
1431,23,MINNESOTA,WASECA,3694,4608,8864,41.6741877256318%,51.985559566787%,2838,5967,9653,29.4001864705273%,61.8149797990262%,3496,6624,10389,33.6509769948985%,63.7597458850708%,0.555046976632137,0.677683134582624,0.654545454545455,8302,8805,10120
1432,23,MINNESOTA,WASHINGTON,49637,51502,107009,46.3858180153071%,48.1286620751526%,67086,64428,144235,46.5115956598607%,44.6687697160883%,89165,73764,166786,53.46072212296%,44.2267336587004%,0.509219984377935,0.489894611980474,0.452737081796365,101139,131514,162929
1433,23,MINNESOTA,WATONWAN,2258,2562,5134,43.9813011297234%,49.9026100506428%,1814,2768,4998,36.2945178071228%,55.3821528611445%,1987,3103,5201,38.2041915016343%,59.6616035377812%,0.531535269709544,0.604103011785247,0.609626719056974,4820,4582,5090
1434,23,MINNESOTA,WILKIN,1046,2032,3305,31.6490166414523%,61.482602118003%,893,2129,3302,27.0442156268928%,64.4760751059964%,1026,2328,3430,29.9125364431487%,67.8717201166181%,0.660168940870695,0.704500330906684,0.694096601073345,3078,3022,3354
1435,23,MINNESOTA,WINONA,11069,10773,23918,46.2789530897232%,45.0413914206874%,11366,12122,26074,43.591317020787%,46.4907570760144%,13333,13227,27173,49.0670886541788%,48.6769955470504%,0.493224063730428,0.516093324250681,0.498004518072289,21842,23488,26560
1436,23,MINNESOTA,WRIGHT,16762,23861,43366,38.6524004980861%,55.0223677535396%,20334,43274,69618,29.2079634577264%,62.1592116981241%,28430,51973,82426,34.4915439303132%,63.0541334045083%,0.587376609309997,0.680323229782417,0.64640622862331,40623,63608,80403
1437,23,MINNESOTA,YELLOW MEDICINE,2528,2598,5515,45.8386219401632%,47.1078875793291%,1524,3382,5276,28.8855193328279%,64.1015921152388%,1688,3734,5528,30.5354558610709%,67.5470332850941%,0.506827936012485,0.689359967386873,0.688675765400221,5126,4906,5422
1439,24,MISSISSIPPI,ADAMS,8065,6691,14879,54.2039115531958%,44.9694199879024%,7757,5874,13836,56.063891298063%,42.4544666088465%,7917,5696,13759,57.540518933062%,41.3983574387674%,0.453442667389536,0.430929498936248,0.418423565709248,14756,13631,13613
1440,24,MISSISSIPPI,ALCORN,5059,7254,12638,40.0300680487419%,57.398322519386%,2684,11819,14783,18.1559899885003%,79.949942501522%,2782,12818,15793,17.6153992275059%,81.1625403659849%,0.589133436205636,0.814934841067365,0.821666666666667,12313,14503,15600
1441,24,MISSISSIPPI,AMITE,2673,3677,6408,41.7134831460674%,57.3813982521848%,2697,4289,7050,38.2553191489362%,60.8368794326241%,2620,4503,7196,36.4091161756531%,62.5764313507504%,0.579055118110236,0.613942170054395,0.63217745332023,6350,6986,7123
1442,24,MISSISSIPPI,ATTALA,2922,4206,7173,40.7360936846508%,58.6365537432037%,3242,4897,8256,39.2684108527132%,59.3144379844961%,3542,5178,8823,40.1450753711889%,58.6875212512751%,0.59006734006734,0.601670966949257,0.593807339449541,7128,8139,8720
1443,24,MISSISSIPPI,BENTON,1886,1561,3481,54.1798333812123%,44.843435794312%,1719,2251,4013,42.8357837029654%,56.0926987291303%,1679,2570,4289,39.1466542317557%,59.9207274422942%,0.4528575572962,0.567002518891688,0.604848199576371,3447,3970,4249
1444,24,MISSISSIPPI,BOLIVAR,8436,4847,13538,62.3134879598168%,35.8029250997193%,9046,4590,13824,65.4369212962963%,33.203125%,8904,4671,13744,64.7846332945285%,33.9857392316647%,0.364902506963788,0.336608976239366,0.344088397790055,13283,13636,13575
1445,24,MISSISSIPPI,CALHOUN,2251,3448,5758,39.0934352205627%,59.881903438694%,1910,4390,6396,29.8624140087555%,68.6366479049406%,1902,4625,6590,28.8619119878604%,70.1820940819423%,0.605018424284962,0.696825396825397,0.708595066646239,5699,6300,6527
1446,24,MISSISSIPPI,CARROLL,1726,3165,4924,35.0528025995126%,64.2770105605199%,1680,3799,5528,30.3907380607815%,68.7228654124457%,1729,3924,5701,30.3280126293633%,68.8300298193299%,0.647106931097935,0.693374703413032,0.69414470192818,4891,5479,5653
1447,24,MISSISSIPPI,CHICKASAW,3519,3549,7175,49.0452961672474%,49.4634146341463%,3649,4127,7890,46.2484157160963%,52.3067173637516%,3810,4175,8141,46.8001474020391%,51.2836260901609%,0.502122241086587,0.530735596707819,0.522855353788353,7068,7776,7985
1448,24,MISSISSIPPI,CHOCTAW,1278,2398,3719,34.3640763646141%,64.4796988437752%,1218,2788,4065,29.9630996309963%,68.5854858548585%,1185,3001,4223,28.0606204120294%,71.0632251953588%,0.65233949945593,0.695956065901148,0.716913521261347,3676,4006,4186
1449,24,MISSISSIPPI,CLAIBORNE,3670,883,4615,79.5232936078007%,19.1332611050921%,3708,540,4272,86.7977528089888%,12.6404494382022%,3772,603,4449,84.7830973252416%,13.5536075522589%,0.193938062815726,0.127118644067797,0.137828571428571,4553,4248,4375
1450,24,MISSISSIPPI,CLARKE,2368,4503,6919,34.2245989304813%,65.0816591993063%,2585,5137,7791,33.1793094596329%,65.9350532665897%,2838,5417,8338,34.0369393139842%,64.9676181338451%,0.655363120360937,0.665242165242165,0.656208358570563,6871,7722,8255
1451,24,MISSISSIPPI,CLAY,4515,3570,8165,55.2969993876301%,43.7232088181261%,5722,4150,10003,57.2028391482555%,41.4875537338798%,5844,4181,10189,57.3559721268034%,41.0344489154971%,0.441558441558442,0.420380875202593,0.417057356608479,8085,9872,10025
1452,24,MISSISSIPPI,COAHOMA,5662,3695,9553,59.2693394745106%,38.6789490212499%,6378,2426,8912,71.5664272890485%,27.221723518851%,6020,2375,8501,70.8151982119751%,27.93788966004%,0.394891525061451,0.275556565197637,0.2829064919595,9357,8804,8395
1453,24,MISSISSIPPI,COPIAH,4845,5643,10587,45.76367242845%,53.3012184754888%,6741,6103,12982,51.9257433369281%,47.0112463410877%,6470,6250,12883,50.2212217651168%,48.5135449817589%,0.538043478260869,0.475163500467144,0.491352201257862,10488,12844,12720
1454,24,MISSISSIPPI,COVINGTON,2623,4180,6881,38.1194593809039%,60.7469844499346%,3276,5435,8811,37.1807967313585%,61.6842583134718%,3416,5854,9360,36.4957264957265%,62.542735042735%,0.614434808172865,0.623923774537941,0.631499460625674,6803,8711,9270
1455,24,MISSISSIPPI,DESOTO,9586,24879,34936,27.4387451339592%,71.2130753377605%,20591,43089,65695,31.3433290204734%,65.5894664738565%,28265,46462,76124,37.1302086070096%,61.0346277126793%,0.72186275932105,0.676648869346734,0.621756527091948,34465,63680,74727
1456,24,MISSISSIPPI,FORREST,8500,13281,22251,38.2005303132443%,59.6872050694351%,11716,15461,28064,41.7474344355758%,55.0919327251995%,13755,17290,31654,43.4542237947811%,54.6218487394958%,0.609751618382994,0.568900172940354,0.556933483652762,21781,27177,31045
1457,24,MISSISSIPPI,FRANKLIN,1486,2427,3953,37.591702504427%,61.3964077915507%,1502,2721,4290,35.011655011655%,63.4265734265734%,1480,2923,4461,33.1764178435328%,65.5234252409774%,0.620240224891388,0.644328676296472,0.663865546218487,3913,4223,4403
1458,24,MISSISSIPPI,GEORGE,1977,5143,7284,27.1416803953872%,70.6068094453597%,1027,8696,9891,10.3831766252148%,87.9183095743605%,1218,9713,11049,11.0236220472441%,87.9084080007241%,0.722331460674157,0.894374164352566,0.888573780989845,7120,9723,10931
1459,24,MISSISSIPPI,GREENE,1317,3082,4436,29.6889089269612%,69.4770063119928%,974,4335,5369,18.1411808530453%,80.7412926056994%,966,4794,5812,16.6207845836201%,82.4845147969718%,0.70061377585815,0.816537954417028,0.832291666666667,4399,5309,5760
1460,24,MISSISSIPPI,GRENADA,4163,5129,9385,44.3580181140117%,54.6510388918487%,4424,5970,10513,42.0812327594407%,56.7868353467136%,4734,6081,10911,43.3874072037394%,55.7327467693154%,0.551980198019802,0.574369828747354,0.562274618585298,9292,10394,10815
1461,24,MISSISSIPPI,HANCOCK,4801,9326,14548,33.0010998075337%,64.1050316194666%,3344,13811,17637,18.960140613483%,78.3069683052673%,4504,16132,20957,21.4916257097867%,76.9766665076108%,0.660154314433355,0.805071407752842,0.781740647412289,14127,17155,20636
1462,24,MISSISSIPPI,HARRISON,19142,32256,52616,36.3805686483199%,61.3045461456591%,21169,40354,63313,33.4354713881825%,63.7373051348064%,27728,46822,75768,36.5959244008024%,61.7965367965368%,0.627573057317405,0.655917299221429,0.628061703554661,51398,61523,74550
1463,24,MISSISSIPPI,HINDS,46789,37753,87770,53.3086476016862%,43.0135581633816%,67594,25275,94681,71.3913034294103%,26.6949018282443%,73550,25141,99995,73.5536776838842%,25.1422571128556%,0.446559106716188,0.27215755526602,0.254744606904378,84542,92869,98691
1464,24,MISSISSIPPI,HOLMES,5447,1937,7422,73.3899218539477%,26.0980867690649%,6689,1309,8076,82.825656265478%,16.208519068846%,6588,1369,8115,81.1829944547135%,16.8699938385705%,0.262323943661972,0.16366591647912,0.172049767500314,7384,7998,7957
1465,24,MISSISSIPPI,HUMPHREYS,2288,1628,3944,58.0121703853955%,41.2778904665314%,3071,1151,4253,72.2078532800376%,27.0632494709617%,3016,1118,4189,71.9980902363333%,26.6889472427787%,0.415730337078652,0.272619611558503,0.270440251572327,3916,4222,4134
1466,24,MISSISSIPPI,ISSAQUENA,555,366,941,58.9798087141339%,38.8947927736451%,395,298,699,56.5092989985694%,42.6323319027182%,355,308,676,52.5147928994083%,45.5621301775148%,0.397394136807818,0.43001443001443,0.464555052790347,921,693,663
1467,24,MISSISSIPPI,ITAWAMBA,2994,5424,8564,34.9602989257356%,63.3348902382064%,1117,8470,9737,11.4717058642292%,86.9877785765636%,1249,9438,10819,11.5445050374341%,87.2354191699787%,0.644333570919458,0.883488056743507,0.883129035276504,8418,9587,10687
1468,24,MISSISSIPPI,JACKSON,14193,30068,45107,31.4651827875939%,66.6592768306471%,14657,33629,49567,29.5700768656566%,67.8455423971594%,17375,36295,54543,31.8556001686743%,66.5438278055846%,0.679333950882267,0.696454458849356,0.676262343953792,44261,48286,53670
1469,24,MISSISSIPPI,JASPER,3104,3294,6447,48.146424693656%,51.0935318752908%,4368,4038,8475,51.5398230088496%,47.646017699115%,4341,4302,8736,49.6909340659341%,49.2445054945055%,0.514848390121913,0.480371163454675,0.497743838944811,6398,8406,8643
1470,24,MISSISSIPPI,JEFFERSON,2786,600,3408,81.7488262910798%,17.6056338028169%,3337,490,3860,86.4507772020725%,12.6943005181347%,3327,531,3908,85.1330603889458%,13.5875127942682%,0.177200236266982,0.128037627384374,0.137636080870918,3386,3827,3858
1471,24,MISSISSIPPI,JEFFERSON DAVIS,2835,2437,5317,53.3195410946022%,45.8341169832612%,3720,2466,6237,59.6440596440596%,39.5382395382395%,3599,2534,6213,57.9269274102688%,40.7854498631901%,0.462253414264036,0.398642095053346,0.413174629055927,5272,6186,6133
1472,24,MISSISSIPPI,JONES,7713,16341,24340,31.6885784716516%,67.1364009860312%,7791,20133,28352,27.4795428893905%,71.0108634311512%,8517,21226,30091,28.3041440962414%,70.5393639294141%,0.679346470441507,0.720992694456382,0.71364690851629,24054,27924,29743
1473,24,MISSISSIPPI,KEMPER,2311,1915,4261,54.2360948134241%,44.9425017601502%,2827,1778,4639,60.9398577279586%,38.3272256951929%,2887,1787,4731,61.0230395265272%,37.7721411963644%,0.453147184098438,0.386102062975027,0.382327770646127,4226,4605,4674
1474,24,MISSISSIPPI,LAFAYETTE,5139,7081,12678,40.5347846663512%,55.8526581479729%,7969,10872,19643,40.5691594970218%,55.3479611057374%,10070,12949,23423,42.9919310079836%,55.2832685821628%,0.579459901800327,0.577039435274136,0.562535296928624,12220,18841,23019
1475,24,MISSISSIPPI,LAMAR,3478,12795,16602,20.9492832188893%,77.0690278279725%,5190,18751,24592,21.1044242029928%,76.2483734547821%,7340,20704,28485,25.7679480428296%,72.683868702826%,0.786271738462484,0.783217075310137,0.738268435315932,16273,23941,28044
1476,24,MISSISSIPPI,LAUDERDALE,8412,17315,25970,32.3912206391991%,66.6730843280709%,11269,17741,29506,38.1922320883888%,60.1267538805667%,12960,17967,31247,41.4759816942427%,57.4999199923193%,0.673028335989427,0.611547742157877,0.580948685614512,25727,29010,30927
1477,24,MISSISSIPPI,LAWRENCE,2841,3674,6587,43.1304083801427%,55.7765295278579%,2195,4091,6364,34.4908862350723%,64.2834695160277%,2260,4285,6613,34.175109632542%,64.7966127324966%,0.56392939370683,0.650811326757875,0.654698242933537,6515,6286,6545
1478,24,MISSISSIPPI,LEAKE,2793,4114,6952,40.1754890678941%,59.1772151898734%,3584,4782,8449,42.4192212096106%,56.5984140134927%,3897,5228,9200,42.3586956521739%,56.8260869565217%,0.595627624149414,0.571599330623954,0.572931506849315,6907,8366,9125
1479,24,MISSISSIPPI,LEE,9142,15551,25094,36.4310193671794%,61.9709890810552%,10029,22220,32913,30.4712423662383%,67.5113177164039%,12189,24207,36954,32.9842506900471%,65.5057639227147%,0.629773620054266,0.689013612825204,0.665100560501154,24693,32249,36396
1480,24,MISSISSIPPI,LEFLORE,6401,4626,11276,56.7665838949982%,41.025186236254%,7787,3212,11140,69.9012567324955%,28.8330341113106%,7648,3129,10893,70.2102267511246%,28.7248691820435%,0.419515734107191,0.292026547867988,0.290340540038972,11027,10999,10777
1481,24,MISSISSIPPI,LINCOLN,4358,8540,13000,33.5230769230769%,65.6923076923077%,4458,10550,15193,29.3424603435793%,69.439873626012%,5040,11596,16801,29.9982143920005%,69.0197012082614%,0.662118157853931,0.70295842217484,0.697042558307285,12898,15008,16636
1482,24,MISSISSIPPI,LOWNDES,7537,11404,19230,39.1939677587103%,59.3031721268851%,11819,13271,25575,46.2130987292278%,51.8905180840665%,13087,13800,27241,48.0415550089938%,50.6589332256525%,0.602080143603822,0.52893583100837,0.513259195893926,18941,25090,26887
1483,24,MISSISSIPPI,MADISON,10416,19109,29859,34.8839545865568%,63.9974547037744%,20343,28265,49802,40.847757118188%,56.7547488052689%,24440,31091,56212,43.4782608695652%,55.3102540382836%,0.647214225232854,0.581488643844635,0.559885469377465,29525,48608,55531
1484,24,MISSISSIPPI,MARION,4114,6796,10998,37.4068012365885%,61.793053282415%,3677,7836,11693,31.4461643718464%,67.0144530915933%,3787,8273,12177,31.0996140264433%,67.9395581834606%,0.622914757103575,0.680621905671849,0.685986733001658,10910,11513,12060
1485,24,MISSISSIPPI,MARSHALL,7735,4723,12592,61.4278907242694%,37.5079415501906%,8023,6587,14839,54.066985645933%,44.3897836781454%,8057,7566,15817,50.9388632484036%,47.8346083328065%,0.37911382244341,0.450855578370979,0.484285988606542,12458,14610,15623
1486,24,MISSISSIPPI,MONROE,5783,7397,13360,43.2859281437126%,55.3667664670659%,5524,10167,15884,34.7771342231176%,64.0078065978343%,5874,11177,17259,34.0344168260038%,64.7604148560172%,0.561229135053111,0.647951054744758,0.655504076007272,13180,15691,17051
1487,24,MISSISSIPPI,MONTGOMERY,2187,2630,4849,45.1020829036915%,54.2379872138585%,2115,2818,4996,42.3338670936749%,56.4051240992794%,2121,2917,5075,41.7931034482759%,57.4778325123153%,0.545982976956612,0.571254814514494,0.57899960301707,4817,4933,5038
1488,24,MISSISSIPPI,NESHOBA,2563,6409,9066,28.2704610633135%,70.6926979924995%,2715,7679,10553,25.7272813417985%,72.7660380934332%,3260,8320,11703,27.8561052721524%,71.0928821669657%,0.714333481943825,0.738791610544545,0.718480138169257,8972,10394,11580
1489,24,MISSISSIPPI,NEWTON,2147,5540,7738,27.7461876453864%,71.5947273197209%,2756,6548,9438,29.2011019283747%,69.3791057427421%,3075,6997,10183,30.1973878032014%,68.7125601492684%,0.720697281123976,0.70378331900258,0.694698173153296,7687,9304,10072
1490,24,MISSISSIPPI,NOXUBEE,3383,1530,4954,68.2882519176423%,30.8841340331046%,4347,1200,5574,77.9870828848224%,21.5285252960172%,4040,1240,5339,75.6696010488856%,23.2253230942124%,0.311418685121107,0.216333153055706,0.234848484848485,4913,5547,5280
1491,24,MISSISSIPPI,OKTIBBEHA,6443,7959,14804,43.522021075385%,53.7624966225344%,8859,8576,18124,48.8799382034871%,47.3184727433238%,10299,9004,19757,52.1283595687604%,45.573720706585%,0.552631578947368,0.491884141095498,0.46645599129669,14402,17435,19303
1492,24,MISSISSIPPI,PANOLA,5880,5424,11389,51.6287645974186%,47.6249012204759%,7431,7449,15064,49.3295273499735%,49.4490175252257%,7403,8060,15627,47.3731362385615%,51.5773980930441%,0.479830148619958,0.500604838709677,0.521244260492789,11304,14880,15463
1493,24,MISSISSIPPI,PEARL RIVER,4611,11575,16477,27.9844631911149%,70.2494386113977%,3604,17782,21883,16.4694054745693%,81.2594251245259%,4148,19595,24033,17.2596013814339%,81.5337244621978%,0.715124181391326,0.83147853736089,0.825295876679442,16186,21386,23743
1494,24,MISSISSIPPI,PERRY,1285,3026,4359,29.4792383574214%,69.4195916494609%,1220,4135,5432,22.459499263623%,76.1229749631812%,1362,4500,5916,23.0223123732252%,76.0649087221095%,0.701925307353282,0.772175536881419,0.767656090071648,4311,5355,5862
1495,24,MISSISSIPPI,PIKE,6544,7464,14166,46.1951150642383%,52.6895383312156%,8043,8009,16310,49.3133047210301%,49.1048436541999%,8646,8479,17342,49.8558413101142%,48.8928612616769%,0.532838378069674,0.498940941938699,0.495124087591241,14008,16052,17125
1496,24,MISSISSIPPI,PONTOTOC,2771,6601,9510,29.1377497371188%,69.4111461619348%,2386,10336,12984,18.3764633394948%,79.6056685150955%,2614,11550,14361,18.2020750644106%,80.4261541675371%,0.704332052923602,0.812450872504323,0.815447613668455,9372,12722,14164
1497,24,MISSISSIPPI,PRENTISS,3287,5101,8482,38.7526526762556%,60.1391181325159%,2067,7648,9872,20.9380064829822%,77.4716369529984%,2153,8370,10644,20.2273581360391%,78.6358511837655%,0.608130662851693,0.787236232629954,0.79540055117362,8388,9715,10523
1498,24,MISSISSIPPI,QUITMAN,2103,1280,3413,61.617345443891%,37.5036624670378%,2312,1001,3365,68.7072808320951%,29.7473997028232%,2150,1026,3226,66.6460012399256%,31.8040917544947%,0.378362400236476,0.302143072743737,0.323047858942065,3383,3313,3176
1499,24,MISSISSIPPI,RANKIN,8050,32983,41435,19.4280197900326%,79.6017859297695%,14110,47178,62768,22.4796074432832%,75.162503186337%,18847,50895,70655,26.6746868586795%,72.033118675253%,0.803816440425999,0.769775486228952,0.729761119554931,41033,61288,69742
1500,24,MISSISSIPPI,SCOTT,3548,5601,9206,38.5400825548555%,60.8407560286769%,4268,6122,10522,40.5626306785782%,58.1828549705379%,4330,6285,10733,40.3428677909252%,58.5577191838256%,0.612198054432178,0.589220404234841,0.592086669806877,9149,10390,10615
1501,24,MISSISSIPPI,SHARKEY,1706,1074,2903,58.7667929727868%,36.9962108163968%,1479,692,2190,67.5342465753425%,31.5981735159817%,1465,688,2183,67.1094823637197%,31.5162620247366%,0.386330935251799,0.318747121142331,0.319554110543428,2780,2171,2153
1502,24,MISSISSIPPI,SIMPSON,3227,6254,9574,33.7058700647587%,65.3227491121788%,3874,7393,11419,33.9259129520974%,64.7429722392504%,4037,7635,11815,34.1684299619128%,64.6212441811257%,0.65963505959287,0.656164018816011,0.654129540781357,9481,11267,11672
1503,24,MISSISSIPPI,SMITH,1620,4838,6528,24.8161764705882%,74.1115196078431%,1617,5928,7627,21.2009964599449%,77.7238757047332%,1791,6458,8327,21.5083463432208%,77.5549417557344%,0.749148343140291,0.785685884691849,0.782882773669536,6458,7545,8249
1504,24,MISSISSIPPI,STONE,1677,3702,5523,30.3639326453015%,67.0287887017925%,1573,5306,7045,22.3278921220724%,75.3158268275373%,1802,5964,7878,22.8738258441229%,75.7044935262757%,0.688232013385388,0.7713330425934,0.767962915271697,5379,6879,7766
1505,24,MISSISSIPPI,SUNFLOWER,4981,3369,8415,59.1919191919192%,40.0356506238859%,6725,2794,9598,70.0666805584497%,29.1102312981871%,6781,2799,9681,70.0444168990807%,28.9123024480942%,0.403473053892216,0.293518226704486,0.292171189979123,8350,9519,9580
1506,24,MISSISSIPPI,TALLAHATCHIE,3041,2428,5523,55.0606554408836%,43.9616150642767%,3337,2462,5870,56.8483816013629%,41.9420783645656%,3105,2488,5685,54.6174142480211%,43.764291996482%,0.443956847686963,0.42455595792378,0.444841766493832,5469,5799,5593
1507,24,MISSISSIPPI,TATE,3441,5148,8693,39.5835729897619%,59.2200621189463%,3926,7495,11627,33.7662337662338%,64.462028038187%,4183,8707,13093,31.948369357672%,66.5011838386924%,0.599371288857841,0.656247263812276,0.675484871993794,8589,11421,12890
1508,24,MISSISSIPPI,TIPPAH,2908,5381,8403,34.6066880875878%,64.0366535761038%,1842,7240,9235,19.9458581483487%,78.3974011911207%,1937,8054,10102,19.1744209067511%,79.7267867748961%,0.649173603570998,0.797181237612861,0.806125512961665,8289,9082,9991
1509,24,MISSISSIPPI,TISHOMINGO,2747,4122,6992,39.2877574370709%,58.9530892448513%,999,7166,8371,11.9340580575797%,85.6050651057221%,1059,7933,9138,11.5889691398555%,86.8133070693806%,0.600087348959092,0.877648499693815,0.882228647686833,6869,8165,8992
1510,24,MISSISSIPPI,TUNICA,1539,792,2366,65.0464919695689%,33.4742180896027%,2667,853,3567,74.7687132043734%,23.9136529296327%,2580,926,3562,72.4312184166199%,25.9966311061202%,0.33976833976834,0.242329545454545,0.264118653736452,2331,3520,3506
1511,24,MISSISSIPPI,UNION,3094,6087,9311,33.2295134786811%,65.3742884759961%,2012,9235,11496,17.5017397355602%,80.3322894919972%,2160,10373,12683,17.0306709768982%,81.786643538595%,0.662999673238209,0.821107850982484,0.827654990824224,9181,11247,12533
1512,24,MISSISSIPPI,WALTHALL,2356,3476,5895,39.9660729431722%,58.9652247667515%,2790,4056,6919,40.3237462060991%,58.6211880329527%,2835,4220,7119,39.8230088495575%,59.2779884815283%,0.5960219478738,0.592462751971954,0.598157335223246,5832,6846,7055
1513,24,MISSISSIPPI,WARREN,7485,10892,18623,40.192235407829%,58.4868173763626%,9284,9767,19416,47.8162340337866%,50.3038730943552%,10442,10365,21053,49.5986320239396%,49.2328884244526%,0.592697393480982,0.512676499921264,0.498149661171721,18377,19051,20807
1514,24,MISSISSIPPI,WASHINGTON,10405,7367,18328,56.7710606721956%,40.1953295504147%,11380,5244,16825,67.6374442793462%,31.1679049034175%,12503,5300,18008,69.4302532207908%,29.4313638382941%,0.41452847175332,0.315447545717036,0.297702634387463,17772,16624,17803
1515,24,MISSISSIPPI,WAYNE,2981,4635,7705,38.6891628812459%,60.1557430240104%,3524,5990,9599,36.712157516408%,62.4023335764142%,3624,6307,10056,36.0381861575179%,62.7187748607796%,0.60858718487395,0.629598486441034,0.635082066257174,7616,9514,9931
1516,24,MISSISSIPPI,WEBSTER,1426,3069,4545,31.3751375137514%,67.5247524752475%,1019,3976,5069,20.102584336161%,78.4375616492405%,1043,4291,5395,19.3327154772938%,79.5366079703429%,0.682758620689655,0.795995995995996,0.804461942257218,4495,4995,5334
1517,24,MISSISSIPPI,WILKINSON,2551,1423,4098,62.2498779892631%,34.7242557345046%,2857,1318,4218,67.7335229966809%,31.2470365101944%,2749,1324,4127,66.610128422583%,32.0814150714805%,0.358077503774534,0.315688622754491,0.325067517800147,3974,4175,4073
1518,24,MISSISSIPPI,WINSTON,3672,4645,8368,43.8814531548757%,55.5090822179732%,3850,4910,8881,43.3509739894156%,55.2865668280599%,4040,5112,9236,43.7418796015591%,55.3486357730619%,0.558494649513046,0.560502283105023,0.558566433566434,8317,8760,9152
1519,24,MISSISSIPPI,YALOBUSHA,2674,2470,5228,51.1476664116297%,47.2456006120888%,2582,3376,6077,42.4880697712687%,55.5537271680105%,2785,3671,6535,42.6166794185157%,56.1744452945677%,0.480171073094868,0.566633098355153,0.56861833952912,5144,5958,6456
1520,24,MISSISSIPPI,YAZOO,4997,5254,10516,47.5180677063522%,49.961962723469%,5369,4598,10070,53.3167825223436%,45.6603773584906%,5496,4832,10436,52.6638558834803%,46.3012648524339%,0.512535362403668,0.461322363800542,0.467854376452362,10251,9967,10328
1522,25,MISSOURI,ADAIR,4101,6050,10552,38.8646702047005%,57.3351023502654%,3500,6030,10226,34.2264815177%,58.9673381576374%,3710,6413,10336,35.8939628482972%,62.0452786377709%,0.596000394049847,0.632738719832109,0.633507853403141,10151,9530,10123
1523,25,MISSOURI,ANDREW,2795,4257,7274,38.4245257080011%,58.5235083860324%,2045,6665,9140,22.3741794310722%,72.9212253829322%,2351,7255,9752,24.1078753076292%,74.3949958982773%,0.603658536585366,0.765212399540758,0.755257130959817,7052,8710,9606
1524,25,MISSOURI,ATCHISON,1013,1798,2871,35.2838732149077%,62.6262626262626%,541,2060,2724,19.8604992657856%,75.6240822320117%,564,2199,2814,20.0426439232409%,78.1449893390192%,0.63963002490217,0.7920030757401,0.795874049945711,2811,2601,2763
1525,25,MISSOURI,AUDRAIN,4551,5256,9985,45.578367551327%,52.6389584376565%,2570,6981,10061,25.5441804989564%,69.3867408806282%,2704,7732,10656,25.3753753753754%,72.5600600600601%,0.535943713673906,0.730918228457753,0.740896895362208,9807,9551,10436
1526,25,MISSOURI,BARRY,4135,7885,12368,33.4330530401035%,63.753234152652%,2710,11428,14605,18.5552892844916%,78.247175624786%,2948,12425,15598,18.8998589562764%,79.6576484164636%,0.655990016638935,0.808318008204838,0.80823521758928,12020,14138,15373
1527,25,MISSOURI,BARTON,1424,3836,5366,26.5374580693254%,71.4871412597838%,795,4959,5939,13.3860919346691%,83.4989055396532%,844,5168,6077,13.8884317920026%,85.0419614941583%,0.729277566539924,0.861835245046924,0.859614105123087,5260,5754,6012
1528,25,MISSOURI,BATES,3386,4245,7792,43.4548254620123%,54.4789527720739%,1618,6001,8023,20.1670198180232%,74.7974573102331%,1672,6597,8416,19.8669201520913%,78.3864068441065%,0.556283580133665,0.78763617272608,0.797799008344419,7631,7619,8269
1529,25,MISSOURI,BENTON,3150,4218,7534,41.8104592513937%,55.9861959118662%,2025,7213,9312,21.7461340206186%,77.4591924398626%,2180,8109,10476,20.8094692630775%,77.405498281787%,0.572475570032573,0.780796709244425,0.788123238409952,7368,9238,10289
1530,25,MISSOURI,BOLLINGER,1692,3487,5294,31.9607102380053%,65.8670192670948%,705,4827,5676,12.4207188160677%,85.0422832980973%,750,5167,5983,12.5355172990139%,86.3613571786729%,0.6732960030894,0.872559652928416,0.873246577657597,5179,5532,5917
1531,25,MISSOURI,BOONE,28811,28426,59609,48.3333053733497%,47.687429750541%,41125,36200,83868,49.0353889445319%,43.1630657700196%,50064,38646,91168,54.9140049140049%,42.3898736398736%,0.496636790887014,0.468153895893954,0.435644234020967,57237,77325,88710
1532,25,MISSOURI,BUCHANAN,17085,16423,34751,49.164052833012%,47.2590716813905%,12013,21320,35659,33.6885498752068%,59.7885526795479%,13445,22450,36598,36.7369801628504%,61.3421498442538%,0.490121761967291,0.639606396063961,0.62543529739518,33508,33333,35895
1533,25,MISSOURI,BUTLER,4996,9111,14397,34.7016739598527%,63.2840175036466%,3036,13650,17259,17.5908221797323%,79.0891708673736%,3301,14602,18141,18.196350807563%,80.4917038751998%,0.645849578223577,0.818051060769507,0.815617494274703,14107,16686,17903
1534,25,MISSOURI,CALDWELL,1488,2220,3850,38.6493506493507%,57.6623376623377%,838,3232,4312,19.4341372912801%,74.9536178107607%,897,3725,4682,19.158479282358%,79.5600170867151%,0.598705501618123,0.794103194103194,0.80592816962354,3708,4070,4622
1535,25,MISSOURI,CALLAWAY,6708,8238,15308,43.8202247191011%,53.8149986934936%,4989,13057,19193,25.9938519251811%,68.0300109414891%,5870,14815,21144,27.7620128641695%,70.0671585319712%,0.551184263348053,0.723539842624404,0.716219482716945,14946,18046,20685
1536,25,MISSOURI,CAMDEN,6323,10358,17099,36.9787706883443%,60.5766419088836%,4768,16944,22514,21.1779337301235%,75.2598383228214%,5652,18850,24812,22.7793003385459%,75.9713042076415%,0.620945986451652,0.780397936624908,0.769324953065056,16681,21712,24502
1537,25,MISSOURI,CAPE GIRARDEAU,9334,19832,29859,31.260256539067%,66.4188351920694%,8492,27017,37038,22.9278038770992%,72.9440034559102%,10760,28907,40328,26.6812140448324%,71.6797262447927%,0.67996982788178,0.760849362133544,0.728741775279199,29166,35509,39667
1538,25,MISSOURI,CARROLL,1620,2880,4581,35.3634577603143%,62.8683693516699%,745,3480,4361,17.0832377894978%,79.7982114193992%,786,3706,4532,17.3433362753751%,81.7740511915269%,0.64,0.823668639053254,0.825022261798753,4500,4225,4492
1539,25,MISSOURI,CARTER,997,1730,2808,35.505698005698%,61.6096866096866%,436,2324,2844,15.3305203938115%,81.7158931082982%,418,2451,2897,14.4287193648602%,84.6047635484985%,0.634396773010634,0.842028985507246,0.854304635761589,2727,2760,2869
1540,25,MISSOURI,CASS,14921,20113,35869,41.5985948869497%,56.0734896428671%,14846,33098,50990,29.115512845656%,64.9107668170229%,19052,37197,57408,33.1870122630992%,64.7941053511706%,0.574099446252212,0.690347071583514,0.66129175629789,35034,47944,56249
1541,25,MISSOURI,CEDAR,1979,3530,5663,34.9461416210489%,62.3344517040438%,1011,5021,6288,16.0782442748092%,79.8505089058524%,1145,5788,7044,16.2549687677456%,82.1692220329358%,0.640769649664186,0.832393899204244,0.834847829222559,5509,6032,6933
1542,25,MISSOURI,CHARITON,1792,2300,4154,43.1391429947039%,55.3683196918633%,888,2950,3969,22.3733938019652%,74.3260267069791%,916,3111,4077,22.467500613196%,76.3061074319352%,0.562072336265885,0.7686294945284,0.772535386143531,4092,3838,4027
1543,25,MISSOURI,CHRISTIAN,7896,14824,23228,33.9934561735836%,63.8195281556742%,8508,30946,41531,20.4859020972286%,74.5130143748044%,11131,34920,46839,23.7643843805376%,74.5532569013002%,0.652464788732394,0.784356465757591,0.758289722264446,22720,39454,46051
1544,25,MISSOURI,CLARK,1812,1899,3802,47.6591267753814%,49.9473961073119%,724,2458,3215,22.5194401244168%,76.4541213063764%,678,2672,3394,19.9764289923394%,78.7271655863288%,0.511721907841552,0.772470144563168,0.797611940298507,3711,3182,3350
1545,25,MISSOURI,CLAY,39084,39083,80173,48.7495790353361%,48.7483317326282%,45304,57476,110176,41.1196630845193%,52.1674411850131%,59400,64605,126569,46.9309230538283%,51.043304442636%,0.499993603438791,0.559213854835571,0.520987056973509,78167,102780,124005
1546,25,MISSOURI,CLINTON,3994,4323,8531,46.8174891571914%,50.6740124252725%,2572,7067,10208,25.1959247648903%,69.2300156739812%,2896,7799,10888,26.5980896399706%,71.6293166789126%,0.519778766382109,0.733167341010478,0.729219261337073,8317,9639,10695
1547,25,MISSOURI,COLE,12056,20167,32775,36.7841342486651%,61.5316552250191%,10913,24616,37374,29.1994434633703%,65.8639696045379%,12694,26086,39529,32.1131321308406%,65.9920564648739%,0.625857306892592,0.69284246671733,0.672666322846828,32223,35529,38780
1548,25,MISSOURI,COOPER,2567,4072,6790,37.8055964653903%,59.9705449189985%,1932,5624,7986,24.1923365890308%,70.4232406711746%,2249,6272,8693,25.8713907741861%,72.1500057517543%,0.613345383340865,0.744309158284807,0.736063842272034,6639,7556,8521
1549,25,MISSOURI,CRAWFORD,3350,4754,8302,40.3517224765117%,57.2633100457721%,1824,7724,9696,18.8118811881188%,79.6617161716172%,2113,8725,10973,19.2563565114372%,79.5133509523376%,0.586623889437315,0.808965228320067,0.805037829857907,8104,9548,10838
1550,25,MISSOURI,DADE,1193,2468,3752,31.7963752665245%,65.7782515991471%,637,3184,3951,16.1225006327512%,80.5871931156669%,656,3414,4119,15.9261956785628%,82.884195193008%,0.674132750614586,0.833289714734363,0.838820638820639,3661,3821,4070
1551,25,MISSOURI,DALLAS,2311,3723,6219,37.1603151632095%,59.8649300530632%,1272,5895,7453,17.0669529048705%,79.0956661746948%,1380,6619,8104,17.0286278381046%,81.6757156959526%,0.617003646005966,0.822519882796149,0.827478434804351,6034,7167,7999
1552,25,MISSOURI,DAVIESS,1367,2011,3494,39.1242129364625%,57.5558099599313%,730,2767,3593,20.3172836070136%,77.0108544391873%,746,3102,3911,19.0744055228842%,79.3147532600358%,0.595322676139728,0.791249642550758,0.806133056133056,3378,3497,3848
1553,25,MISSOURI,DEKALB,1562,2363,4049,38.5774265250679%,58.3600889108422%,824,3540,4594,17.9364388332608%,77.0570309098825%,930,3828,4843,19.2029733636176%,79.0419161676647%,0.60203821656051,0.811182401466544,0.80453972257251,3925,4364,4758
1554,25,MISSOURI,DENT,1839,3996,5988,30.7114228456914%,66.7334669338677%,978,5600,6791,14.4014136356943%,82.4620821675747%,1056,5987,7142,14.7857742929152%,83.8280593671241%,0.684832904884319,0.851322590453025,0.850063893227318,5835,6578,7043
1555,25,MISSOURI,DOUGLAS,1546,3599,5281,29.2747585684529%,68.1499715962886%,984,5486,6666,14.7614761476148%,82.2982298229823%,1016,5898,7000,14.5142857142857%,84.2571428571429%,0.699514091350826,0.847913446676971,0.853051778999132,5145,6470,6914
1556,25,MISSOURI,DUNKLIN,4947,5426,10525,47.0023752969121%,51.5534441805226%,2360,8026,10578,22.3104556626962%,75.8744564189828%,2200,8135,10419,21.1152701794798%,78.0785104136673%,0.523088788200135,0.772771037935683,0.787131107885825,10373,10386,10335
1557,25,MISSOURI,FRANKLIN,16172,21863,39194,41.2614175639128%,55.7814971679339%,12341,35430,50113,24.626344461517%,70.700217508431%,14569,38058,53685,27.137934246065%,70.8913104219056%,0.574812672538451,0.741663352242993,0.723164915347635,38035,47771,52627
1558,25,MISSOURI,GASCONADE,2257,4190,6629,34.0473676270931%,63.2071202292955%,1520,5670,7445,20.4163868368032%,76.1584956346541%,1601,6222,7923,20.2069923008961%,78.530859522908%,0.649914689002637,0.788595271210014,0.795347053560015,6447,7190,7823
1559,25,MISSOURI,GENTRY,1271,1771,3105,40.9339774557166%,57.037037037037%,605,2304,3043,19.8816956950378%,75.7147551758133%,613,2581,3237,18.9372876119864%,79.7343219029966%,0.582182774490467,0.792024750773462,0.808077645585473,3042,2909,3194
1560,25,MISSOURI,GREENE,41091,59178,102926,39.9228571983755%,57.4956765054505%,42728,78035,129231,33.0632742917721%,60.3841183616934%,55068,83630,141800,38.8349788434415%,58.9774330042313%,0.590192382491099,0.646183019633497,0.602964714703889,100269,120763,138698
1561,25,MISSOURI,GRUNDY,1563,2976,4708,33.1988105352591%,63.2115548003398%,780,3462,4310,18.0974477958237%,80.3248259860789%,799,3585,4437,18.007662835249%,80.7978363759297%,0.655651024454726,0.816124469589816,0.817746350364963,4539,4242,4384
1562,25,MISSOURI,HARRISON,1328,2552,3991,33.2748684540215%,63.9438737158607%,574,2965,3689,15.5597722960152%,80.3740851179181%,597,3198,3826,15.6037637219028%,83.5859905906952%,0.657731958762887,0.83780729019497,0.842687747035573,3880,3539,3795
1563,25,MISSOURI,HENRY,4459,5120,9778,45.6023726733483%,52.3624463080385%,2357,7075,9866,23.8901277113318%,71.7109264139469%,2619,8027,10788,24.2769744160178%,74.4067482387838%,0.534502557678255,0.750106022052587,0.753992109712568,9579,9432,10646
1564,25,MISSOURI,HICKORY,1961,2172,4238,46.271826333176%,51.2505899008966%,1016,3542,4724,21.5071972904318%,74.9788314987299%,1056,3966,5080,20.7874015748031%,78.0708661417323%,0.525526252117106,0.777095217200527,0.789725209080048,4133,4558,5022
1565,25,MISSOURI,HOLT,871,1738,2662,32.7197595792637%,65.2892561983471%,347,1926,2355,14.7346072186837%,81.7834394904459%,338,1976,2343,14.4259496372172%,84.3363209560393%,0.666155615178229,0.847338319401672,0.853932584269663,2609,2273,2314
1566,25,MISSOURI,HOWARD,1944,2414,4512,43.0851063829787%,53.5017730496454%,1283,3277,4868,26.3557929334429%,67.317173377157%,1413,3553,5092,27.7494108405342%,69.7761194029851%,0.553923818265259,0.718640350877193,0.715465163109142,4358,4560,4966
1567,25,MISSOURI,HOWELL,4641,9018,14075,32.9733570159858%,64.0710479573712%,2881,13893,17455,16.505299341163%,79.5932397593813%,3218,15181,18650,17.254691689008%,81.3994638069705%,0.660224028113332,0.828246095147252,0.825099190173379,13659,16774,18399
1568,25,MISSOURI,IRON,2044,2237,4414,46.3072043497961%,50.6796556411418%,933,3173,4269,21.8552354181307%,74.3265401733427%,945,3596,4592,20.5792682926829%,78.3101045296167%,0.522541462275169,0.772771553823673,0.791896058136974,4281,4106,4541
1569,25,MISSOURI,JACKSON,160419,104418,272062,58.9641331755262%,38.380222155244%,71237,91557,173275,41.1121050353484%,52.8391285528784%,92182,100142,196418,46.9315439521836%,50.9841256911281%,0.39427270358749,0.562410162536703,0.520694245128013,264837,162794,192324
1570,25,MISSOURI,JASPER,11737,24899,37481,31.3145326965663%,66.4309917024626%,10572,35070,48326,21.8764226296404%,72.5696312543972%,13549,37728,52352,25.8805776283619%,72.0660146699266%,0.679632055901299,0.768371237018536,0.73576847319461,36636,45642,51277
1571,25,MISSOURI,JEFFERSON,38616,36766,77204,50.018133775452%,47.6218848764313%,31568,69036,106238,29.7144148044956%,64.9823980120108%,37523,77046,116688,32.1566913478678%,66.0273549979432%,0.487729166113926,0.686215259830623,0.672485576377554,75382,100604,114569
1572,25,MISSOURI,JOHNSON,6926,9339,16787,41.2581163995949%,55.6323345445881%,5930,13719,21132,28.0617073632406%,64.9204997160704%,6974,15489,23123,30.16044630887%,66.9852527786187%,0.574177682139563,0.69820347091455,0.689533900191426,16265,19649,22463
1573,25,MISSOURI,KANSAS CITY,0,0,0,#DIV/0!,#DIV/0!,97735,24654,128601,75.9986314258832%,19.1709240208085%,107660,26393,136645,78.7881005525266%,19.3150133557759%,#DIV/0!,0.201439671865936,0.196884814215273,0,122389,134053
1574,25,MISSOURI,KNOX,787,1226,2055,38.2968369829684%,59.6593673965937%,379,1416,1870,20.2673796791444%,75.7219251336898%,340,1486,1854,18.3387270765912%,80.151024811219%,0.609041231992052,0.788857938718663,0.813800657174151,2013,1795,1826
1575,25,MISSOURI,LACLEDE,4183,8556,13046,32.0634677295723%,65.5833205580255%,2553,12881,16051,15.905551056009%,80.2504516852533%,2780,13762,16793,16.5545167629369%,81.9508128386828%,0.671638276159824,0.834585979007386,0.831942933139886,12739,15434,16542
1576,25,MISSOURI,LAFAYETTE,6343,7849,14520,43.6845730027548%,54.0564738292011%,4053,10988,15876,25.5291005291005%,69.2113882590073%,4472,12273,17055,26.2210495455878%,71.9613016710642%,0.553058060879369,0.730536533475168,0.732935204538668,14192,15041,16745
1577,25,MISSOURI,LAWRENCE,4235,8305,12903,32.8218243819267%,64.3648763853367%,2901,13089,16715,17.3556685611726%,78.3069099611128%,3214,14426,17905,17.950293214186%,80.5696732756213%,0.662280701754386,0.818574108818011,0.817800453514739,12540,15990,17640
1578,25,MISSOURI,LEWIS,2023,2388,4484,45.1159678858162%,53.2560214094559%,934,3344,4456,20.9605026929982%,75.0448833034111%,984,3553,4609,21.3495335213712%,77.0883054892602%,0.541373838131943,0.781673679289388,0.783116596870179,4411,4278,4537
1579,25,MISSOURI,LINCOLN,6961,8549,15913,43.7441085904606%,53.723370828882%,5575,18159,24962,22.3339476003525%,72.7465747936864%,6607,21848,29018,22.7686263698394%,75.2911985664071%,0.551192778852353,0.765104912783349,0.767808820945352,15510,23734,28455
1580,25,MISSOURI,LINN,2646,3246,6010,44.026622296173%,54.0099833610649%,1240,4088,5587,22.1943798102739%,73.1698586003222%,1275,4363,5726,22.2668529514495%,76.1962975899406%,0.55091649694501,0.767267267267267,0.773855977296914,5892,5328,5638
1581,25,MISSOURI,LIVINGSTON,2425,3709,6276,38.6392606755895%,59.0981516889739%,1265,4879,6421,19.7009811555832%,75.9850490577792%,1410,5267,6758,20.864160994377%,77.9372595442439%,0.604662536680796,0.794108072916667,0.788827317657631,6134,6144,6677
1582,25,MISSOURI,MACON,2817,4232,7175,39.2613240418118%,58.9825783972126%,1548,5798,7621,20.3122949744128%,76.0792546909854%,1662,6076,7836,21.2098009188361%,77.5395610005105%,0.600368846644914,0.78927307378165,0.785215818040837,7049,7346,7738
1583,25,MISSOURI,MADISON,1828,2460,4373,41.8019666133089%,56.2542876743654%,1005,4102,5321,18.887427175343%,77.0907724112009%,1019,4584,5676,17.9527836504581%,80.7610993657505%,0.573694029850746,0.803211278637165,0.818133142959129,4288,5107,5603
1584,25,MISSOURI,MARIES,1554,2216,3854,40.3217436429683%,57.4987026466009%,794,3561,4500,17.6444444444444%,79.1333333333333%,814,3892,4771,17.0614127017397%,81.5761894780968%,0.587798408488064,0.81768082663605,0.827029324266893,3770,4355,4706
1585,25,MISSOURI,MARION,4993,6550,11712,42.6314890710383%,55.9255464480874%,2994,9419,12938,23.1411346421394%,72.8010511671047%,3202,9915,13348,23.9886125262212%,74.2807911297573%,0.567443472234254,0.758801256746959,0.755889303956697,11543,12413,13117
1586,25,MISSOURI,MCDONALD,1866,4460,6529,28.5801807321182%,68.3106141828764%,1329,6599,8242,16.1247270080078%,80.0655180781364%,1439,7465,9053,15.8952833314923%,82.4588534187562%,0.705026873221625,0.83236629667003,0.838387241689128,6326,7928,8904
1587,25,MISSOURI,MERCER,555,1250,1842,30.1302931596091%,67.8610206297503%,216,1486,1745,12.378223495702%,85.1575931232092%,222,1541,1779,12.4789207419899%,86.6216975829117%,0.692520775623269,0.873090481786134,0.874078275666477,1805,1702,1763
1588,25,MISSOURI,MILLER,3217,5945,9356,34.3843522873023%,63.5421120136811%,1750,9285,11416,15.3293622985284%,81.333216538192%,2038,10176,12382,16.4593765142949%,82.1838152156356%,0.648875791311941,0.841413683733575,0.833142295726216,9162,11035,12214
1589,25,MISSOURI,MISSISSIPPI,2756,2395,5215,52.8475551294343%,45.9252157238734%,1458,3600,5169,28.2066163668021%,69.6459663377829%,1178,3537,4756,24.7687132043734%,74.3692178301093%,0.464958260531936,0.711743772241993,0.750159066808059,5151,5058,4715
1590,25,MISSOURI,MONITEAU,2176,3764,6065,35.8779884583677%,62.0610057708162%,1237,5347,6830,18.1112737920937%,78.2869692532943%,1308,5744,7157,18.2758138885008%,80.2570909598994%,0.633670033670034,0.812120291616039,0.814520703346568,5940,6584,7052
1591,25,MISSOURI,MONROE,1860,2175,4094,45.4323400097704%,53.1265266243283%,853,3159,4156,20.5245428296439%,76.0105871029836%,936,3477,4483,20.8788757528441%,77.5596698639304%,0.539033457249071,0.787387836490528,0.787899388171312,4035,4012,4413
1592,25,MISSOURI,MONTGOMERY,2092,3106,5303,39.4493682821045%,58.5706204035452%,1119,4127,5429,20.6115306686314%,76.0176828145146%,1208,4465,5772,20.9286209286209%,77.3562023562023%,0.597537514428626,0.786694624475791,0.78706151947823,5198,5246,5673
1593,25,MISSOURI,MORGAN,3235,4460,7881,41.048090343865%,56.5918030706763%,1768,6760,8821,20.0430790159846%,76.635302119941%,1924,7442,9487,20.2803836829345%,78.4441867819121%,0.57959714100065,0.792682926829268,0.794576126414691,7695,8528,9366
1594,25,MISSOURI,NEW MADRID,3738,3416,7266,51.4450867052023%,47.0134874759152%,1933,5270,7357,26.2742965882833%,71.6324588826968%,1748,5447,7250,24.1103448275862%,75.1310344827586%,0.477495107632094,0.731639594613356,0.757053509381515,7154,7203,7195
1595,25,MISSOURI,NEWTON,6447,14232,21162,30.4649844060108%,67.2526226254607%,4990,20553,26606,18.7551680072164%,77.2494925956551%,5818,22120,28405,20.4823094525612%,77.8736138003873%,0.68823444073698,0.804643150765376,0.791753167728542,20679,25543,27938
1596,25,MISSOURI,NODAWAY,3553,5161,9049,39.2640070726047%,57.0339264007073%,2529,6380,9458,26.7392683442588%,67.4561218016494%,2853,6865,9893,28.8385727281917%,69.3924997472961%,0.592265320174432,0.716129756426086,0.706421074295122,8714,8909,9718
1597,25,MISSOURI,OREGON,1568,2521,4233,37.0422867942358%,59.5558705409875%,865,3671,4668,18.5304198800343%,78.6418166238218%,823,3847,4739,17.3665330238447%,81.1774635999156%,0.616532159452189,0.809303350970018,0.823768736616702,4089,4536,4670
1598,25,MISSOURI,OSAGE,1938,4154,6178,31.3693752023309%,67.2385885399806%,998,5856,7090,14.0761636107193%,82.5952045133992%,1037,6425,7539,13.755139938984%,85.2235044435601%,0.681877872619829,0.854391596148234,0.861029214687751,6092,6854,7462
1599,25,MISSOURI,OZARK,1432,2663,4292,33.3643988816403%,62.0456663560112%,724,3639,4505,16.0710321864595%,80.7769145394007%,752,4064,4864,15.4605263157895%,83.5526315789474%,0.65030525030525,0.834059133623653,0.843853820598007,4095,4363,4816
1600,25,MISSOURI,PEMISCOT,3245,2750,6060,53.5478547854785%,45.3795379537954%,1947,3964,6027,32.3046291687407%,65.7706985233118%,1560,4120,5735,27.2013949433304%,71.8395815170009%,0.458715596330275,0.670614109287769,0.725352112676056,5995,5911,5680
1601,25,MISSOURI,PERRY,2085,4667,6903,30.2042590178183%,67.6082862523541%,1520,6908,8740,17.3913043478261%,79.0389016018307%,1664,7657,9447,17.6140573727109%,81.0521858791151%,0.691202606635071,0.819648789748458,0.821478382147838,6752,8428,9321
1602,25,MISSOURI,PETTIS,5855,9533,15755,37.1628054585846%,60.5077753094256%,4324,12810,18111,23.8749930981172%,70.7304952791121%,4783,13854,19097,25.0458187149814%,72.5454259831387%,0.619508708084221,0.747636278744018,0.743359982829855,15388,17134,18637
1603,25,MISSOURI,PHELPS,6262,9444,16146,38.7835996531649%,58.4912671869194%,4766,12709,18553,25.6885678865952%,68.501051042958%,5637,13480,19568,28.8072363041701%,68.8879803761243%,0.601298866675156,0.727267525035765,0.705131558298896,15706,17475,19117
1604,25,MISSOURI,PIKE,3557,3648,7351,48.3879744252483%,49.6259012379268%,1806,5274,7382,24.4649146572744%,71.4440531021403%,1717,5863,7695,22.3131903833658%,76.1923326835607%,0.506315058986815,0.744915254237288,0.773482849604222,7205,7080,7580
1605,25,MISSOURI,PLATTE,15325,17785,34054,45.0020555588184%,52.2258765490104%,20057,25933,48885,41.0289454842999%,53.048992533497%,27179,28917,57270,47.4576567138118%,50.4924044002095%,0.537148897614014,0.563883452924549,0.515491300627496,33110,45990,56096
1606,25,MISSOURI,POLK,3606,6430,10294,35.0301146298815%,62.4635710122401%,2631,10438,13763,19.1164716994841%,75.841023032769%,2885,11850,15064,19.151619755709%,78.6643653744026%,0.640693503387804,0.79868390848573,0.804207668815745,10036,13069,14735
1607,25,MISSOURI,PULASKI,3800,6531,10531,36.0839426455227%,62.0169024783971%,2922,9876,13488,21.6637010676157%,73.220640569395%,3740,10329,14414,25.9469959761343%,71.6594977105592%,0.632175007259704,0.771683075480544,0.734167318217357,10331,12798,14069
1608,25,MISSOURI,PUTNAM,708,1593,2334,30.3341902313625%,68.2519280205656%,353,1936,2346,15.0468883205456%,82.5234441602728%,361,1984,2361,15.2901313002965%,84.0321897501059%,0.692307692307692,0.845784185233727,0.846055437100213,2301,2289,2345
1609,25,MISSOURI,RALLS,2033,2446,4542,44.7600176133862%,53.8529282254513%,1138,3969,5266,21.6103304215724%,75.3703000379795%,1205,4396,5662,21.2822324267043%,77.6404097492052%,0.546104041080598,0.777168592128451,0.78485984645599,4479,5107,5601
1610,25,MISSOURI,RANDOLPH,4116,4844,9186,44.8073154800784%,52.7324188983235%,2283,7529,10309,22.1456979338442%,73.0332718983413%,2485,8018,10744,23.1291883842144%,74.6276991809382%,0.540625,0.76732572360375,0.763400933066743,8960,9812,10503
1611,25,MISSOURI,RAY,4970,4517,9747,50.9900482199651%,46.3424643480045%,3090,7104,10869,28.4294783328733%,65.360198730334%,3109,8345,11649,26.6889861790712%,71.6370503905915%,0.476125223990724,0.696880517951736,0.72856643967173,9487,10194,11454
1612,25,MISSOURI,REYNOLDS,1298,1762,3131,41.4564037048866%,56.2759501756627%,540,2406,3038,17.7748518762344%,79.1968400263331%,529,2733,3298,16.0400242571255%,82.8684050939964%,0.575816993464052,0.816700610997963,0.837829552421827,3060,2946,3262
1613,25,MISSOURI,RIPLEY,1820,3121,5065,35.9328726554788%,61.6189536031589%,830,4522,5524,15.0253439536568%,81.8609703113686%,833,4839,5717,14.5705789749869%,84.6422949099178%,0.631653511434932,0.8449177877429,0.853138222849083,4941,5352,5672
1614,25,MISSOURI,SALINE,4585,4572,9355,49.0112239444148%,48.8722608230893%,2789,5977,9274,30.0733232693552%,64.4489971964632%,2904,6451,9519,30.5074062401513%,67.7697237104738%,0.499290160532926,0.681838923112024,0.689577765900588,9157,8766,9355
1615,25,MISSOURI,SCHUYLER,808,1159,2006,40.2791625124626%,57.7766699900299%,354,1505,1936,18.2851239669421%,77.7376033057851%,373,1606,2003,18.6220668996505%,80.1797304043934%,0.589222165734621,0.809575040344271,0.811520970186963,1967,1859,1979
1616,25,MISSOURI,SCOTLAND,790,1335,2179,36.2551629187701%,61.2666360715925%,365,1525,1968,18.5467479674797%,77.489837398374%,388,1560,1984,19.5564516129032%,78.6290322580645%,0.628235294117647,0.806878306878307,0.80082135523614,2125,1890,1948
1617,25,MISSOURI,SCOTT,6452,8999,15704,41.0850738665308%,57.3038716250637%,3575,13168,17256,20.7174316179879%,76.3096893834029%,3753,13769,17719,21.1806535357526%,77.7075455725492%,0.582421849718465,0.786477931075673,0.785812121903892,15451,16743,17522
1618,25,MISSOURI,SHANNON,1430,2245,3781,37.8206823591642%,59.3758265009257%,776,2966,3904,19.8770491803279%,75.9733606557377%,706,3165,3906,18.0747567844342%,81.0291858678955%,0.610884353741497,0.792624265098878,0.817618186515112,3675,3742,3871
1619,25,MISSOURI,SHELBY,1262,1936,3257,38.7473134786613%,59.4412035615597%,606,2524,3255,18.6175115207373%,77.542242703533%,592,2700,3350,17.6716417910448%,80.5970149253731%,0.605378361475923,0.806389776357828,0.820170109356014,3198,3130,3292
1620,25,MISSOURI,ST. CHARLES,53806,72114,128686,41.8118521051241%,56.0387299317719%,68626,121650,201005,34.1414392676799%,60.5208825651103%,89530,128389,222017,40.3257408216488%,57.8284545778026%,0.572696950444727,0.639334440496962,0.589159274776408,125920,190276,217919
1621,25,MISSOURI,ST. CLAIR,1866,2731,4739,39.3753956530914%,57.6281916016037%,936,3501,4630,20.2159827213823%,75.6155507559395%,988,3932,4974,19.8632891033374%,79.0510655408122%,0.594083097672395,0.789046653144016,0.799186991869919,4597,4437,4920
1622,25,MISSOURI,ST. FRANCOIS,9075,9327,18841,48.1662332147975%,49.5037418396051%,6250,17468,24728,25.2749919120026%,70.6405693950178%,7044,20511,28001,25.1562444198421%,73.2509553230242%,0.506847081838931,0.736487056244203,0.744365813826892,18402,23718,27555
1623,25,MISSOURI,ST. LOUIS CITY,96557,24799,124752,77.3991599333077%,19.8786392202129%,104235,20832,131191,79.4528588089122%,15.8791380506285%,110089,21474,133867,82.2375940298953%,16.0412947178916%,0.20434918751442,0.166566720237952,0.163222182528522,121356,125067,131563
1624,25,MISSOURI,ST. LOUIS COUNTY,250631,224689,486884,51.4765323978607%,46.1483638813352%,286704,202434,514858,55.6860338190336%,39.3184140092997%,328151,199493,536446,61.1713014916692%,37.1878996208379%,0.472711015736767,0.413858665652638,0.378082570824268,475320,489138,527644
1625,25,MISSOURI,STE. GENEVIEVE,3600,3505,7311,49.2408699220353%,47.9414580768705%,2542,5496,8469,30.015350100366%,64.8955012398158%,2713,6630,9484,28.6060733867566%,69.9072121467735%,0.493314567206193,0.683752177158497,0.709622177030932,7105,8038,9343
1626,25,MISSOURI,STODDARD,4476,7727,12454,35.9402601573792%,62.0443231090413%,1876,11079,13291,14.1148145361523%,83.3571589797607%,1819,11484,13426,13.5483390436467%,85.5355280798451%,0.633204949602557,0.855191045928213,0.863263925430354,12203,12955,13303
1627,25,MISSOURI,STONE,4055,7793,12151,33.3717389515266%,64.1346391243519%,2887,13158,16567,17.4262087281946%,79.4229492364339%,3506,14800,18483,18.9687821241141%,80.0735811286047%,0.657748143146523,0.820068557182923,0.808478094613788,11848,16045,18306
1628,25,MISSOURI,SULLIVAN,1127,1877,3064,36.7819843342037%,61.2597911227154%,526,1884,2486,21.1584875301689%,75.7843925985519%,478,1974,2471,19.3443949817887%,79.8866855524079%,0.624833555259654,0.781742738589212,0.805057096247961,3004,2410,2452
1629,25,MISSOURI,TANEY,5092,9647,15112,33.6950767601906%,63.8366860772896%,4373,18276,23515,18.5966404422709%,77.7206038698703%,5339,20508,26288,20.3096469872185%,78.0127814972611%,0.654522016419024,0.806923042959954,0.793438310055326,14739,22649,25847
1630,25,MISSOURI,TEXAS,3486,6136,9932,35.0986709625453%,61.7801047120419%,1728,8875,10956,15.7721796276013%,81.0058415480102%,1716,9478,11315,15.1657092355281%,83.7649138311975%,0.637705258781958,0.837027256436858,0.846703591209577,9622,10603,11194
1631,25,MISSOURI,VERNON,3156,4985,8408,37.5356803044719%,59.2887725975262%,1707,6533,8599,19.8511454820328%,75.9739504593558%,1903,7155,9185,20.7185628742515%,77.8987479586282%,0.612332637268149,0.792839805825243,0.789909472289689,8141,8240,9058
1632,25,MISSOURI,WARREN,4524,5979,10740,42.122905027933%,55.6703910614525%,3915,11111,15784,24.8035985808414%,70.3940699442473%,4769,13222,18375,25.9537414965986%,71.956462585034%,0.569265924021708,0.739451617196859,0.734923017064088,10503,15026,17991
1633,25,MISSOURI,WASHINGTON,4047,4020,8265,48.9655172413793%,48.6388384754991%,1926,7048,9282,20.7498383968972%,75.9319112260289%,1804,8047,9976,18.0834001603849%,80.6635926222935%,0.498326515433247,0.785379986628037,0.816871383615876,8067,8974,9851
1634,25,MISSOURI,WAYNE,2387,3346,5848,40.8173734610123%,57.2161422708618%,948,4658,5655,16.763925729443%,82.36958443855%,845,4987,5878,14.3756379720994%,84.8417829193603%,0.583638583638584,0.830895469140207,0.855109739368999,5733,5606,5832
1635,25,MISSOURI,WEBSTER,4174,7350,11880,35.1346801346801%,61.8686868686869%,3177,12840,16743,18.9750940691632%,76.6887654542197%,3573,14880,18779,19.0265722349433%,79.237446083391%,0.637799375216938,0.801648248735718,0.806372947488213,11524,16017,18453
1636,25,MISSOURI,WORTH,469,651,1158,40.5008635578584%,56.2176165803109%,195,808,1046,18.6424474187381%,77.2466539196941%,215,877,1107,19.4218608852755%,79.223125564589%,0.58125,0.805583250249252,0.803113553113553,1120,1003,1092
1637,25,MISSOURI,WRIGHT,2250,5391,7841,28.6953194745568%,68.7539854610381%,1170,6707,8119,14.4106417046434%,82.6086956521739%,1168,7453,8739,13.3653736125415%,85.2843574779723%,0.705535924617197,0.85146629427447,0.864516877392414,7641,7877,8621
1639,26,MONTANA,BEAVERHEAD,799,3113,4196,19.0419447092469%,74.1897044804576%,1143,3353,4849,23.5718704887606%,69.148277995463%,1608,3923,5661,28.404875463699%,69.2987104751811%,0.795756646216769,0.745774021352313,0.709274995480022,3912,4496,5531
1640,26,MONTANA,BIG HORN,2345,1651,4161,56.3566450372507%,39.6779620283586%,2094,1853,4237,49.4217606797262%,43.733773896625%,2491,2207,4784,52.069397993311%,46.1329431438127%,0.413163163163163,0.469470483911832,0.469774372073223,3996,3947,4698
1641,26,MONTANA,BLAINE,1246,1410,2759,45.1612903225806%,51.1054729974629%,1202,1268,2684,44.7839046199702%,47.2429210134128%,1589,1469,3117,50.9785049727302%,47.1286493423163%,0.530873493975904,0.51336032388664,0.480379332897318,2656,2470,3058
1642,26,MONTANA,BROADWATER,462,1488,2074,22.2757955641273%,71.7454194792671%,573,2348,3133,18.2891796999681%,74.9441429939355%,835,3173,4097,20.3807664144496%,77.4469123749085%,0.763076923076923,0.803834303320781,0.791666666666667,1950,2921,4008
1643,26,MONTANA,CARBON,1434,3008,4789,29.9436207976613%,62.8106076425141%,1828,3748,5991,30.5124353196461%,62.5605074278084%,2421,4468,7052,34.3306863301191%,63.3579126488939%,0.677172444844665,0.672166427546628,0.648570184351865,4442,5576,6889
1644,26,MONTANA,CARTER,53,573,645,8.21705426356589%,88.8372093023256%,70,678,786,8.9058524173028%,86.2595419847328%,74,775,864,8.56481481481482%,89.6990740740741%,0.915335463258786,0.906417112299465,0.91283863368669,626,748,849
1645,26,MONTANA,CASCADE,13137,18164,33317,39.43032085722%,54.5187141699433%,12175,19632,34571,35.2173787278355%,56.7874808365393%,15456,23315,39885,38.7514103046258%,58.4555597342359%,0.580300948851474,0.617222623950703,0.601351525624823,31301,31807,38771
1646,26,MONTANA,CHOUTEAU,686,2039,2885,23.7781629116118%,70.6759098786828%,732,1679,2603,28.1213983864771%,64.5024971187092%,991,1891,2965,33.4232715008432%,63.7774030354132%,0.748256880733945,0.696391538780589,0.656141568355309,2725,2411,2882
1647,26,MONTANA,CUSTER,1501,3156,4905,30.6014271151886%,64.3425076452599%,1176,3657,5185,22.6808100289296%,70.5303760848602%,1514,4205,5860,25.8361774744027%,71.7576791808874%,0.677689499677904,0.75667287399131,0.735268403567057,4657,4833,5719
1648,26,MONTANA,DANIELS,303,750,1110,27.2972972972973%,67.5675675675676%,168,730,962,17.4636174636175%,75.8835758835759%,195,799,1014,19.2307692307692%,78.7968441814596%,0.712250712250712,0.812917594654788,0.803822937625755,1053,898,994
1649,26,MONTANA,DAWSON,1364,2723,4271,31.9363146804027%,63.7555607586045%,787,3320,4374,17.9926840420668%,75.9030635573845%,962,3758,4825,19.9378238341969%,77.8860103626943%,0.666258869586494,0.808375943511079,0.796186440677966,4087,4107,4720
1650,26,MONTANA,DEER LODGE,2672,1493,4534,58.932509925011%,32.9289810322012%,2058,1763,4206,48.9300998573467%,41.9163100332858%,2562,2186,4891,52.3819259865058%,44.6943365364956%,0.358463385354142,0.461397539911018,0.460404380791912,4165,3821,4748
1651,26,MONTANA,FALLON,256,1061,1369,18.699780861943%,77.5018261504748%,154,1279,1484,10.377358490566%,86.1859838274933%,172,1375,1575,10.9206349206349%,87.3015873015873%,0.805618830675778,0.892533147243545,0.888817065287653,1317,1433,1547
1652,26,MONTANA,FERGUS,1352,4353,5994,22.5558892225559%,72.6226226226226%,1202,4269,5840,20.5821917808219%,73.0993150684932%,1496,4869,6507,22.990625480252%,74.8271092669433%,0.763014899211218,0.780296106744654,0.76496465043205,5705,5471,6365
1653,26,MONTANA,FLATHEAD,8329,22519,33839,24.6136115133426%,66.5474748071752%,13293,30240,46571,28.5435142041184%,64.9331128814069%,20274,38321,59936,33.8260811532301%,63.9365323011212%,0.729998703319502,0.694645441389291,0.653997781380664,30848,43533,58595
1654,26,MONTANA,GALLATIN,10009,18833,32040,31.2390761548065%,58.7796504369538%,24246,23802,53819,45.0510042921645%,44.2260168342035%,37044,31696,70979,52.190084391158%,44.6554614745206%,0.652971361209348,0.49537962037962,0.461099796334012,28842,48048,68740
1655,26,MONTANA,GARFIELD,61,651,744,8.1989247311828%,87.5%,34,653,718,4.73537604456825%,90.9470752089137%,41,764,813,5.04305043050431%,93.9729397293973%,0.914325842696629,0.950509461426492,0.949068322981366,712,687,805
1656,26,MONTANA,GLACIER,2211,1709,4124,53.6129970902037%,41.4403491755577%,3121,1620,5075,61.4975369458128%,31.9211822660098%,3610,1884,5617,64.2691828378138%,33.5410361402884%,0.435969387755102,0.341700063277789,0.342919548598471,3920,4741,5494
1657,26,MONTANA,GOLDEN VALLEY,88,405,531,16.5725047080979%,76.271186440678%,71,365,474,14.9789029535865%,77.0042194092827%,78,414,503,15.506958250497%,82.3061630218688%,0.821501014198783,0.837155963302752,0.841463414634146,493,436,492
1658,26,MONTANA,GRANITE,295,1181,1590,18.5534591194969%,74.2767295597484%,472,1192,1777,26.5616207090602%,67.0793472144063%,638,1419,2102,30.3520456707897%,67.5071360608944%,0.800135501355014,0.716346153846154,0.689839572192513,1476,1664,2057
1659,26,MONTANA,HILL,2760,3392,6558,42.0860018298262%,51.7230863068009%,2371,3478,6445,36.7882079131109%,53.9643134212568%,2981,3957,7182,41.5065441381231%,55.0960735171262%,0.551365409622887,0.59463156095059,0.570337272989334,6152,5849,6938
1660,26,MONTANA,JEFFERSON,1513,3308,5163,29.3046678287817%,64.0712763896959%,1998,4177,6714,29.7587131367292%,62.2132856717307%,2625,5345,8151,32.2046374677954%,65.5747761010919%,0.686164696121137,0.676437246963563,0.670639899623589,4821,6175,7970
1661,26,MONTANA,JUDITH BASIN,278,1057,1394,19.9426111908178%,75.8249641319943%,235,872,1208,19.453642384106%,72.1854304635762%,275,1040,1344,20.4613095238095%,77.3809523809524%,0.791760299625468,0.787714543812105,0.790874524714829,1335,1107,1315
1662,26,MONTANA,LAKE,3884,6441,11448,33.9273235499651%,56.2631027253669%,4776,7530,13181,36.2339731431606%,57.1276837872696%,6916,9322,16626,41.5974978948635%,56.0688078912547%,0.623825665859564,0.611896635787421,0.574085478507205,10325,12306,16238
1663,26,MONTANA,LEWIS AND CLARK,9982,15091,27269,36.6056694414903%,55.3412299680956%,14478,16895,34478,41.9919948952956%,49.0022623121991%,19743,21409,42265,46.7124097953389%,50.6542056074766%,0.601882503090974,0.538520383769483,0.520242029548989,25073,31373,41152
1664,26,MONTANA,LIBERTY,243,752,1044,23.2758620689655%,72.0306513409962%,206,698,961,21.4360041623309%,72.6326742976067%,249,821,1083,22.9916897506925%,75.8079409048938%,0.755778894472362,0.77212389380531,0.767289719626168,995,904,1070
1665,26,MONTANA,LINCOLN,1629,5578,7846,20.7621718072903%,71.0935508539383%,2041,6729,9330,21.8756698821007%,72.1221864951769%,2835,8672,11747,24.1338214012088%,73.8231037711756%,0.773969751630359,0.7672748004561,0.753628226297037,7207,8770,11507
1666,26,MONTANA,MADISON,758,2656,3656,20.7330415754923%,72.6477024070022%,1180,3297,4778,24.6965257429887%,69.0037672666388%,1771,4191,6087,29.0947921800559%,68.8516510596353%,0.777973052138254,0.736430645521555,0.702952029520295,3414,4477,5962
1667,26,MONTANA,MCCONE,267,827,1142,23.3800350262697%,72.4168126094571%,154,862,1060,14.5283018867925%,81.3207547169811%,155,956,1128,13.741134751773%,84.7517730496454%,0.755941499085923,0.848425196850394,0.86048604860486,1094,1016,1111
1668,26,MONTANA,MEAGHER,176,698,935,18.8235294117647%,74.6524064171123%,193,729,977,19.7543500511771%,74.6161719549642%,258,833,1110,23.2432432432432%,75.0450450450451%,0.798627002288329,0.790672451193059,0.763519706691109,874,922,1091
1669,26,MONTANA,MINERAL,382,1078,1639,23.306894447834%,65.7718120805369%,519,1330,2012,25.7952286282306%,66.10337972167%,686,1828,2563,26.7655091689426%,71.3226687475615%,0.738356164383562,0.719307733910222,0.727128082736675,1460,1849,2514
1670,26,MONTANA,MISSOULA,17241,21474,46576,37.0169185846788%,46.1052902782549%,31543,22250,59203,53.2793946252724%,37.5825549380944%,43357,26347,71495,60.6434016364781%,36.8515280788866%,0.554668733049206,0.413622590299853,0.377984046826581,38715,53793,69704
1671,26,MONTANA,MUSSELSHELL,512,1582,2207,23.1989125509742%,71.6810149524241%,332,1967,2441,13.6009832036051%,80.5817287996723%,413,2423,2881,14.3353002429712%,84.1027421034363%,0.75549188156638,0.855589386689865,0.854372355430183,2094,2299,2836
1672,26,MONTANA,PARK,2154,4523,7406,29.0845260599514%,61.0721036997029%,3595,4980,9359,38.4122235281547%,53.2108131210599%,5280,6025,11566,45.6510461698081%,52.0923396161162%,0.677400029953572,0.580758017492711,0.532950022114109,6677,8575,11305
1673,26,MONTANA,PETROLEUM,36,254,306,11.7647058823529%,83.0065359477124%,30,278,322,9.3167701863354%,86.3354037267081%,39,298,348,11.2068965517241%,85.632183908046%,0.875862068965517,0.902597402597403,0.884272997032641,290,308,337
1674,26,MONTANA,PHILLIPS,423,1727,2228,18.9856373429084%,77.5134649910233%,318,1723,2171,14.6476278212805%,79.3643482266237%,416,1936,2382,17.4643157010915%,81.2762384550798%,0.803255813953488,0.844194022537972,0.82312925170068,2150,2041,2352
1675,26,MONTANA,PONDERA,792,1948,2896,27.3480662983425%,67.2651933701657%,738,1799,2723,27.1024605214837%,66.0668380462725%,903,2031,2995,30.1502504173623%,67.8130217028381%,0.710948905109489,0.709105242412298,0.692229038854806,2740,2537,2934
1676,26,MONTANA,POWDER RIVER,115,860,1008,11.4087301587302%,85.3174603174603%,127,884,1053,12.0607787274454%,83.9506172839506%,154,970,1136,13.556338028169%,85.387323943662%,0.882051282051282,0.874381800197824,0.862989323843416,975,1011,1124
1677,26,MONTANA,POWELL,638,1971,2832,22.5282485875706%,69.5974576271186%,551,2029,2794,19.7208303507516%,72.6198997852541%,752,2355,3179,23.6552374960679%,74.0798993394149%,0.755461862782675,0.786434108527132,0.757965883488896,2609,2580,3107
1678,26,MONTANA,PRAIRIE,164,541,746,21.9839142091153%,72.5201072386059%,100,556,689,14.5137880986938%,80.6966618287373%,126,603,744,16.9354838709677%,81.0483870967742%,0.767375886524823,0.847560975609756,0.82716049382716,705,656,729
1679,26,MONTANA,RAVALLI,4451,11241,17238,25.8208608887342%,65.2105812739297%,6223,14810,22556,27.5891115446001%,65.6588047526157%,8763,19114,28507,30.7398182902445%,67.0501981969341%,0.716352281417283,0.704131602719536,0.685654840908276,15692,21033,27877
1680,26,MONTANA,RICHLAND,1018,2858,4033,25.2417555169849%,70.8653607736177%,671,3908,4871,13.775405460891%,80.2299322521043%,875,4800,5798,15.0914108313211%,82.7871679889617%,0.737358101135191,0.853461454466041,0.845814977973568,3876,4579,5675
1681,26,MONTANA,ROOSEVELT,2059,1605,3813,53.9994754786258%,42.0928402832415%,1560,1797,3652,42.7163198247536%,49.2059145673604%,1910,1996,4017,47.5479213343291%,49.6888225043565%,0.438045851528384,0.535299374441466,0.511008704557092,3664,3357,3906
1682,26,MONTANA,ROSEBUD,1394,1826,3423,40.724510663161%,53.3450189891908%,987,2253,3453,28.5838401390096%,65.2476107732407%,1199,2486,3773,31.7784256559767%,65.8892128279883%,0.567080745341615,0.69537037037037,0.674626865671642,3220,3240,3685
1683,26,MONTANA,SANDERS,1165,3144,4721,24.676975217115%,66.5960601567465%,1218,4286,5953,20.4602721316983%,71.9973122795229%,1820,5660,7622,23.8782471792181%,74.2587247441616%,0.729635646321652,0.778706395348837,0.75668449197861,4309,5504,7480
1684,26,MONTANA,SHERIDAN,702,1176,1965,35.7251908396947%,59.8473282442748%,477,1241,1835,25.9945504087193%,67.6294277929155%,574,1403,2030,28.2758620689655%,69.1133004926108%,0.626198083067093,0.722351571594878,0.709661102680829,1878,1718,1977
1685,26,MONTANA,SILVER BOW,8967,6299,16703,53.6849667724361%,37.7117883015027%,8619,6376,16452,52.3887673231218%,38.7551665451009%,10392,7745,18658,55.6972880265838%,41.5103440883267%,0.412616271452902,0.425208402800934,0.427027623090919,15266,14995,18137
1686,26,MONTANA,STILLWATER,925,2765,3918,23.6089841755998%,70.5717202654416%,908,3661,4873,18.6332854504412%,75.1282577467679%,1156,4462,5724,20.1956673654787%,77.9524807826695%,0.749322493224932,0.801269424381703,0.794232823068708,3690,4569,5618
1687,26,MONTANA,SWEET GRASS,305,1450,1846,16.522210184182%,78.5482123510293%,402,1595,2107,19.0792596108211%,75.7000474608448%,549,1840,2446,22.4448078495503%,75.2248569092396%,0.826210826210826,0.798698047070606,0.77019673503558,1755,1997,2389
1688,26,MONTANA,TETON,847,2294,3314,25.5582377791189%,69.2214846107423%,808,2170,3188,25.34504391468%,68.0677540777917%,1007,2608,3679,27.3715683609676%,70.8888284860016%,0.730340655842088,0.728676964405641,0.721438450899032,3141,2978,3615
1689,26,MONTANA,TOOLE,630,1639,2378,26.4928511354079%,68.9234650967199%,402,1497,2037,19.7349042709867%,73.4904270986745%,467,1596,2119,22.0386974988202%,75.3185464841907%,0.722344645218158,0.788309636650869,0.773630634997576,2269,1899,2063
1690,26,MONTANA,TREASURE,106,344,479,22.1294363256785%,71.8162839248434%,59,351,443,13.3182844243792%,79.2325056433409%,78,373,460,16.9565217391304%,81.0869565217391%,0.764444444444445,0.85609756097561,0.827050997782705,450,410,451
1691,26,MONTANA,VALLEY,1273,2500,3963,32.1221296997224%,63.0835225839011%,886,2698,3894,22.7529532614278%,69.2860811504879%,1030,3135,4261,24.1727294062427%,73.5742783384182%,0.66260270341903,0.752790178571429,0.752701080432173,3773,3584,4165
1692,26,MONTANA,WHEATLAND,243,708,999,24.3243243243243%,70.8708708708709%,179,702,946,18.9217758985201%,74.2071881606765%,225,823,1068,21.0674157303371%,77.059925093633%,0.744479495268139,0.796821793416572,0.78530534351145,951,881,1048
1693,26,MONTANA,WIBAUX,121,369,518,23.3590733590734%,71.2355212355212%,55,463,541,10.1663585951941%,85.5822550831793%,77,516,598,12.876254180602%,86.2876254180602%,0.753061224489796,0.893822393822394,0.870151770657673,490,518,593
1694,26,MONTANA,YELLOWSTONE,20370,33922,57499,35.4267030730969%,58.9958086227587%,22171,40920,69108,32.0816692712855%,59.2116686924813%,30679,50772,83821,36.6006132114864%,60.5719330478043%,0.624806601340897,0.648586961690257,0.623344096450627,54292,63091,81451
1696,27,NEBRASKA,ADAMS,3686,8162,12438,29.6349895481589%,65.6214825534652%,3302,9287,13513,24.4357285576852%,68.7264116036409%,4213,10085,14602,28.8522120257499%,69.0658813861115%,0.688892640108035,0.737707522440226,0.705343404671982,11848,12589,14298
1697,27,NEBRASKA,ANTELOPE,678,2562,3368,20.1306413301663%,76.0688836104513%,383,2732,3281,11.6732703444072%,83.2672965559281%,452,3093,3583,12.6151269885571%,86.3243092380687%,0.790740740740741,0.877046548956661,0.872496473906911,3240,3115,3545
1698,27,NEBRASKA,ARTHUR,26,235,272,9.55882352941176%,86.3970588235294%,17,244,273,6.22710622710623%,89.3772893772894%,21,260,284,7.3943661971831%,91.5492957746479%,0.900383141762452,0.934865900383142,0.925266903914591,261,261,281
1699,27,NEBRASKA,BANNER,65,390,462,14.0692640692641%,84.4155844155844%,19,357,402,4.72636815920398%,88.8059701492537%,43,362,410,10.4878048780488%,88.2926829268293%,0.857142857142857,0.949468085106383,0.893827160493827,455,376,405
1700,27,NEBRASKA,BLAINE,43,299,349,12.3209169054441%,85.6733524355301%,30,276,317,9.46372239747634%,87.0662460567823%,35,280,317,11.0410094637224%,88.3280757097792%,0.874269005847953,0.901960784313726,0.888888888888889,342,306,315
1701,27,NEBRASKA,BOONE,575,2196,2862,20.0908455625437%,76.7295597484277%,414,2299,2905,14.2512908777969%,79.1394148020654%,499,2653,3217,15.5113459745104%,82.4681380167858%,0.792493684590401,0.847401400663472,0.841687817258883,2771,2713,3152
1702,27,NEBRASKA,BOX BUTTE,1614,3208,5089,31.7154647278444%,63.0379249361368%,965,3617,4924,19.5978878960195%,73.4565393988627%,1051,4002,5181,20.2856591391623%,77.2437753329473%,0.665284114475321,0.789393278044522,0.792004749653671,4822,4582,5053
1703,27,NEBRASKA,BOYD,265,931,1242,21.3365539452496%,74.9597423510467%,128,983,1156,11.0726643598616%,85.0346020761246%,135,1010,1153,11.7085862966175%,87.5975715524718%,0.778428093645485,0.884788478847885,0.882096069868996,1196,1111,1145
1704,27,NEBRASKA,BROWN,250,1375,1684,14.8456057007126%,81.6508313539192%,153,1385,1597,9.58046336881653%,86.7251095804634%,191,1470,1679,11.3758189398451%,87.552114353782%,0.846153846153846,0.900520156046814,0.885009030704395,1625,1538,1661
1705,27,NEBRASKA,BUFFALO,3927,11931,16461,23.85638782577%,72.4804082376526%,4763,14569,21129,22.5424771640873%,68.9526243551517%,6350,16640,23589,26.9193268048667%,70.541354020942%,0.752364737041241,0.753620939375129,0.723792953458025,15858,19332,22990
1706,27,NEBRASKA,BURT,1223,2056,3392,36.0554245283019%,60.6132075471698%,930,2367,3558,26.1382799325464%,66.5261382799325%,1063,2580,3731,28.491021173948%,69.1503618332887%,0.627020433058859,0.717925386715196,0.708207521273676,3279,3297,3643
1707,27,NEBRASKA,BUTLER,1028,2638,3828,26.8547544409613%,68.9132706374086%,691,3079,3981,17.3574478774177%,77.342376287365%,873,3542,4498,19.4086260560249%,78.7461093819475%,0.719585379159847,0.816710875331565,0.802265005662514,3666,3770,4415
1708,27,NEBRASKA,CASS,3656,6144,10280,35.5642023346304%,59.7665369649805%,3484,8452,12933,26.9388386298616%,65.3521997989639%,4737,10121,15284,30.9931954985606%,66.219576027218%,0.626938775510204,0.708109919571046,0.681181854892987,9800,11936,14858
1709,27,NEBRASKA,CEDAR,1062,2989,4269,24.87702037948%,70.016397282736%,571,3532,4420,12.9185520361991%,79.9095022624434%,725,4174,4996,14.5116092874299%,83.546837469976%,0.73784250802271,0.860833536436754,0.852010614411104,4051,4103,4899
1710,27,NEBRASKA,CHASE,306,1505,1875,16.32%,80.2666666666667%,171,1648,1898,9.00948366701791%,86.8282402528978%,226,1740,1993,11.3396889111892%,87.3055694932263%,0.831032578685809,0.905992303463441,0.885045778229908,1811,1819,1966
1711,27,NEBRASKA,CHERRY,446,2322,2847,15.6656129258869%,81.5595363540569%,317,2623,3118,10.1667735728031%,84.1244387427838%,373,2844,3265,11.4241960183767%,87.1056661562021%,0.838872832369942,0.892176870748299,0.884053465962076,2768,2940,3217
1712,27,NEBRASKA,CHEYENNE,844,3207,4186,20.1624462494028%,76.6125179168657%,711,3665,4711,15.0923370834218%,77.7966461473148%,855,3813,4765,17.9433368310598%,80.0209863588667%,0.791656381140459,0.837522851919561,0.816838046272494,4051,4376,4668
1713,27,NEBRASKA,CLAY,774,2326,3215,24.0746500777605%,72.348367029549%,477,2422,3065,15.5628058727569%,79.021207177814%,632,2848,3558,17.7627880831928%,80.0449690837549%,0.750322580645161,0.835460503621939,0.818390804597701,3100,2899,3480
1714,27,NEBRASKA,COLFAX,863,2338,3315,26.0331825037707%,70.5279034690799%,859,2171,3214,26.7268201617922%,67.548226509023%,1025,2636,3717,27.5760021522733%,70.9174065106268%,0.730396751015308,0.716501650165017,0.720021851953018,3201,3030,3661
1715,27,NEBRASKA,CUMING,857,3232,4215,20.3321470937129%,76.6785290628707%,719,3122,4074,17.6485027000491%,76.6323024054983%,870,3507,4451,19.5461694001348%,78.7912828577848%,0.790413303986305,0.812809164280135,0.80123372172721,4089,3841,4377
1716,27,NEBRASKA,CUSTER,976,4245,5414,18.0273365349095%,78.4078315478389%,641,4695,5652,11.3411181882519%,83.067940552017%,786,5090,5993,13.1153011847155%,84.9324211580177%,0.813062631679755,0.879872563718141,0.866235534377127,5221,5336,5876
1717,27,NEBRASKA,DAKOTA,2695,3119,6061,44.464609800363%,51.4601550899192%,2314,3616,6279,36.8530020703934%,57.5887880235706%,2744,3926,6794,40.3885781571975%,57.7862820135414%,0.536463708290334,0.609780775716695,0.588605697151424,5814,5930,6670
1718,27,NEBRASKA,DAWES,823,2549,3621,22.7285280309307%,70.3949185307926%,801,2632,3676,21.7899891186072%,71.5995647442873%,1082,2931,4121,26.2557631642805%,71.1235137102645%,0.755931198102017,0.766676376347218,0.730376277099427,3372,3433,4013
1719,27,NEBRASKA,DAWSON,1740,5511,7507,23.1783668575996%,73.4114826162249%,2136,5984,8635,24.7365373480023%,69.2993630573248%,2497,6524,9178,27.2063630420571%,71.0830246241011%,0.760033098882913,0.736945812807882,0.723201418911429,7251,8120,9021
1720,27,NEBRASKA,DEUEL,213,783,1033,20.6195546950629%,75.7986447241045%,120,809,984,12.1951219512195%,82.2154471544716%,141,871,1032,13.6627906976744%,84.3992248062015%,0.786144578313253,0.870828848223897,0.860671936758893,996,929,1012
1721,27,NEBRASKA,DIXON,820,1834,2792,29.3696275071633%,65.6876790830946%,556,2041,2782,19.9856218547807%,73.3644859813084%,651,2335,3083,21.115796302303%,75.7379176127149%,0.691032403918613,0.785906815556411,0.781982585398526,2654,2597,2986
1722,27,NEBRASKA,DODGE,5021,8871,14472,34.6945826423438%,61.2976782752902%,4544,9933,15529,29.2613819305815%,63.964196020349%,5544,10984,16876,32.8513865844987%,65.086513391799%,0.638568960552836,0.686122815500449,0.664569215876089,13892,14477,16528
1723,27,NEBRASKA,DOUGLAS,73347,101025,183156,40.0461901330014%,55.1578981851536%,113798,108077,240433,47.3304413287694%,44.950984265887%,150350,119159,274951,54.6824706947783%,43.3382675458536%,0.579364806276237,0.487107605633803,0.442133657874134,174372,221875,269509
1724,27,NEBRASKA,DUNDY,179,801,1011,17.7052423343225%,79.2284866468843%,89,823,953,9.3389296956978%,86.3588667366212%,105,883,999,10.5105105105105%,88.3883883883884%,0.81734693877551,0.902412280701754,0.893724696356275,980,912,988
1725,27,NEBRASKA,FILLMORE,848,2024,2998,28.285523682455%,67.5116744496331%,613,2130,2941,20.8432505950357%,72.4243454607277%,693,2359,3134,22.1123165283982%,75.271218889598%,0.704735376044568,0.776522056142909,0.772935779816514,2872,2743,3052
1726,27,NEBRASKA,FRANKLIN,420,1196,1668,25.1798561151079%,71.7026378896883%,250,1347,1673,14.9432157800359%,80.5140466228332%,276,1437,1724,16.0092807424594%,83.3526682134571%,0.74009900990099,0.843456480901691,0.838879159369527,1616,1597,1713
1727,27,NEBRASKA,FRONTIER,244,1102,1393,17.516152189519%,79.1098348887294%,161,1110,1328,12.1234939759036%,83.5843373493976%,189,1229,1440,13.125%,85.3472222222222%,0.818722139673105,0.873328088119591,0.866713681241185,1346,1271,1418
1728,27,NEBRASKA,FURNAS,534,1849,2431,21.9662690250926%,76.0592348827643%,304,1921,2340,12.991452991453%,82.0940170940171%,399,2163,2601,15.3402537485582%,83.1603229527105%,0.775912715065044,0.863370786516854,0.844262295081967,2383,2225,2562
1729,27,NEBRASKA,GAGE,3516,5538,9506,36.9871660004208%,58.2579423521986%,2935,6380,10048,29.2097929936306%,63.4952229299363%,3385,7445,11068,30.5836646187206%,67.2659920491507%,0.611663353214049,0.68491680085883,0.687442289935365,9054,9315,10830
1730,27,NEBRASKA,GARDEN,203,963,1219,16.6529942575882%,78.9991796554553%,153,869,1075,14.2325581395349%,80.8372093023256%,161,1016,1195,13.4728033472803%,85.020920502092%,0.82590051457976,0.850293542074364,0.86321155480034,1166,1022,1177
1731,27,NEBRASKA,GARFIELD,202,718,963,20.9761163032191%,74.5586708203531%,121,821,980,12.3469387755102%,83.7755102040816%,133,933,1075,12.3720930232558%,86.7906976744186%,0.780434782608696,0.871549893842887,0.875234521575985,920,942,1066
1732,27,NEBRASKA,GOSPER,228,757,1014,22.4852071005917%,74.65483234714%,166,794,1010,16.4356435643564%,78.6138613861386%,215,893,1118,19.2307692307692%,79.8747763864043%,0.768527918781726,0.827083333333333,0.805956678700361,985,960,1108
1733,27,NEBRASKA,GRANT,49,324,385,12.7272727272727%,84.1558441558442%,20,367,405,4.93827160493827%,90.6172839506173%,20,375,402,4.97512437810945%,93.2835820895522%,0.868632707774799,0.948320413436692,0.949367088607595,373,387,395
1734,27,NEBRASKA,GREELEY,416,839,1310,31.7557251908397%,64.0458015267176%,210,912,1175,17.8723404255319%,77.6170212765958%,229,1016,1258,18.2034976152623%,80.7631160572337%,0.668525896414343,0.812834224598931,0.816064257028113,1255,1122,1245
1735,27,NEBRASKA,HALL,5952,11803,18546,32.0931737301844%,63.6417556346382%,6282,14408,22060,28.4768812330009%,65.312783318223%,7681,16189,24374,31.5130877164191%,66.4191351440059%,0.664770487186708,0.69637506041566,0.678215333054043,17755,20690,23870
1736,27,NEBRASKA,HAMILTON,1066,3251,4491,23.7363616121131%,72.3892228902249%,878,3783,5004,17.5459632294165%,75.5995203836931%,1118,4309,5533,20.2060365082234%,77.8781854328574%,0.753069261060922,0.811628405921476,0.793992997973098,4317,4661,5427
1737,27,NEBRASKA,HARLAN,438,1358,1852,23.6501079913607%,73.3261339092873%,254,1496,1832,13.8646288209607%,81.6593886462882%,282,1615,1928,14.6265560165975%,83.7655601659751%,0.756124721603563,0.854857142857143,0.851344227727992,1796,1750,1897
1738,27,NEBRASKA,HAYES,66,486,571,11.5586690017513%,85.1138353765324%,30,472,514,5.83657587548638%,91.8287937743191%,34,494,534,6.36704119850187%,92.5093632958802%,0.880434782608696,0.940239043824701,0.935606060606061,552,502,528
1739,27,NEBRASKA,HITCHCOCK,312,1126,1480,21.0810810810811%,76.0810810810811%,161,1232,1468,10.9673024523161%,83.9237057220708%,175,1264,1469,11.9128658951668%,86.0449285228046%,0.783031988873435,0.884422110552764,0.878387769284225,1438,1393,1439
1740,27,NEBRASKA,HOLT,846,3954,4959,17.059891107078%,79.7338173018754%,531,4354,5118,10.3751465416178%,85.0722938647909%,686,4769,5537,12.3893805309735%,86.1296731081813%,0.82375,0.891299897645855,0.874243813015582,4800,4885,5455
1741,27,NEBRASKA,HOOKER,74,317,409,18.0929095354523%,77.5061124694377%,40,355,417,9.59232613908873%,85.1318944844125%,59,376,442,13.3484162895928%,85.0678733031674%,0.81074168797954,0.89873417721519,0.864367816091954,391,395,435
1742,27,NEBRASKA,HOWARD,955,1760,2827,33.7813937035727%,62.2568093385214%,544,2284,2994,18.1696726786907%,76.2859051436206%,648,2786,3501,18.5089974293059%,79.5772636389603%,0.648250460405157,0.807637906647808,0.811298776936517,2715,2828,3434
1743,27,NEBRASKA,JEFFERSON,1361,2351,3847,35.3782167923057%,61.1125552378477%,837,2399,3494,23.955352032055%,68.6605609616485%,1016,2616,3716,27.3412271259419%,70.3982777179763%,0.633351293103448,0.741347342398022,0.720264317180617,3712,3236,3632
1744,27,NEBRASKA,JOHNSON,794,1210,2112,37.594696969697%,57.2916666666667%,563,1355,2089,26.9506941120153%,64.8635710866443%,647,1518,2229,29.0264692687304%,68.1022880215343%,0.603792415169661,0.706465067778936,0.701154734411085,2004,1918,2165
1745,27,NEBRASKA,KEARNEY,680,2333,3122,21.7809096732864%,74.7277386290839%,550,2531,3296,16.6868932038835%,76.7900485436893%,701,2822,3604,19.4506104328524%,78.3018867924528%,0.774311317623631,0.82148653034729,0.80102185637241,3013,3081,3523
1746,27,NEBRASKA,KEITH,778,2953,3849,20.213042348662%,76.7212262925435%,571,3235,4034,14.154685176004%,80.193356470005%,763,3544,4364,17.4839596700275%,81.2098991750687%,0.79147681586706,0.849973725696269,0.822846528906431,3731,3806,4307
1747,27,NEBRASKA,KEYA PAHA,78,422,513,15.2046783625731%,82.261208576998%,40,460,519,7.70712909441233%,88.6319845857418%,49,476,529,9.26275992438563%,89.9810964083176%,0.844,0.92,0.906666666666667,500,500,525
1748,27,NEBRASKA,KIMBALL,379,1379,1820,20.8241758241758%,75.7692307692308%,230,1330,1677,13.7149672033393%,79.3082886106142%,268,1563,1874,14.3009605122732%,83.4044823906083%,0.784414106939704,0.852564102564103,0.853631895139268,1758,1560,1831
1749,27,NEBRASKA,KNOX,1037,2784,3978,26.0683760683761%,69.9849170437406%,720,3188,4115,17.4969623329283%,77.4726609963548%,905,3721,4697,19.2676176282734%,79.2207792207792%,0.72860507720492,0.815762538382804,0.804366623432771,3821,3908,4626
1750,27,NEBRASKA,LANCASTER,44650,55514,107132,41.6775566590748%,51.8183175895157%,61898,61588,136223,45.4387291426558%,45.2111611108256%,82293,70092,156091,52.7211690616371%,44.9045748954136%,0.554231061059862,0.498744796981034,0.45996653213899,100164,123486,152385
1751,27,NEBRASKA,LINCOLN,5205,9220,15114,34.4382691544264%,61.0030435357946%,2913,12164,16131,18.0583968755812%,75.4076002727667%,3692,13071,17107,21.5818086163559%,76.4073186414918%,0.639168110918544,0.806791802082642,0.779753027501044,14425,15077,16763
1752,27,NEBRASKA,LOGAN,60,336,412,14.5631067961165%,81.5533980582524%,32,400,453,7.06401766004415%,88.3002207505519%,38,407,450,8.44444444444444%,90.4444444444444%,0.848484848484848,0.925925925925926,0.914606741573034,396,432,445
1753,27,NEBRASKA,LOUP,84,284,378,22.2222222222222%,75.1322751322751%,48,323,385,12.4675324675325%,83.8961038961039%,75,370,454,16.5198237885463%,81.4977973568282%,0.771739130434783,0.870619946091644,0.831460674157303,368,371,445
1754,27,NEBRASKA,MADISON,2772,9636,12853,21.5669493503462%,74.9708239321559%,2711,10628,14343,18.9012061632852%,74.0988635571359%,3478,11940,15765,22.0615287028227%,75.7373929590866%,0.776595744680851,0.796761376415024,0.774419509664029,12408,13339,15418
1755,27,NEBRASKA,MCPHERSON,48,244,301,15.9468438538206%,81.0631229235881%,14,257,287,4.87804878048781%,89.5470383275261%,17,275,302,5.62913907284768%,91.0596026490066%,0.835616438356164,0.948339483394834,0.941780821917808,292,271,292
1756,27,NEBRASKA,MERRICK,848,2380,3340,25.3892215568862%,71.2574850299401%,602,2926,3788,15.8922914466737%,77.2439281942978%,743,3419,4257,17.4536058256988%,80.3147756636129%,0.73729863692689,0.829365079365079,0.821480057664584,3228,3528,4162
1757,27,NEBRASKA,MORRILL,460,1597,2138,21.5154349859682%,74.6959775491113%,284,1802,2209,12.856496152105%,81.5753734721594%,386,2113,2557,15.0958154086821%,82.6359014470082%,0.77637335926106,0.86385426653883,0.845538215286114,2057,2086,2499
1758,27,NEBRASKA,NANCE,497,1105,1665,29.8498498498499%,66.3663663663664%,281,1261,1621,17.3349784083899%,77.7914867365824%,359,1437,1828,19.6389496717724%,78.6105032822757%,0.68976279650437,0.817769130998703,0.80011135857461,1602,1542,1796
1759,27,NEBRASKA,NEMAHA,1063,2177,3369,31.5523894330662%,64.6185811813595%,785,2116,3161,24.8339133185701%,66.9408415058526%,921,2428,3423,26.9062226117441%,70.9319310546304%,0.671913580246914,0.729403653912444,0.7249925350851,3240,2901,3349
1760,27,NEBRASKA,NUCKOLLS,644,1701,2443,26.3610315186246%,69.6275071633238%,353,1726,2205,16.0090702947846%,78.2766439909297%,409,1857,2303,17.7594442032132%,80.6339557099436%,0.725373134328358,0.83020683020683,0.819505736981465,2345,2079,2266
1761,27,NEBRASKA,OTOE,2208,4178,6662,33.1432002401681%,62.7138997298109%,2025,4860,7457,27.15569263779%,65.173662330696%,2490,5649,8315,29.9458809380637%,67.9374624173181%,0.654243658001879,0.705882352941176,0.694065610025802,6386,6885,8139
1762,27,NEBRASKA,PAWNEE,522,937,1519,34.3647136273864%,61.6853192890059%,279,974,1327,21.024868123587%,73.3986435568953%,322,1071,1429,22.5332400279916%,74.9475157452764%,0.642220699108979,0.777334397446129,0.768844221105528,1459,1253,1393
1763,27,NEBRASKA,PERKINS,243,1170,1452,16.7355371900826%,80.5785123966942%,161,1217,1455,11.0652920962199%,83.6426116838488%,199,1321,1544,12.8886010362694%,85.5569948186529%,0.828025477707006,0.883164005805515,0.869078947368421,1413,1378,1520
1764,27,NEBRASKA,PHELPS,934,3575,4627,20.1858655716447%,77.2638858871839%,572,3849,4695,12.1831735889244%,81.9808306709265%,752,4157,5009,15.0129766420443%,82.9906168895987%,0.792858726990464,0.870617507351278,0.846811977999593,4509,4421,4909
1765,27,NEBRASKA,PIERCE,570,2534,3208,17.7680798004988%,78.9900249376559%,382,3052,3630,10.5234159779614%,84.0771349862259%,480,3462,4006,11.9820269595607%,86.4203694458313%,0.816365979381443,0.888759464181712,0.878234398782344,3104,3434,3942
1766,27,NEBRASKA,PLATTE,2612,9861,12859,20.3126215102263%,76.6855898592426%,2646,10965,14433,18.3329869050094%,75.9717314487633%,3260,12186,15673,20.8001020863906%,77.7515472468577%,0.79058766936583,0.80559841304827,0.788942120937459,12473,13611,15446
1767,27,NEBRASKA,POLK,610,1925,2613,23.3448143895905%,73.6701109835438%,413,2028,2582,15.995352439969%,78.5437645236251%,530,2291,2879,18.4091698506426%,79.5762417506078%,0.759368836291913,0.830807046292503,0.812123360510457,2535,2441,2821
1768,27,NEBRASKA,RED WILLOW,1188,3680,5025,23.6417910447761%,73.2338308457711%,645,4258,5170,12.4758220502901%,82.3597678916828%,811,4525,5452,14.8752751283933%,82.9970652971387%,0.755957271980279,0.868447889047522,0.848013493253373,4868,4903,5336
1769,27,NEBRASKA,RICHARDSON,1382,2623,4150,33.3012048192771%,63.2048192771084%,818,2769,3805,21.4980289093298%,72.772667542707%,996,3073,4126,24.1396025206011%,74.4789142026175%,0.654931335830212,0.771954279342069,0.755222413369378,4005,3587,4069
1770,27,NEBRASKA,ROCK,141,725,894,15.7718120805369%,81.0961968680089%,70,687,798,8.7719298245614%,86.0902255639098%,84,744,841,9.98810939357907%,88.4661117717004%,0.837182448036952,0.907529722589168,0.898550724637681,866,757,828
1771,27,NEBRASKA,SALINE,2321,2581,5145,45.11175898931%,50.1652089407191%,1733,3004,5136,33.7422118380062%,58.4890965732087%,1986,3631,5770,34.419410745234%,62.9289428076257%,0.526519787841697,0.634156639223137,0.646430478903329,4902,4737,5617
1772,27,NEBRASKA,SARPY,14637,28979,45278,32.3269579045011%,64.0023852643668%,28033,45143,80580,34.789029535865%,56.0225862496898%,41206,51979,95673,43.0696225685408%,54.3298527275198%,0.664412142333089,0.616909915819394,0.557804367655739,43616,73176,93185
1773,27,NEBRASKA,SAUNDERS,2852,5688,8919,31.9766789998879%,63.773965691221%,2523,7555,10860,23.232044198895%,69.5672191528545%,3331,9108,12735,26.1562622693365%,71.5194346289753%,0.666042154566745,0.749652708870808,0.73221320041804,8540,10078,12439
1774,27,NEBRASKA,SCOTTS BLUFF,3937,9397,13839,28.4485873256738%,67.9023050798468%,3207,10076,14317,22.399944122372%,70.3778724593141%,4196,10952,15469,27.1252181782921%,70.7996638438167%,0.704739763011849,0.758563577505082,0.722999735938738,13334,13283,15148
1775,27,NEBRASKA,SEWARD,2250,4457,7016,32.0695553021665%,63.5262257696693%,1875,5454,7922,23.6682655894976%,68.8462509467306%,2438,6490,9142,26.6681251367316%,70.9910304091009%,0.664529595944536,0.744167007777323,0.726926523297491,6707,7329,8928
1776,27,NEBRASKA,SHERIDAN,392,2105,2576,15.2173913043478%,81.7158385093168%,287,2211,2608,11.0046012269939%,84.7776073619632%,340,2292,2672,12.7245508982036%,85.7784431137725%,0.843011613936724,0.885108086469175,0.870820668693009,2497,2498,2632
1777,27,NEBRASKA,SHERMAN,564,1072,1705,33.0791788856305%,62.8739002932551%,340,1150,1573,21.6147488874762%,73.1087094723458%,343,1322,1698,20.2002355712603%,77.8563015312132%,0.655256723716381,0.771812080536913,0.793993993993994,1636,1490,1665
1778,27,NEBRASKA,SIOUX,98,629,752,13.031914893617%,83.6436170212766%,81,616,736,11.0054347826087%,83.695652173913%,72,642,729,9.87654320987654%,88.0658436213992%,0.865199449793673,0.883787661406026,0.899159663865546,727,697,714
1779,27,NEBRASKA,STANTON,500,1895,2486,20.1126307320998%,76.2268704746581%,417,2187,2801,14.8875401642271%,78.0792574080685%,532,2561,3161,16.830117051566%,81.0186649794369%,0.791231732776618,0.839861751152074,0.827998706757194,2395,2604,3093
1780,27,NEBRASKA,THAYER,821,2096,3006,27.3120425815037%,69.7272122421823%,499,2051,2690,18.5501858736059%,76.2453531598513%,624,2308,2980,20.9395973154362%,77.4496644295302%,0.718546451834076,0.804313725490196,0.787175989085948,2917,2550,2932
1781,27,NEBRASKA,THOMAS,55,329,395,13.9240506329114%,83.2911392405063%,30,344,393,7.63358778625954%,87.5318066157761%,45,377,427,10.5386416861827%,88.2903981264637%,0.856770833333333,0.919786096256684,0.893364928909953,384,374,422
1782,27,NEBRASKA,THURSTON,924,1040,2082,44.3804034582133%,49.9519692603266%,919,1043,2088,44.0134099616858%,49.9521072796935%,1122,1180,2325,48.258064516129%,50.752688172043%,0.529531568228106,0.531600407747197,0.5125977410947,1964,1962,2302
1783,27,NEBRASKA,VALLEY,583,1610,2263,25.7622624834291%,71.1444984533805%,339,1780,2205,15.3741496598639%,80.7256235827664%,412,1901,2340,17.6068376068376%,81.2393162393162%,0.734154126766986,0.840018876828693,0.82187635105923,2193,2119,2313
1784,27,NEBRASKA,WASHINGTON,2550,5758,8626,29.5617899373986%,66.7516809645259%,2623,7424,10832,24.2152880354505%,68.5376661742984%,3554,8583,12413,28.6312736647064%,69.1452509465883%,0.69306692344728,0.738927042898378,0.707176402735437,8308,10047,12137
1785,27,NEBRASKA,WAYNE,1001,2774,3940,25.4060913705584%,70.4060913705584%,835,2693,3776,22.1133474576271%,71.3188559322034%,1022,3055,4200,24.3333333333333%,72.7380952380952%,0.734834437086093,0.763321995464853,0.749325484424822,3775,3528,4077
1786,27,NEBRASKA,WEBSTER,584,1302,1945,30.025706940874%,66.9408740359897%,306,1330,1708,17.9156908665105%,77.8688524590164%,335,1511,1876,17.8571428571429%,80.543710021322%,0.690349946977731,0.812958435207824,0.818526543878657,1886,1636,1846
1787,27,NEBRASKA,WHEELER,85,351,453,18.7637969094923%,77.4834437086093%,62,377,465,13.3333333333333%,81.0752688172043%,59,438,502,11.7529880478088%,87.2509960159363%,0.805045871559633,0.85876993166287,0.881287726358149,436,439,497
1788,27,NEBRASKA,YORK,1407,4816,6460,21.7801857585139%,74.5510835913313%,1186,4700,6381,18.5864284594891%,73.6561667450243%,1630,5337,7143,22.8195436091278%,74.7165056698866%,0.773903262092238,0.798504926945294,0.766039902397014,6223,5886,6967
1790,28,NEVADA,CARSON CITY,7354,11084,19452,37.8058811433272%,56.9812872712317%,9610,13125,25016,38.4154141349536%,52.4664214902462%,12735,16113,29739,42.8225562392818%,54.1813779885%,0.601149799327476,0.57730371673631,0.558548252911814,18438,22735,28848
1791,28,NEVADA,CHURCHILL,2191,6237,8823,24.8328233027315%,70.6902414144849%,2210,7830,10938,20.2047906381423%,71.5852989577619%,3048,9367,12881,23.6627591025541%,72.7195093548638%,0.740033222591362,0.779880478087649,0.754490535642368,8428,10040,12415
1792,28,NEVADA,CLARK,196100,170932,382198,51.3084840841658%,44.7234156118033%,402227,320057,767156,52.4309266954831%,41.7199370141145%,521777,430809,972308,53.6637567519757%,44.3078736367489%,0.465714161163059,0.443117942526762,0.452252080127149,367032,722284,952586
1793,28,NEVADA,DOUGLAS,5837,11193,17974,32.4746856570602%,62.2732836319128%,8454,17415,27885,30.3173749327595%,62.4529316837009%,11570,21623,34117,33.912712137644%,63.3789606354603%,0.657251908396947,0.673199582511887,0.651432530955322,17030,25869,33193
1794,28,NEVADA,ELKO,2542,11025,14180,17.9266572637518%,77.7503526093089%,3401,13551,18559,18.3253408050003%,73.01578748855%,4555,16734,21957,20.7450926811495%,76.2125973493647%,0.812633596226137,0.799374705049552,0.786039738832261,13567,16952,21289
1795,28,NEVADA,ESMERALDA,116,333,491,23.6252545824847%,67.8207739307536%,65,329,423,15.3664302600473%,77.7777777777778%,72,395,480,15%,82.2916666666667%,0.741648106904232,0.83502538071066,0.845824411134904,449,394,467
1796,28,NEVADA,EUREKA,150,632,837,17.921146953405%,75.5077658303465%,74,723,854,8.66510538641686%,84.6604215456675%,104,887,1008,10.3174603174603%,87.9960317460317%,0.808184143222506,0.907151819322459,0.895055499495459,782,797,991
1797,28,NEVADA,HUMBOLDT,1128,3638,5030,22.4254473161034%,72.3260437375746%,1386,4521,6433,21.5451577801959%,70.2782527592103%,1689,5877,7771,21.7346544846223%,75.6273323896538%,0.763323541754091,0.76536312849162,0.776764472640761,4766,5907,7566
1798,28,NEVADA,LANDER,395,1619,2119,18.6408683341199%,76.4039641340255%,403,1828,2413,16.7012018234563%,75.7563199336925%,496,2198,2765,17.9385171790235%,79.4936708860759%,0.803872889771599,0.819363514119229,0.815887156644395,2014,2231,2694
1799,28,NEVADA,LINCOLN,461,1372,1956,23.5685071574642%,70.1431492842536%,285,1671,2132,13.3677298311445%,78.3771106941839%,330,2067,2446,13.4914145543745%,84.5053147996729%,0.748499727223132,0.854294478527607,0.862327909887359,1833,1956,2397
1800,28,NEVADA,LYON,3955,7270,11992,32.9803202134757%,60.6237491661107%,6146,16005,23762,25.8648261930814%,67.3554414611565%,8472,20906,30229,28.0260676833504%,69.1587548380694%,0.647661469933185,0.722540743081576,0.711620940840084,11225,22151,29378
1801,28,NEVADA,MINERAL,916,1227,2293,39.9476668120366%,53.5106846925425%,637,1179,1997,31.8978467701552%,59.0385578367551%,824,1420,2327,35.4103996562097%,61.022776106575%,0.572561829211386,0.649229074889868,0.632798573975045,2143,1816,2244
1802,28,NEVADA,NYE,4525,6904,12181,37.148017404154%,56.6784336261391%,5094,13324,19595,25.9964276601174%,67.9969379943863%,7287,17527,25376,28.7161097099622%,69.0691992433796%,0.604077347099484,0.723422738625258,0.70633513339244,11429,18418,24814
1803,28,NEVADA,PERSHING,476,1221,1802,26.4150943396226%,67.7580466148724%,430,1403,1982,21.6952573158426%,70.787083753784%,547,1731,2320,23.5775862068966%,74.6120689655172%,0.719505008839128,0.765411893071467,0.759877085162423,1697,1833,2278
1804,28,NEVADA,STOREY,666,1014,1798,37.0411568409344%,56.3959955506118%,752,1616,2558,29.3979671618452%,63.1743549648163%,900,1901,2868,31.3807531380753%,66.2831241283124%,0.603571428571429,0.682432432432432,0.678686183505891,1680,2368,2801
1805,28,NEVADA,WASHOE,52097,63640,122301,42.5973622456072%,52.0355516308125%,97379,94758,209909,46.3910551715267%,45.1424188576955%,128052,116653,251956,50.8231595992951%,46.2989569607392%,0.549867371713454,0.493179345987499,0.476708690055373,115737,192137,244705
1806,28,NEVADA,WHITE PINE,1069,2234,3543,30.1721704769969%,63.0539091165679%,707,2723,3773,18.7384044526902%,72.1706864564007%,856,3400,4363,19.6195278478111%,77.9280311712125%,0.676354828943385,0.793877551020408,0.798872180451128,3303,3430,4256
1808,29,NEW HAMPSHIRE,BELKNAP,10719,14799,26795,40.0037320395596%,55.2304534428065%,13517,19315,35045,38.570409473534%,55.1148523327151%,16894,20899,38391,44.0051053632362%,54.4372378942981%,0.579943569245239,0.588298001949318,0.552986002698913,25518,32832,37793
1809,29,NEW HAMPSHIRE,CARROLL,9852,12597,23879,41.2580091293605%,52.7534653879978%,12987,14635,29616,43.8512965964344%,49.4158562938952%,16649,16150,33221,50.1158905511574%,48.6138286023901%,0.561138580783108,0.52983129389617,0.492393060764048,22449,27622,32799
1810,29,NEW HAMPSHIRE,CHESHIRE,17382,13793,33395,52.0497080401258%,41.302590208115%,22064,16876,41895,52.6649958228906%,40.281656522258%,25522,17898,44220,57.7159656264134%,40.4748982360923%,0.442437850842021,0.433384694401644,0.412206356517734,31175,38940,43420
1811,29,NEW HAMPSHIRE,COOS,6570,7329,14600,45%,50.1986301369863%,6563,7952,15627,41.9978242784924%,50.8862865553209%,7640,8617,16515,46.2609748713291%,52.1768089615501%,0.527304122598748,0.547847054770927,0.530048594451621,13899,14515,16257
1812,29,NEW HAMPSHIRE,GRAFTON,18326,18092,38733,47.3136601864044%,46.7095241783492%,28510,19010,51191,55.6933836025864%,37.1354339630013%,33180,19905,53966,61.4831560612237%,36.8843345810325%,0.496787302982042,0.400042087542088,0.374964679287934,36418,47520,53085
1813,29,NEW HAMPSHIRE,HILLSBOROUGH,77625,80649,165761,46.8294713473012%,48.6537846658744%,99589,100013,214157,46.5027993481418%,46.7007849381529%,122344,104625,230941,52.9763013063943%,45.3037788872483%,0.509553053565336,0.501062113606076,0.460966035009186,158274,199602,226969
1814,29,NEW HAMPSHIRE,MERRIMACK,30622,30028,63684,48.0842911877395%,47.1515608316061%,40198,37674,83648,48.0561400153022%,45.0387337413925%,48533,39711,89805,54.0426479594677%,44.2191414731919%,0.495103050288541,0.483793918224779,0.450013598658266,60650,77872,88244
1815,29,NEW HAMPSHIRE,ROCKINGHAM,61628,65860,134173,45.9317448368897%,49.0858816602446%,79994,90447,181434,44.0898618781485%,49.8511855550779%,100064,95858,198798,50.3345104075494%,48.2187949576958%,0.516597640562249,0.530664570144508,0.489266136523719,127488,170441,195922
1816,29,NEW HAMPSHIRE,STRAFFORD,25400,21108,49393,51.4242908914219%,42.7348004778005%,34894,29072,69000,50.5710144927536%,42.1333333333333%,41721,30489,73596,56.6892222403392%,41.4275232349584%,0.453857400877268,0.454491448582059,0.422226838388035,46508,63966,72210
1817,29,NEW HAMPSHIRE,SULLIVAN,8224,9304,18668,44.0539961431326%,49.8392971930576%,10210,10796,22683,45.0116827580126%,47.5951152845744%,12390,11508,24380,50.8203445447088%,47.2026251025431%,0.530807850296668,0.513948395696468,0.481546572934974,17528,21006,23898
1819,30,NEW JERSEY,ATLANTIC,52880,35593,91102,58.0448288731312%,39.0693947443525%,60924,52690,117291,51.9426042918894%,44.922457818588%,73808,64438,140031,52.7083288700359%,46.0169533888925%,0.402303527629898,0.463763268611263,0.466111135222719,88473,113614,138246
1820,30,NEW JERSEY,BERGEN,202682,152731,366721,55.2687192715988%,41.6477376534205%,231211,175529,419296,55.1426677096848%,41.8627890559414%,285967,204417,495849,57.6721945592307%,41.2256553910566%,0.429728231662882,0.431550867876285,0.416850876048158,355413,406740,490384
1821,30,NEW JERSEY,BURLINGTON,99506,72254,177541,56.0467722948502%,40.6970784213224%,121725,89272,218943,55.5966621449418%,40.7740827521318%,154595,103345,261497,59.1192250771519%,39.5205298722356%,0.420668374476013,0.423096062977199,0.40065519112972,171760,210997,257940
1822,30,NEW JERSEY,CAMDEN,127166,62464,196861,64.5968475218555%,31.7300023874714%,146717,72631,226592,64.7494174551617%,32.0536470837452%,175065,86207,264616,66.1581310276023%,32.5781509810442%,0.329399356641882,0.331122234987326,0.32995116200741,189630,219348,261272
1823,30,NEW JERSEY,CAPE MAY,22189,23794,47594,46.6214228684288%,49.993696684456%,18750,28446,48722,38.4836418866221%,58.3843027790321%,23941,33158,57714,41.4821360501785%,57.4522646151714%,0.517452101863732,0.602720569539792,0.580710695458765,45983,47196,57099
1824,30,NEW JERSEY,CUMBERLAND,28188,18882,48684,57.8999260537343%,38.7848163667735%,27771,24453,54004,51.4239685949189%,45.2799792607955%,32742,28952,62408,52.4644276374824%,46.3914882707345%,0.401147227533461,0.468232996323529,0.469283884980711,47070,52224,61694
1825,30,NEW JERSEY,ESSEX,185505,66842,259573,71.4654451734194%,25.7507521968772%,240837,63176,310934,77.4559874442808%,20.3181382544206%,266820,75475,345311,77.2694759217054%,21.8571085195664%,0.264881294408097,0.20780690299428,0.220496939774171,252347,304013,342295
1826,30,NEW JERSEY,GLOUCESTER,61095,42315,107298,56.9395515293854%,39.4368953754963%,66870,67544,139542,47.9210560261427%,48.4040647260323%,86702,83340,172654,50.2171974005815%,48.2699503052348%,0.409196402668988,0.502507179311679,0.490114207078251,103410,134414,170042
1827,30,NEW JERSEY,HUDSON,118206,43804,167361,70.6293580941797%,26.173361774846%,163917,49043,219375,74.72%,22.3557834757835%,181452,65698,249850,72.6243746247749%,26.2949769861917%,0.27037837170545,0.23029207362885,0.265822375075865,162010,212960,247150
1828,30,NEW JERSEY,HUNTERDON,21387,32210,56455,37.8832698609512%,57.0542910282526%,28898,38712,70836,40.7956406347055%,54.6501778756564%,39457,43153,84242,46.8376819163838%,51.2250421405%,0.60096647200403,0.57257802100281,0.52237017310253,53597,67610,82610
1829,30,NEW JERSEY,MERCER,83256,46670,135559,61.4168000649164%,34.4278137194875%,104775,46193,156529,66.9364782244824%,29.5108254700407%,122532,51641,176604,69.382346945709%,29.2411270412901%,0.359204470236904,0.305978750463674,0.296492567734379,129926,150968,174173
1830,30,NEW JERSEY,MIDDLESEX,154998,93545,258849,59.8796982024269%,36.1388299742321%,193044,122953,326102,59.1974290252743%,37.703847262513%,226250,143467,374362,60.4361553790182%,38.3230669779518%,0.376373504785892,0.389095466096197,0.388045450980074,248543,315997,369717
1831,30,NEW JERSEY,MONMOUTH,131476,119291,262141,50.1546877443819%,45.5064259310829%,137181,166723,314377,43.6358257760587%,53.0328236480404%,181291,191808,378151,47.9414308040968%,50.7225949422321%,0.475704538475956,0.548604164472991,0.514094114430754,250767,303904,373099
1832,30,NEW JERSEY,MORRIS,88039,111066,206508,42.6322466926221%,53.7829042942646%,115249,126071,250416,46.0230176985496%,50.3446265414351%,153881,141134,299322,51.4098529342982%,47.1512284429477%,0.55782627256975,0.522422509530913,0.478396013762012,199105,241320,295015
1833,30,NEW JERSEY,OCEAN,102104,105684,216393,47.1845207562167%,48.8389180796052%,87150,179079,274362,31.764602969799%,65.2710652349815%,119456,217740,341516,34.9781562210848%,63.7568957237728%,0.508614549444626,0.672650237201808,0.645737197357027,207788,266229,337196
1834,30,NEW JERSEY,PASSAIC,90324,61043,156573,57.68810714491%,38.9869262261054%,116759,72902,194802,59.9372696378887%,37.4236404143695%,129097,92009,223707,57.7080735068639%,41.1292449498675%,0.403278125350968,0.384380552670291,0.416130724629816,151367,189661,221106
1835,30,NEW JERSEY,SALEM,13718,12257,26972,50.8601512679816%,45.4434228088388%,11904,16381,29494,40.3607513392555%,55.5401098528514%,14479,18827,33922,42.6832144331113%,55.5008549024232%,0.471876804619827,0.579140887396146,0.565273524289918,25975,28285,33306
1836,30,NEW JERSEY,SOMERSET,56232,59725,120377,46.7132425629481%,49.6149596683752%,85689,65505,157092,54.5470170346039%,41.6984951493392%,111173,71996,185859,59.8157743235463%,38.736891944969%,0.515061617668619,0.433251319496805,0.393057777243966,115957,151194,183169
1837,30,NEW JERSEY,SUSSEX,21353,33277,57490,37.1421116715951%,57.8831101061054%,24212,46658,74126,32.6633030245798%,62.9441761325311%,34481,51698,87960,39.2007730786721%,58.7744429286039%,0.609134175361523,0.658360378157189,0.599890924703234,54630,70870,86179
1838,30,NEW JERSEY,UNION,112003,68554,186373,60.0961512665461%,36.7832250379615%,147414,68114,221975,66.410181326726%,30.6854375492736%,170245,80002,252991,67.2929076528414%,31.6224687834745%,0.379680654862453,0.316033183623473,0.319692144161568,180557,215528,250247
1839,30,NEW JERSEY,WARREN,16543,22172,40801,40.5455748633612%,54.3418053479081%,17281,29858,49236,35.0983020554066%,60.6426192217077%,24901,34769,60787,40.9643509302976%,57.1980851168835%,0.57269792070257,0.633403339061075,0.582688117982236,38715,47139,59670
1841,31,NEW MEXICO,BERNALILLO,99461,95249,204319,48.6792711397374%,46.6177888497888%,143417,94698,274662,52.2158143463603%,34.4780129759486%,193757,116135,317590,61.0085330142637%,36.567587140653%,0.489183914539572,0.397698591016946,0.37475959366489,194710,238115,309892
1842,31,NEW MEXICO,CATRON,353,1273,1711,20.6312098188194%,74.4009351256575%,427,1464,2049,20.8394338701806%,71.4494875549048%,595,1698,2326,25.5803955288048%,73.0008598452279%,0.78290282902829,0.774193548387097,0.74051460968164,1626,1891,2293
1843,31,NEW MEXICO,CHAVES,6340,11378,18149,34.9330541627638%,62.6921593476225%,5534,12872,20271,27.3000838636476%,63.4995806817621%,6381,15656,22443,28.4320278037695%,69.7589448825915%,0.642171802686534,0.699337172661089,0.710441530153832,17718,18406,22037
1844,31,NEW MEXICO,CIBOLA,4127,2752,7088,58.2251693002257%,38.8261851015801%,3741,3195,8063,46.3971226590599%,39.6254495845219%,4745,3975,8903,53.2966415814894%,44.6478715039874%,0.400058147986626,0.460640138408304,0.455848623853211,6879,6936,8720
1845,31,NEW MEXICO,COLFAX,2653,2600,5461,48.5808459989013%,47.6103277787951%,2129,2585,5332,39.9287321830458%,48.4808702175544%,2611,3271,6016,43.4009308510638%,54.3716755319149%,0.494955263658862,0.548366567670768,0.556103366201972,5253,4714,5882
1846,31,NEW MEXICO,CURRY,3471,8301,11969,28.9999164508313%,69.354164926059%,3121,9035,13370,23.3433059087509%,67.5766641735228%,4307,10444,15101,28.521289980796%,69.1609827163764%,0.705147808358818,0.743254359986838,0.708019795268117,11772,12156,14751
1847,31,NEW MEXICO,DE BACA,349,612,982,35.5397148676171%,62.3217922606925%,193,620,910,21.2087912087912%,68.1318681318681%,231,656,901,25.638179800222%,72.8079911209767%,0.636836628511967,0.762607626076261,0.739571589627959,961,813,887
1848,31,NEW MEXICO,DONA ANA,23912,21263,46653,51.2550103959017%,45.5769189548368%,37947,25374,70648,53.7127731853697%,35.916091042917%,47957,32802,82641,58.03051753972%,39.6921624859331%,0.470680686220255,0.400720140237836,0.406171448383462,45175,63321,80759
1849,31,NEW MEXICO,EDDY,7108,10335,17787,39.9617698318997%,58.1042334289088%,5033,13147,19667,25.5910916764123%,66.8480195250928%,5424,17454,23222,23.3571613125484%,75.1614847988976%,0.592501289915725,0.723157315731573,0.762916338840808,17443,18180,22878
1850,31,NEW MEXICO,GRANT,5673,4961,11241,50.4670402989058%,44.1330842451739%,6276,5288,12811,48.9891499492624%,41.2770275544454%,7590,6553,14435,52.5805334257014%,45.3966054728091%,0.466522475079932,0.457281217571774,0.463338754153998,10634,11564,14143
1851,31,NEW MEXICO,GUADALUPE,1076,548,1651,65.1726226529376%,33.1920048455481%,970,595,1827,53.0925013683634%,32.5670498084291%,1234,917,2189,56.3727729556875%,41.8912745545911%,0.33743842364532,0.380191693290735,0.426313342631334,1624,1565,2151
1852,31,NEW MEXICO,HARDING,214,366,593,36.0876897133221%,61.7200674536256%,156,311,527,29.6015180265655%,59.0132827324478%,179,319,505,35.4455445544554%,63.1683168316832%,0.631034482758621,0.665952890792291,0.640562248995984,580,467,498
1853,31,NEW MEXICO,HIDALGO,839,954,1834,45.7470010905125%,52.0174482006543%,784,910,1872,41.8803418803419%,48.6111111111111%,823,1120,1974,41.6919959473151%,56.7375886524823%,0.532069157836029,0.537190082644628,0.576428203808544,1793,1694,1943
1854,31,NEW MEXICO,LEA,3855,10157,14256,27.0412457912458%,71.2471941638608%,3930,12495,17712,22.1883468834688%,70.5453929539295%,4061,16531,20918,19.4139019026676%,79.0276317047519%,0.724878675421068,0.760730593607306,0.80278749028749,14012,16425,20592
1855,31,NEW MEXICO,LINCOLN,2027,4458,6772,29.9320732427643%,65.8298877731837%,2331,5896,8902,26.1851269377668%,66.2323073466637%,3194,6942,10306,30.9916553464002%,67.3588201047933%,0.687432536622976,0.716664640816823,0.684885556432518,6485,8227,10136
1856,31,NEW MEXICO,LOS ALAMOS,4149,5623,10218,40.6048150322959%,55.0303386181249%,5562,3359,10885,51.0978410656867%,30.8589802480478%,7554,4278,12293,61.4496054665257%,34.8002928495892%,0.575419566107245,0.376527295146284,0.361561866125761,9772,8921,11832
1857,31,NEW MEXICO,LUNA,2975,3395,6612,44.9939503932244%,51.346037507562%,3195,3478,7295,43.7971213159698%,47.676490747087%,3563,4408,8103,43.9713686289029%,54.3996050845366%,0.532967032967033,0.521204855387382,0.553004641826621,6370,6673,7971
1858,31,NEW MEXICO,MCKINLEY,10281,5070,15879,64.7458907991687%,31.9289627810315%,13576,5104,21703,62.5535640234069%,23.5174860618348%,18029,7801,26486,68.0699237332931%,29.4532960809484%,0.330271643541137,0.273233404710921,0.302013162988773,15351,18680,25830
1859,31,NEW MEXICO,MORA,1456,668,2191,66.4536741214058%,30.4883614787768%,1536,665,2441,62.9250307251127%,27.2429332240885%,1745,903,2686,64.9664929262844%,33.6187639612807%,0.314500941619586,0.30213539300318,0.341012084592145,2124,2201,2648
1860,31,NEW MEXICO,OTERO,5465,10258,16204,33.7262404344606%,63.3053567020489%,6124,11887,20060,30.5284147557328%,59.2572283150548%,8485,14521,23571,35.9976241992279%,61.6053625217428%,0.652420021624372,0.659985564377325,0.631183169607928,15723,18011,23006
1861,31,NEW MEXICO,QUAY,1471,2292,3844,38.267429760666%,59.6253902185224%,1017,2212,3572,28.471444568869%,61.926091825308%,1170,2634,3873,30.2091402013943%,68.009295120062%,0.609088493223492,0.685041808609477,0.692429022082019,3763,3229,3804
1862,31,NEW MEXICO,RIO ARRIBA,8169,3495,12097,67.5291394560635%,28.8914606927337%,9592,3599,14878,64.4710310525608%,24.1900793117354%,10990,5408,16628,66.0933365407746%,32.523454414241%,0.299639917695473,0.272837540747479,0.329796316623978,11664,13191,16398
1863,31,NEW MEXICO,ROOSEVELT,1762,3762,5651,31.1803220668908%,66.5722880906034%,1454,3884,5950,24.436974789916%,65.2773109243698%,1802,4634,6608,27.2699757869249%,70.1271186440678%,0.681028240405503,0.727613338328962,0.720012430080796,5524,5338,6436
1864,31,NEW MEXICO,SAN JUAN,11980,21434,34657,34.5673312750671%,61.8460916986467%,12865,27946,46110,27.9006723053568%,60.6072435480373%,18083,32874,52294,34.5794928672505%,62.8638084675106%,0.641467648291135,0.684766362010242,0.645132170261201,33414,40811,50957
1865,31,NEW MEXICO,SAN MIGUEL,6540,2215,9161,71.3895862897064%,24.1785831241131%,7285,2313,10751,67.7611384987443%,21.5142777416054%,7888,3421,11531,68.4069031306912%,29.6678518775475%,0.252998286693318,0.240987705772036,0.302502431691573,8755,9598,11309
1866,31,NEW MEXICO,SANDOVAL,14899,15423,31755,46.9185954967722%,48.5687293339632%,27707,25905,61690,44.9132760577079%,41.9922191603177%,40588,34174,76562,53.0132441681252%,44.6357200700086%,0.50864059099004,0.483194061031112,0.457103876300794,30322,53612,74762
1867,31,NEW MEXICO,SANTA FE,32017,13974,49471,64.7187241009885%,28.2468516908896%,50793,14332,71434,71.1047960355013%,20.0632751910855%,62530,18329,82227,76.0455811351503%,22.2907317547764%,0.303842056054445,0.220069097888676,0.226678539185496,45991,65125,80859
1868,31,NEW MEXICO,SIERRA,1689,2721,4586,36.8294810292194%,59.3327518534671%,1612,3010,5181,31.1136846168693%,58.096892491797%,2265,3542,5945,38.0992430613961%,59.5794785534062%,0.617006802721088,0.651233232366941,0.609953504391252,4410,4622,5807
1869,31,NEW MEXICO,SOCORRO,3294,3173,6826,48.2566656900088%,46.4840316437152%,3313,2616,6868,48.2382061735585%,38.0896913220734%,3722,3255,7160,51.9832402234637%,45.4608938547486%,0.490644812123086,0.441221116545792,0.466532893793894,6467,5929,6977
1870,31,NEW MEXICO,TAOS,7039,2744,10895,64.6076181734741%,25.1858650757228%,10668,2727,15260,69.908256880734%,17.870249017038%,13121,3715,17181,76.3692450963274%,21.6227227751586%,0.280486558315445,0.203583426651736,0.220658113566168,9783,13395,16836
1871,31,NEW MEXICO,TORRANCE,1868,2891,4960,37.6612903225806%,58.2862903225807%,1785,3714,6324,28.2258064516129%,58.7286527514232%,2344,4772,7281,32.1933800302156%,65.540447740695%,0.607480563143518,0.675395526459356,0.670601461495222,4759,5499,7116
1872,31,NEW MEXICO,UNION,452,1269,1755,25.7549857549858%,72.3076923076923%,320,1216,1702,18.8014101057579%,71.4453584018801%,383,1388,1789,21.4086081609838%,77.5852431525992%,0.737361998837885,0.791666666666667,0.783738001129305,1721,1536,1771
1873,31,NEW MEXICO,VALENCIA,9819,10803,21377,45.9325443233382%,50.5356223979043%,10841,13215,27592,39.2903740214555%,47.8943171933894%,14263,17364,32277,44.1893608451839%,53.7968212659169%,0.523858015711376,0.549343199201862,0.549024567616277,20622,24056,31627
1875,32,NEW YORK,ALBANY,85617,47624,141969,60.3068275468588%,33.5453514499644%,83077,47810,139830,59.4128584710005%,34.1915182721877%,99474,51081,154727,64.2900075617055%,33.0136304588081%,0.3574275185566,0.365276918257734,0.339284646806815,133241,130887,150555
1876,32,NEW YORK,ALLEGANY,6336,11436,18689,33.9022954679223%,61.1910749638825%,4882,12525,18692,26.1181254012412%,67.0072758399315%,6048,14135,20895,28.9447236180904%,67.647762622637%,0.643484132343011,0.719538116849543,0.700341871872368,17772,17407,20183
1877,32,NEW YORK,BRONX,265801,36245,308048,86.2855788708253%,11.7660234768608%,353646,37797,399522,88.5172781473861%,9.46055536365957%,355374,67740,432399,82.1865915508593%,15.6660861842881%,0.119998278407925,0.0965581195729646,0.160098696805116,302046,391443,423114
1878,32,NEW YORK,BROOME,45381,36946,87063,52.1243237655491%,42.4359371949048%,39212,40943,86072,45.5572079189516%,47.5683148991542%,47010,43800,93494,50.2813014738914%,46.8479260701221%,0.448771362979339,0.510797829205914,0.482325735051206,82327,80155,90810
1879,32,NEW YORK,CATTARAUGUS,13697,18382,33733,40.6041561675511%,54.4926333264163%,9497,19692,31161,30.4771990629312%,63.1943775873688%,11879,22155,35018,33.9225541150266%,63.267462447884%,0.573022849839459,0.674637705985131,0.650966680378445,32079,29189,34034
1880,32,NEW YORK,CAYUGA,17031,14988,33978,50.123609394314%,44.1108952851845%,13522,17384,33172,40.763294344628%,52.405643313638%,16149,19512,36760,43.9309031556039%,53.0794341675735%,0.468097067366251,0.562479777389504,0.547152351308152,32019,30906,35661
1881,32,NEW YORK,CHAUTAUQUA,27016,29064,58720,46.008174386921%,49.4959128065395%,19091,31594,54234,35.2011653206476%,58.2549692075082%,23087,34853,59770,38.6264012046177%,58.3118621381964%,0.518259629101284,0.623340238729407,0.601536071798412,56080,50685,57940
1882,32,NEW YORK,CHEMUNG,17424,18779,37710,46.2052505966587%,49.7984619464333%,13757,20097,36119,38.0879869320856%,55.6410753343116%,16636,21922,39711,41.8926745737957%,55.2038478003576%,0.518713918736016,0.593637384060968,0.568546086415271,36203,33854,38558
1883,32,NEW YORK,CHENANGO,9112,10033,20250,44.9975308641975%,49.5456790123457%,6775,11921,20160,33.6061507936508%,59.1319444444444%,8290,13482,22417,36.9808627381005%,60.1418566266673%,0.524053277618177,0.637623020967052,0.619235715598016,19145,18696,21772
1884,32,NEW YORK,CLINTON,15542,13274,30555,50.8656521027655%,43.4429716903944%,15059,14449,32105,46.9054664382495%,45.0054508643513%,18364,16514,35637,51.5307124617673%,46.3394786317591%,0.46064686285397,0.489663819981022,0.473478983886691,28816,29508,34878
1885,32,NEW YORK,COLUMBIA,13489,13153,28691,47.0147432992925%,45.8436443484019%,15284,13756,30902,49.4595819040839%,44.5149181282765%,20386,14464,35781,56.9743718733406%,40.423688549789%,0.493694167104572,0.473691460055096,0.415035868005739,26642,29040,34850
1886,32,NEW YORK,CORTLAND,9691,9857,20723,46.7644646045457%,47.5655069246731%,8771,9900,20244,43.3264177040111%,48.9033787788974%,10369,10789,21892,47.3643340032889%,49.2828430476887%,0.504245958665848,0.530234052809169,0.509925323754608,19548,18671,21158
1887,32,NEW YORK,DELAWARE,8450,10662,20175,41.8835192069393%,52.8475836431227%,6627,11942,19792,33.483225545675%,60.337510105093%,9143,13387,23074,39.6246857935338%,58.0176822397504%,0.55786940142319,0.643114868867467,0.594185530403906,19112,18569,22530
1888,32,NEW YORK,DUTCHESS,52390,52669,111762,46.8763980601636%,47.1260356829692%,62261,61797,130934,47.5514381291338%,47.1970611147601%,81443,66872,151889,53.620077819987%,44.0268880564096%,0.501327825317203,0.498129906978994,0.450878198429019,105059,124058,148315
1889,32,NEW YORK,ERIE,240176,160176,424654,56.5580449024382%,37.7191784370334%,215456,188303,423625,50.8600767187961%,44.4503983475952%,267174,197527,476787,56.0363432727822%,41.4287721770938%,0.400087922628087,0.466374743349374,0.425062567113047,400352,403759,464701
1890,32,NEW YORK,ESSEX,7927,8822,17932,44.2058889136739%,49.1969663171983%,7762,7958,17218,45.0807294691602%,46.2190730630735%,9947,8976,19470,51.0888546481767%,46.1016949152542%,0.526718013015702,0.506234096692112,0.474343391639803,16749,15720,18923
1891,32,NEW YORK,FRANKLIN,8870,7643,17447,50.8396859058864%,43.8069582163123%,7297,8221,16952,43.045068428504%,48.4957527135441%,9253,9668,19420,47.6467559217302%,49.783728115345%,0.462847453521468,0.529771877819307,0.510966650811268,16513,15518,18921
1892,32,NEW YORK,FULTON,9314,11434,21671,42.9790964883946%,52.7617553412395%,6496,13462,21214,30.6212878287923%,63.4580937116998%,7931,15378,24072,32.9469923562645%,63.8833499501496%,0.551089261615577,0.674516484617697,0.659745162812648,20748,19958,23309
1893,32,NEW YORK,GENESEE,10191,14459,26069,39.0924086079251%,55.4643446238828%,7650,16915,26432,28.942191283293%,63.9944007263922%,9625,18876,29431,32.703611837858%,64.1364547585879%,0.58657200811359,0.688581314878893,0.662292551138557,24650,24565,28501
1894,32,NEW YORK,GREENE,8480,11332,21094,40.2010050251256%,53.721437375557%,7405,13073,22050,33.5827664399093%,59.2879818594104%,10346,14271,25320,40.8609794628752%,56.3625592417062%,0.571976579850596,0.638392421134876,0.579721330787667,19812,20478,24617
1895,32,NEW YORK,HAMILTON,1114,2388,3682,30.2552960347637%,64.8560564910375%,949,2064,3225,29.4263565891473%,64%,1178,2225,3489,33.7632559472628%,63.7718543995414%,0.681896059394632,0.685031530036509,0.653834851601528,3502,3013,3403
1896,32,NEW YORK,HERKIMER,12224,14147,27705,44.1219996390543%,51.0629850207544%,8083,16699,26255,30.7865168539326%,63.6031232146258%,9937,18870,29560,33.6163734776725%,63.8362652232747%,0.536460505858708,0.67383584859979,0.655049120005554,26371,24782,28807
1897,32,NEW YORK,JEFFERSON,16799,18192,36418,46.1282882091274%,49.9533197869186%,13809,21763,38236,36.1151794120724%,56.9175645988074%,17307,25629,44129,39.2191076163067%,58.0774547349815%,0.519905118459032,0.611801416844709,0.596911682504192,34991,35572,42936
1898,32,NEW YORK,KINGS,497468,96605,617105,80.6131857625526%,15.6545482535387%,640553,141044,805605,79.512043743522%,17.5078357259451%,703310,202772,920380,76.4151763402073%,22.0313348834177%,0.162614695500385,0.18045616858816,0.223789899810392,594073,781597,906082
1899,32,NEW YORK,LEWIS,4333,6103,10923,39.668589215417%,55.8729286825964%,3146,7400,11325,27.7792494481236%,65.3421633554084%,3824,8894,13036,29.3341515802393%,68.2264498312366%,0.584802606362591,0.701687843732221,0.699323793049222,10436,10546,12718
1900,32,NEW YORK,LIVINGSTON,10476,15244,27223,38.4821658156706%,55.9967674392977%,10697,17290,30031,35.6198594785388%,57.5738403649562%,12477,18182,31656,39.4143290371494%,57.436189032095%,0.592690513219285,0.617786829599457,0.593039564238886,25720,27987,30659
1901,32,NEW YORK,MADISON,12017,14879,28366,42.3640978636396%,52.4536416837058%,11667,15936,30064,38.8072112825971%,53.0069185737094%,14807,18408,34266,43.2119301931944%,53.7208895114691%,0.55320493753718,0.57732855124443,0.554207436399217,26896,27603,33215
1902,32,NEW YORK,MONROE,161743,141266,317762,50.9006740894128%,44.4565429472373%,188592,136582,347790,54.2258259294402%,39.2713994076885%,225746,145661,383499,58.8648210295203%,37.9821068633816%,0.466210574603395,0.420027431467461,0.392187007783914,303009,325174,371407
1903,32,NEW YORK,MONTGOMERY,10249,9765,20809,49.2527271853525%,46.9268105146812%,6595,11301,19054,34.6121549280991%,59.3103810223575%,7977,12745,21246,37.5458909912454%,59.9877624023346%,0.487908464075147,0.631481895395619,0.61504681015346,20014,17896,20722
1904,32,NEW YORK,NASSAU,341610,226954,589707,57.9287680153025%,38.4858921464388%,326088,288313,636967,51.193860906452%,45.2634123902808%,396504,326716,738369,53.6999792786534%,44.2483365363389%,0.399170541926678,0.46925867633679,0.451751887392495,568564,614401,723220
1905,32,NEW YORK,NEW YORK,449300,79921,563232,79.7717459235271%,14.1897122322595%,579013,64929,668939,86.5569207356725%,9.70626619168564%,603040,85185,701405,85.9760053036406%,12.1449091466414%,0.151016305097492,0.100830509580055,0.123774928257474,529221,643942,688225
1906,32,NEW YORK,NIAGARA,47781,40952,93257,51.2358321627331%,43.9130574648552%,35559,51961,92402,38.4829332698426%,56.2336313066817%,46029,56068,104866,43.8931588884863%,53.4663284572693%,0.461519389629563,0.593704296160878,0.549164030284925,88733,87520,102097
1907,32,NEW YORK,ONEIDA,43933,47603,95996,45.7654485603567%,49.5885245218551%,33743,51437,91009,37.0765528683976%,56.5185860739048%,41567,57180,101696,40.8737806796727%,56.2264002517306%,0.520046757559867,0.603862409016201,0.57905556624505,91536,85180,98747
1908,32,NEW YORK,ONONDAGA,109896,83678,203629,53.9687372623742%,41.0933609652849%,112337,83649,208440,53.8941661869123%,40.1309729418538%,138894,90619,235686,58.9317990886179%,38.4490381269995%,0.432279128395342,0.426811098751952,0.394831665308719,193574,195986,229513
1909,32,NEW YORK,ONTARIO,19761,23885,45948,43.0073126142596%,51.9826760685993%,22233,26029,52258,42.5446821539286%,49.8086417390639%,29025,29039,60085,48.3065656985937%,48.3298660231339%,0.54724373367548,0.539327006754797,0.50012055662717,43646,48262,58064
1910,32,NEW YORK,ORANGE,58170,62852,126549,45.9663845625015%,49.6661372274771%,68278,76645,152021,44.9135316831227%,50.4173765466613%,84684,84996,173305,48.8641412538588%,49.0441706817461%,0.519343590421576,0.528867053538776,0.500919377652051,121022,144923,169680
1911,32,NEW YORK,ORLEANS,5991,9202,15843,37.8148078015527%,58.0824338824718%,4470,10936,16380,27.2893772893773%,66.7643467643468%,5587,12126,18314,30.5067161734192%,66.21164136726%,0.60567366550385,0.709853303907568,0.684581945463784,15193,15406,17713
1912,32,NEW YORK,OSWEGO,22857,23249,48473,47.1540857797124%,47.9627834051946%,17095,27688,48180,35.4815276048153%,57.4678289746783%,21143,32138,54852,38.5455407277766%,58.5903886822723%,0.504251073612979,0.61827032579327,0.603179369756574,46106,44783,53281
1913,32,NEW YORK,OTSEGO,11460,12219,25358,45.1928385519363%,48.1859768120514%,10451,13308,25668,40.7160666978339%,51.846657316503%,12975,14382,28223,45.9731424724515%,50.9584381532792%,0.516026859242367,0.560124584368029,0.525715538984538,23679,23759,27357
1914,32,NEW YORK,PUTNAM,18525,21853,42547,43.5400850823795%,51.3620231743719%,19366,27024,48563,39.878096493215%,55.6473035026666%,24953,29283,55318,45.1082830181858%,52.9357532810297%,0.541210560206053,0.582539340375081,0.539918135555719,40378,46390,54236
1915,32,NEW YORK,QUEENS,416967,122052,555930,75.0035076358534%,21.9545626247909%,517220,149341,686393,75.3533325660372%,21.7573605791434%,569038,212665,794498,71.6223325924043%,26.7672165316967%,0.22643357655296,0.224047011451315,0.272053452526087,539019,666561,781703
1916,32,NEW YORK,RENSSELAER,34808,29562,68436,50.8621193523876%,43.1965632123444%,32717,33726,71562,45.7183980324753%,47.1283642156452%,40969,36500,79962,51.2355869037793%,45.6466821740327%,0.459251203977008,0.50759297442921,0.471156204417251,64370,66443,77469
1917,32,NEW YORK,RICHMOND,73828,63903,142121,51.947284356288%,44.9637984534305%,74143,101437,180960,40.9720380194518%,56.0549292661362%,90997,123320,217899,41.7610911477336%,56.595027971675%,0.463969621944225,0.577725253445723,0.575409323572092,137731,175580,214317
1918,32,NEW YORK,ROCKLAND,69530,48441,122580,56.7221406428455%,39.5178658835046%,69342,60911,135087,51.3313642319394%,45.0902011296424%,75802,73186,151381,50.0736552143268%,48.3455651633957%,0.410617863712268,0.467636062125249,0.491220769457943,117971,130253,148988
1919,32,NEW YORK,SARATOGA,43359,46623,95057,45.6136844209264%,49.0474136570689%,50913,54575,114094,44.6237313092713%,47.8333654705769%,68471,61305,133556,51.2676330528018%,45.9020935038486%,0.518136960725478,0.51735742454118,0.472390888916287,89982,105488,129776
1920,32,NEW YORK,SCHENECTADY,35534,27961,66946,53.0786006632211%,41.7664983718221%,33747,28953,67280,50.1590368608799%,43.0335909631391%,42465,30741,75381,56.3338241732001%,40.7808333664982%,0.440365383101032,0.46177033492823,0.419924596344562,63495,62700,73206
1921,32,NEW YORK,SCHOHARIE,5390,7459,13548,39.7844700324771%,55.0560968408621%,4240,8831,14050,30.1779359430605%,62.8540925266904%,5345,9903,15810,33.8077166350411%,62.6375711574953%,0.580512102109114,0.675617779817917,0.64946222455404,12849,13071,15248
1922,32,NEW YORK,SCHUYLER,3301,4381,8153,40.4881638660616%,53.7348215380841%,3091,5050,8772,35.2371181030552%,57.5695394436845%,3903,5621,9799,39.8305949586693%,57.3629962241045%,0.570294194220255,0.620316914383982,0.590193196136077,7682,8141,9524
1923,32,NEW YORK,SENECA,6841,6734,14333,47.7290169538827%,46.9824879648364%,5697,7236,13980,40.7510729613734%,51.7596566523605%,6914,8329,15718,43.9877847054333%,52.9902023158163%,0.496058931860037,0.559498956158664,0.546414747753067,13575,12933,15243
1924,32,NEW YORK,ST. LAWRENCE,21386,16449,39779,53.7620352447271%,41.3509640765228%,16488,19942,39158,42.1063384238214%,50.9270136370601%,19361,24608,45267,42.770671791813%,54.3618971877969%,0.434756178141932,0.547405984079056,0.559667038140508,37835,36430,43969
1925,32,NEW YORK,STEUBEN,14600,24200,40563,35.9933929936149%,59.6602815373616%,12526,26831,42002,29.8223894100281%,63.8802914146945%,15790,29474,46516,33.9453091409408%,63.3631438644767%,0.623711340206186,0.681733871992276,0.651157652880877,38800,39357,45264
1926,32,NEW YORK,SUFFOLK,306306,240992,573866,53.375875204316%,41.9944725772219%,303951,350570,681254,44.6163985826138%,51.4595143661542%,368000,375821,757877,48.5566919170261%,49.5886535677953%,0.440330496365782,0.535613066654851,0.505257313251441,547298,654521,743821
1927,32,NEW YORK,SULLIVAN,14348,12703,28524,50.3015004908148%,44.5344271490675%,12568,15931,29955,41.9562677349357%,53.1831079953263%,15489,18665,35132,44.0880109302061%,53.1282022088125%,0.469594469705371,0.559002070248079,0.54649528605727,27051,28499,34154
1928,32,NEW YORK,TIOGA,9170,12239,22454,40.8390487218313%,54.5069920726819%,7526,13260,22299,33.7503923942778%,59.4645499798197%,9634,14791,25170,38.2757250695272%,58.7644020659515%,0.571675463590079,0.63792937554123,0.605568065506653,21409,20786,24425
1929,32,NEW YORK,TOMPKINS,21807,13351,40060,54.435846230654%,33.3275087368947%,28890,10371,42678,67.6929565584142%,24.3005764093913%,33619,11096,46048,73.0085997220292%,24.09659485754%,0.379742875021332,0.264155268587148,0.248149390584815,35158,39261,44715
1930,32,NEW YORK,ULSTER,38162,33447,78225,48.7849153084052%,42.7574304889741%,42101,34006,81355,51.7497387990904%,41.7995206195071%,57970,37590,98160,59.0566422167889%,38.2946210268949%,0.467078160566409,0.446818295294782,0.39336542486396,71609,76107,95560
1931,32,NEW YORK,WARREN,12193,14993,28621,42.60158624786%,52.3846126969708%,13091,15751,31408,41.6804635761589%,50.1496434029547%,17642,17699,36394,48.4750233554982%,48.631642578447%,0.551497094092548,0.546113306982872,0.500806428793752,27186,28842,35341
1932,32,NEW YORK,WASHINGTON,9641,12596,23555,40.9297389089365%,53.474846104861%,9098,13610,24528,37.0923026744945%,55.4876060013046%,11565,15941,28256,40.9293601359003%,56.4163363533409%,0.566443315195395,0.599348247313722,0.579546280811459,22237,22708,27506
1933,32,NEW YORK,WAYNE,14977,21701,38329,39.0748519397845%,56.6177046100864%,13473,23380,39687,33.9481442285887%,58.9109784060272%,17456,26204,45031,38.7644067420222%,58.1910239612711%,0.591662577021648,0.634412395191708,0.600183234081539,36678,36853,43660
1934,32,NEW YORK,WESTCHESTER,218010,139278,371775,58.6403066370789%,37.4629816421222%,272926,131238,420655,64.8811971805874%,31.1984880721732%,312371,144713,462265,67.5740105783479%,31.305203725136%,0.389819977161282,0.324714719767223,0.316600449807913,357288,404164,457084
1935,32,NEW YORK,WYOMING,5935,10809,17627,33.6699381630453%,61.3207011970273%,3904,12442,17298,22.5690831309978%,71.927390449763%,5073,13898,19483,26.038084483909%,71.3339834727711%,0.645544672718586,0.761164810962927,0.732591850719519,16744,16346,18971
1936,32,NEW YORK,YATES,3962,5565,10052,39.4150417827298%,55.3621169916435%,3659,5660,10066,36.3500894098947%,56.2288893304192%,4219,6208,10788,39.108268446422%,57.5454208379681%,0.584129316678913,0.607361304861037,0.595377385633452,9527,9319,10427
1938,33,NORTH CAROLINA,ALAMANCE,17459,29305,47091,37.0750249516893%,62.2305748444501%,29833,38815,71157,41.9256011355172%,54.5483929901485%,38825,46056,86091,45.0976292527674%,53.4968812070948%,0.626657257719613,0.565420696888475,0.542594927015469,46764,68648,84881
1939,33,NORTH CAROLINA,ALEXANDER,4166,9242,13492,30.8775570708568%,68.4998517640083%,3767,13893,18271,20.6173717913634%,76.0385310054184%,4145,15888,20236,20.4832970942874%,78.513540225341%,0.689289976133651,0.786693091732729,0.793091399191334,13408,17660,20033
1940,33,NORTH CAROLINA,ALLEGHANY,1715,2531,4313,39.7635056805008%,58.6830512404359%,1306,3814,5315,24.5719661335842%,71.7591721542803%,1486,4527,6076,24.4568795260039%,74.506254114549%,0.59609043805935,0.744921875,0.752868784300682,4246,5120,6013
1941,33,NORTH CAROLINA,ANSON,4792,3161,7985,60.0125234815279%,39.5867251095805%,5859,4506,10545,55.5618776671408%,42.7311522048364%,5789,5321,11194,51.7152045738789%,47.5343934250491%,0.397460077958003,0.434732272069464,0.478937893789379,7953,10365,11110
1942,33,NORTH CAROLINA,ASHE,4011,6226,10316,38.8813493602171%,60.3528499418379%,3500,9412,13424,26.072705601907%,70.1132300357569%,4164,11451,15814,26.3310990261793%,72.4105223219932%,0.608185991989841,0.728934324659232,0.733333333333333,10237,12912,15615
1943,33,NORTH CAROLINA,AVERY,1686,4956,6694,25.1867343890051%,74.0364505527338%,1689,6298,8249,20.4752091162565%,76.3486483210086%,2191,7172,9458,23.1655741171495%,75.8299851977162%,0.746160794941283,0.788531363465632,0.765993805404251,6642,7987,9363
1944,33,NORTH CAROLINA,BEAUFORT,6634,10531,17313,38.3180269161901%,60.827124126379%,8764,14543,23938,36.6112457181051%,60.7527780098588%,9633,16437,26315,36.6064981949458%,62.4624738742162%,0.613515875327702,0.623975629639164,0.630494821634062,17165,23307,26070
1945,33,NORTH CAROLINA,BERTIE,4660,2488,7176,64.9386845039019%,34.6711259754738%,5778,3456,9347,61.8166256552905%,36.9744302984915%,5939,3817,9815,60.509424350484%,38.889454915945%,0.348069390039172,0.374269005847953,0.391246412464125,7148,9234,9756
1946,33,NORTH CAROLINA,BLADEN,5889,4977,10908,53.987898789879%,45.6270627062706%,7058,8550,15897,44.3983141473234%,53.7837327797698%,7326,9676,17125,42.7795620437956%,56.5021897810219%,0.458034235229155,0.547796002050231,0.569109516527467,10866,15608,17002
1947,33,NORTH CAROLINA,BRUNSWICK,13118,15427,28839,45.4870141128333%,53.4935330628663%,23282,42720,68351,34.0624131322146%,62.5009143977411%,33310,55850,90175,36.9392847241475%,61.9351261436097%,0.540444911543177,0.647253113542014,0.626401973979363,28545,66002,89160
1948,33,NORTH CAROLINA,BUNCOMBE,38545,46101,85476,45.0945294585615%,53.9344377369086%,75452,55716,138947,54.3027197420599%,40.0987426860602%,96515,62412,161569,59.7360879871758%,38.6286973367416%,0.544632941899204,0.42476823615516,0.392708602062582,84646,131168,158927
1949,33,NORTH CAROLINA,BURKE,11924,18466,30658,38.8936003653206%,60.2322395459586%,11251,26238,38920,28.9080164439877%,67.415210688592%,13118,31019,44602,29.4112371642527%,69.5462086901933%,0.607634090161237,0.699885299687908,0.70278904320638,30390,37489,44137
1950,33,NORTH CAROLINA,CABARRUS,16284,32704,49381,32.9762459245459%,66.2279014195743%,35521,53819,93289,38.0763005284653%,57.6906173289455%,52162,63237,117227,44.4965750211129%,53.9440572564341%,0.667592063362456,0.60240653682561,0.547985684451338,48988,89340,115399
1951,33,NORTH CAROLINA,CALDWELL,8588,17337,26115,32.8853149530921%,66.3871338311315%,8425,26621,36320,23.1965859030837%,73.295704845815%,10245,32119,42829,23.9207079315417%,74.9935791169535%,0.668736740597878,0.759601666381327,0.758167311868568,25925,35046,42364
1952,33,NORTH CAROLINA,CAMDEN,1187,1628,2831,41.9286471211586%,57.5061815612858%,1274,3546,5006,25.4494606472233%,70.8349980023971%,1537,4312,5953,25.8189148328574%,72.4340668570469%,0.578330373001776,0.735684647302905,0.737220037613267,2815,4820,5849
1953,33,NORTH CAROLINA,CARTERET,8839,17381,26461,33.4038774044821%,65.6853482483655%,9939,26569,37781,26.3068738254678%,70.3237076837564%,12093,30028,42695,28.3241597376742%,70.331420541047%,0.662890922959573,0.727758299550783,0.712898554165381,26220,36508,42121
1954,33,NORTH CAROLINA,CASWELL,4091,4270,8422,48.5751602944669%,50.7005461885538%,4792,6026,11070,43.2881662149955%,54.4354110207769%,4860,7089,12051,40.3286034353996%,58.8249937764501%,0.510704461188853,0.557034572009614,0.593271403464725,8361,10818,11949
1955,33,NORTH CAROLINA,CATAWBA,16246,34244,50841,31.9545248913279%,67.3550874294369%,21216,48324,72351,29.3237135630468%,66.7910602479579%,25689,56588,83425,30.7929277794426%,67.830985915493%,0.678233313527431,0.694909404659189,0.687774226089916,50490,69540,82277
1956,33,NORTH CAROLINA,CHATHAM,10461,10248,20931,49.9785007883044%,48.9608714347141%,21065,17105,39849,52.8620542548119%,42.9245401390248%,26787,21186,48599,55.118418074446%,43.5934895779748%,0.49485730841663,0.448126801152738,0.441623413169908,20709,38170,47973
1957,33,NORTH CAROLINA,CHEROKEE,3239,6305,9674,33.4814967955344%,65.1746950589208%,2860,10844,14181,20.1678301953318%,76.4685142091531%,3583,12628,16423,21.816964013883%,76.8921634293369%,0.660624476110645,0.791301809690601,0.77897723767812,9544,13704,16211
1958,33,NORTH CAROLINA,CHOWAN,2430,2415,4890,49.6932515337423%,49.3865030674847%,2992,4014,7228,41.3945766463752%,55.5340343110127%,3247,4471,7784,41.7137718396711%,57.4383350462487%,0.498452012383901,0.57293748215815,0.579295154185022,4845,7006,7718
1959,33,NORTH CAROLINA,CLAY,1361,2416,3852,35.3322949117342%,62.7206645898235%,1367,4437,6010,22.7454242928453%,73.8269550748752%,1699,5112,6893,24.6481938198172%,74.1621935296678%,0.639661106698438,0.7644727773949,0.750550579944208,3777,5804,6811
1960,33,NORTH CAROLINA,CLEVELAND,13455,19064,32746,41.0889879679961%,58.2177975935992%,14964,28479,44673,33.496742999127%,63.7499160566785%,16955,33798,51308,33.0455289623451%,65.8727683792001%,0.586241889356991,0.655548649955114,0.665931077965834,32519,43443,50753
1961,33,NORTH CAROLINA,COLUMBUS,9986,8342,18425,54.1981004070556%,45.2754409769335%,9063,14272,23732,38.1889431990561%,60.1382100117984%,9446,16832,26446,35.7180670044619%,63.6466762459351%,0.455150589262331,0.611613456181701,0.64053580942233,18328,23335,26278
1962,33,NORTH CAROLINA,CRAVEN,12213,19494,31985,38.1835235266531%,60.9473190558074%,17630,27731,47001,37.5098402161656%,59.0008723218655%,21148,31032,53065,39.8530104588712%,58.4792235937058%,0.614816917399943,0.611340138004012,0.594710617094672,31707,45361,52180
1963,33,NORTH CAROLINA,CUMBERLAND,38626,38129,77151,50.0654560537129%,49.4212647924201%,71605,51265,127506,56.1581415776512%,40.2059510924976%,84469,60032,147150,57.40332993544%,40.7964661909616%,0.496762425900593,0.417229592251974,0.415443491740542,76755,122870,144501
1964,33,NORTH CAROLINA,CURRITUCK,2595,4095,6739,38.5071969134886%,60.7656922392046%,2913,9163,12669,22.9931328439498%,72.3261504459705%,4195,11657,16147,25.9800582151483%,72.1929770235957%,0.612107623318386,0.758777740973832,0.735364622760535,6690,12076,15852
1965,33,NORTH CAROLINA,DARE,5589,7301,13002,42.9856945085372%,56.1528995539148%,7222,11460,19609,36.8300270284053%,58.4425518894385%,9936,13938,24232,41.0036315615715%,57.51898316276%,0.566408068269977,0.613424686864361,0.583815028901734,12890,18682,23874
1966,33,NORTH CAROLINA,DAVIDSON,16199,35387,52047,31.1237919572694%,67.990470151978%,18109,54317,74856,24.1917815539168%,72.5619856791707%,22636,64658,88514,25.5733556273584%,73.0483313374156%,0.685980692435932,0.749965482009223,0.740692372900772,51586,72426,87294
1967,33,NORTH CAROLINA,DAVIE,3651,10184,13998,26.0822974710673%,72.753250464352%,5270,15602,21756,24.2232027946314%,71.7135502849789%,6713,18228,25311,26.5220655051164%,72.0161194737466%,0.73610408384532,0.747508623993867,0.730844793713163,13835,20872,24941
1968,33,NORTH CAROLINA,DUPLIN,6475,7840,14390,44.9965253648367%,54.4822793606671%,8283,12217,20856,39.7151898734177%,58.5778672803989%,8767,13793,22715,38.5956416464891%,60.7219898745323%,0.547677261613692,0.595951219512195,0.611391843971631,14315,20500,22560
1969,33,NORTH CAROLINA,DURHAM,53907,30150,84604,63.716845539218%,35.6366129261028%,121250,28350,156134,77.6576530416181%,18.1574801132361%,144688,32459,179914,80.4206454194782%,18.0413975566104%,0.358685177914986,0.189505347593583,0.183232005057946,84057,149600,177147
1970,33,NORTH CAROLINA,EDGECOMBE,11315,6836,18202,62.1634985166465%,37.5563124931326%,16224,8261,24886,65.1932813630154%,33.1953708912642%,16089,9206,25477,63.151077442399%,36.1345527338384%,0.376618368133987,0.337390238921789,0.36394544376359,18151,24485,25295
1971,33,NORTH CAROLINA,FORSYTH,52457,67700,120942,43.3736832531296%,55.9772452911313%,94464,75975,178312,52.9768047018709%,42.6079007582216%,113033,85064,201270,56.1598847319521%,42.2636259750584%,0.563429513053755,0.445760653371587,0.429405796150371,120157,170439,198097
1972,33,NORTH CAROLINA,FRANKLIN,7454,8501,16051,46.4394741760638%,52.962432247212%,12874,16368,30368,42.3933087460485%,53.8988408851423%,15879,20901,37351,42.5129179941635%,55.9583411421381%,0.532811031024757,0.559742835647356,0.568270799347471,15955,29242,36780
1973,33,NORTH CAROLINA,GASTON,19281,39453,59179,32.5808141401511%,66.6672299295358%,31177,61798,96431,32.3308894442658%,64.0852008171646%,40959,73033,115498,35.4629517394241%,63.2331295780014%,0.671723362958423,0.664673299273998,0.640685311249912,58734,92975,113992
1974,33,NORTH CAROLINA,GATES,1944,1480,3446,56.4132327336042%,42.9483459082995%,2385,2874,5392,44.2321958456973%,53.3011869436202%,2546,3367,5971,42.6394238820968%,56.3892145369285%,0.432242990654206,0.546491728465488,0.569423304583122,3424,5259,5913
1975,33,NORTH CAROLINA,GRAHAM,1006,2304,3361,29.9315679857185%,68.5510264802142%,768,3283,4168,18.426103646833%,78.7667946257198%,905,3710,4665,19.3997856377278%,79.5284030010718%,0.69607250755287,0.810417180942977,0.803900325027086,3310,4051,4615
1976,33,NORTH CAROLINA,GRANVILLE,7733,7364,15194,50.8950901671713%,48.4664999341845%,12909,13591,27353,47.194092055716%,49.6874200270537%,14565,16647,31598,46.0946895373125%,52.683714159124%,0.487779028946148,0.512867924528302,0.533352556708958,15097,26500,31212
1977,33,NORTH CAROLINA,GREENE,2478,3353,5870,42.2146507666099%,57.1209540034072%,3605,4374,8095,44.5336627547869%,54.0333539221742%,3832,4874,8753,43.7792756769108%,55.6837655660916%,0.575030012004802,0.548188996114801,0.559843785894785,5831,7979,8706
1978,33,NORTH CAROLINA,GUILFORD,80787,84394,166264,48.5895924553722%,50.7590338257229%,149248,98062,257405,57.9817796857093%,38.096385074105%,173086,107294,284486,60.8416582889844%,37.7150369438215%,0.510918325957586,0.396514495976709,0.382673514516014,165181,247310,280380
1979,33,NORTH CAROLINA,HALIFAX,10222,6698,16970,60.2357100766058%,39.469652327637%,15748,9031,25167,62.5740056423094%,35.8842929232725%,15545,10080,25759,60.3478395900462%,39.1319538801972%,0.395862884160756,0.364461842689374,0.393365853658537,16920,24779,25625
1980,33,NORTH CAROLINA,HARNETT,9155,14762,24167,37.8822361070882%,61.083295402822%,16737,27614,46065,36.3334418756106%,59.9457288613915%,22093,35177,58293,37.8999193728235%,60.3451529343146%,0.617217878496467,0.62262406710108,0.614230836389034,23917,44351,57270
1981,33,NORTH CAROLINA,HAYWOOD,9793,12118,22273,43.9680330444933%,54.4066807345216%,10473,18929,30727,34.0840303316302%,61.6038012171706%,13144,22834,36542,35.9695692627661%,62.4870012588255%,0.553055542878006,0.643799741514183,0.634665628995497,21911,29402,35978
1982,33,NORTH CAROLINA,HENDERSON,12562,25688,38607,32.5381407516772%,66.5371564742145%,19827,35809,58176,34.0810643564356%,61.5528740374037%,27211,40032,68371,39.7990376036624%,58.5511401032602%,0.671581699346405,0.643630023725645,0.595333343247624,38250,55636,67243
1983,33,NORTH CAROLINA,HERTFORD,5484,2382,7897,69.4440926934279%,30.1633531720907%,6910,3099,10186,67.8382093068918%,30.4241115256234%,7097,3479,10634,66.7387624600339%,32.7158171901448%,0.302822273073989,0.309621340793286,0.328952344931921,7866,10009,10576
1984,33,NORTH CAROLINA,HOKE,5017,3439,8582,58.4595665346073%,40.0722442321137%,9726,7760,18230,53.3516182117389%,42.5671969281404%,11804,9453,21639,54.5496557142197%,43.6850131706641%,0.406693472090823,0.443783598307217,0.444700569224256,8456,17486,21257
1985,33,NORTH CAROLINA,HYDE,1088,1132,2237,48.6365668305767%,50.6034868126956%,965,1288,2304,41.8836805555556%,55.9027777777778%,1046,1418,2492,41.9743178170145%,56.9020866773676%,0.50990990990991,0.571682201509099,0.575487012987013,2220,2253,2464
1986,33,NORTH CAROLINA,IREDELL,15434,29853,45586,33.8568858860176%,65.487210985829%,24734,54754,82567,29.9562779318614%,66.3146293313309%,33888,67010,102371,33.1031249084213%,65.4579910326167%,0.659195795702961,0.688833534621578,0.664136058197387,45287,79488,100898
1987,33,NORTH CAROLINA,JACKSON,5722,6237,12121,47.2073261282072%,51.4561504826335%,7713,9870,18713,41.2173355421365%,52.7440816544648%,9591,11356,21428,44.7591935784954%,52.9960798954639%,0.52153190066059,0.561337655690155,0.542130137967251,11959,17583,20947
1988,33,NORTH CAROLINA,JOHNSTON,13704,27212,41155,33.2985056493743%,66.1207629692625%,28362,54372,85909,33.0140031894214%,63.2902257039425%,41257,68353,111357,37.0493098772417%,61.3818619395278%,0.665069899305895,0.657190514177968,0.623601861144056,40916,82734,109610
1989,33,NORTH CAROLINA,JONES,1822,2114,3964,45.9636730575177%,53.3299697275479%,2065,2974,5135,40.2142161635833%,57.9162609542357%,2197,3280,5525,39.7647058823529%,59.3665158371041%,0.537093495934959,0.590196467553086,0.598867993427059,3936,5039,5477
1990,33,NORTH CAROLINA,LEE,6785,9406,16283,41.6692255726832%,57.7657679788737%,10469,13712,25084,41.7357678201244%,54.6643278583958%,12143,16469,29008,41.8608659680088%,56.7739933811362%,0.580940028410846,0.56705678011662,0.575597651335104,16191,24181,28612
1991,33,NORTH CAROLINA,LENOIR,9527,11512,21163,45.0172470821717%,54.3968246467892%,12634,13613,26807,47.1294811056814%,50.7815122915656%,13605,14590,28409,47.8897532472104%,51.3569643422859%,0.547174295356243,0.51864975044767,0.517467636105692,21039,26247,28195
1992,33,NORTH CAROLINA,LINCOLN,8412,15951,24529,34.2941008602063%,65.0291491703698%,9897,28806,40023,24.728281238288%,71.9736151712765%,13274,36341,50217,26.4332795666806%,72.3679232132545%,0.654722324836843,0.744283388884583,0.732459941549935,24363,38703,49615
1993,33,NORTH CAROLINA,MACON,4683,8406,13234,35.386126643494%,63.5182106694877%,4876,12127,17734,27.4952069471073%,68.3827675651291%,6230,14211,20743,30.0342284144049%,68.5098587475293%,0.642218656887463,0.713227077574546,0.695220390391859,13089,17003,20441
1994,33,NORTH CAROLINA,MADISON,3505,4676,8325,42.1021021021021%,56.1681681681682%,3926,6783,11269,34.8389386813382%,60.1916762800604%,4901,7979,13076,37.4808810033649%,61.0201896604466%,0.571568267937905,0.633392473620319,0.619487577639752,8181,10709,12880
1995,33,NORTH CAROLINA,MARTIN,4929,4420,9366,52.6265214606022%,47.1919709587871%,5846,5897,11964,48.8632564359746%,49.2895352724841%,5911,6532,12540,47.1371610845295%,52.0893141945774%,0.47277783720184,0.502171506429362,0.524953789279113,9349,11743,12443
1996,33,NORTH CAROLINA,MCDOWELL,4747,9109,14011,33.8805224466491%,65.0132039112126%,4667,14568,19875,23.4817610062893%,73.2981132075472%,5832,16883,23003,25.3532147980698%,73.3947745946181%,0.657404734411086,0.757369378736678,0.743253356812679,13856,19235,22715
1997,33,NORTH CAROLINA,MECKLENBURG,126911,134068,263036,48.2485287185024%,50.9694490487994%,294562,155518,472857,62.2940973698179%,32.8890129574057%,378107,179211,567053,66.6793051090463%,31.6039241481837%,0.513711831220137,0.345534127266264,0.321559684058293,260979,450080,557318
1998,33,NORTH CAROLINA,MITCHELL,1535,4984,6600,23.2575757575758%,75.5151515151515%,1596,6282,8096,19.7134387351779%,77.5938735177866%,1867,7090,9041,20.6503705342329%,78.4205287025772%,0.764534437797208,0.797410510281797,0.79155967399799,6519,7878,8957
1999,33,NORTH CAROLINA,MONTGOMERY,3979,4946,8974,44.3392021395142%,55.1147760196122%,4150,7130,11540,35.9618717504333%,61.7850953206239%,4327,8411,12849,33.6757724336524%,65.4603471087244%,0.554173669467787,0.63209219858156,0.660307740618621,8925,11280,12738
2000,33,NORTH CAROLINA,MOORE,11232,19882,31301,35.8838375770742%,63.5187374205297%,16329,30490,48692,33.5352830033681%,62.6180892138339%,20779,36764,58339,35.6176828536656%,63.0178782632544%,0.6390049495404,0.651231337704778,0.63889612985072,31114,46819,57543
2001,33,NORTH CAROLINA,NASH,12376,17995,30513,40.5597614131682%,58.9748631730738%,23235,23319,47665,48.7464596664219%,48.9226896045316%,25947,25827,52271,49.6393793881885%,49.4098065849132%,0.592506009021764,0.500902178115737,0.498841117163055,30371,46554,51774
2002,33,NORTH CAROLINA,NEW HANOVER,29292,36503,66319,44.1683378820549%,55.0415416396508%,50979,55344,111905,45.55560520084%,49.4562351994996%,66138,63331,131830,50.1691572479709%,48.0398998710461%,0.554798996884262,0.52052707316385,0.489159567155072,65795,106323,129469
2003,33,NORTH CAROLINA,NORTHAMPTON,5513,2667,8200,67.2317073170732%,32.5243902439024%,6144,3582,9848,62.3883021933388%,36.3728675873274%,6069,3989,10110,60.0296735905045%,39.4559841740851%,0.326039119804401,0.368291178285009,0.396599721614635,8180,9726,10058
2004,33,NORTH CAROLINA,ONSLOW,10269,19657,30215,33.9864305808373%,65.0570908489161%,17514,37122,57135,30.6537148857968%,64.9724337096351%,24266,46078,72235,33.5931335225306%,63.7890219422718%,0.656853572144623,0.679442126070723,0.655038098487433,29926,54636,70344
2005,33,NORTH CAROLINA,ORANGE,30921,17930,49344,62.6641536964981%,36.336738002594%,59923,18557,82340,72.7750789409764%,22.5370415350984%,63594,20176,84997,74.8191112627505%,23.7373083755897%,0.367034451700068,0.236455147808359,0.240849946281485,48851,78480,83770
2006,33,NORTH CAROLINA,PAMLICO,2188,2999,5242,41.7397939717665%,57.2109881724533%,2448,4258,6870,35.6331877729258%,61.9796215429403%,2713,4849,7631,35.5523522474119%,63.5434412265758%,0.578176209755157,0.634953772740829,0.641232478180376,5187,6706,7562
2007,33,NORTH CAROLINA,PASQUOTANK,5874,4943,10903,53.8750802531413%,45.3361460148583%,8615,8180,17391,49.5371168995457%,47.0358231269047%,9832,9770,19897,49.4144845956677%,49.1028798311303%,0.456965887029676,0.487049717177731,0.498418528721559,10817,16795,19602
2008,33,NORTH CAROLINA,PENDER,6415,7661,14154,45.3228769252508%,54.126042108238%,9354,17639,27885,33.5449166218397%,63.2562309485386%,11723,21956,34169,34.308876466973%,64.2570751265767%,0.544259732878659,0.653465713333086,0.651919593812168,14076,26993,33679
2009,33,NORTH CAROLINA,PERQUIMANS,2033,2230,4306,47.2131908964236%,51.7882025081282%,2319,4177,6708,34.5706618962433%,62.2689326177698%,2492,4903,7484,33.2977017637627%,65.5130946018172%,0.523105794041755,0.643011083743842,0.663015551048005,4263,6496,7395
2010,33,NORTH CAROLINA,PERSON,5042,6722,11833,42.6096509760838%,56.8072340065917%,7833,11185,19615,39.9337241906704%,57.0226867193474%,8465,13184,21894,38.6635607929113%,60.2174111628757%,0.571404284257056,0.58812703754338,0.60898886784609,11764,19018,21649
2011,33,NORTH CAROLINA,PITT,19685,23192,43075,45.6993615786419%,53.8409750435287%,41824,35691,80527,51.9378593515219%,44.3217802724552%,47252,38982,87573,53.9572699347973%,44.5137199821863%,0.54089605149614,0.460439914855189,0.452049075770578,42877,77515,86234
2012,33,NORTH CAROLINA,POLK,3114,5074,8303,37.504516439841%,61.1104420089125%,3735,6768,10934,34.1595024693616%,61.8986647155661%,4518,7689,12358,36.5593138048228%,62.2188056319793%,0.619687347337567,0.644387317909169,0.629884492504301,8188,10503,12207
2013,33,NORTH CAROLINA,RANDOLPH,11366,30959,42696,26.6207607270002%,72.5103054150272%,13194,49430,64575,20.4320557491289%,76.5466511807975%,15618,56894,73316,21.3023078182116%,77.601069343663%,0.731458948611931,0.789314001021972,0.784614960282436,42325,62624,72512
2014,33,NORTH CAROLINA,RICHMOND,7935,6263,14269,55.6100637746163%,43.8923540542435%,8501,10383,19328,43.9828228476821%,53.7199917218543%,8754,11830,20763,42.1615373500939%,56.9763521649087%,0.441118467389773,0.549830544376191,0.574718227749708,14198,18884,20584
2015,33,NORTH CAROLINA,ROBESON,17834,11721,29747,59.9522640938582%,39.4022926681682%,19016,20762,40858,46.5416809437564%,50.815017866758%,19020,27806,47188,40.3068576756803%,58.9259981351191%,0.396582642530875,0.521946804766454,0.59381540169991,29555,39778,46826
2016,33,NORTH CAROLINA,ROCKINGHAM,13260,18979,32528,40.7648794884407%,58.3466551893753%,14228,26830,42278,33.653436775628%,63.4609016509769%,15992,31301,47809,33.4497688719697%,65.4709364345625%,0.588696919879649,0.653465828827512,0.661852705474383,32239,41058,47293
2017,33,NORTH CAROLINA,ROWAN,14891,28922,44133,33.7411913987266%,65.5337275961299%,19400,42810,64369,30.138731376905%,66.5071696002734%,23114,49297,73408,31.4870313862249%,67.1548060156931%,0.660123707575377,0.688153030059476,0.68079435444891,43813,62210,72411
2018,33,NORTH CAROLINA,RUTHERFORD,7697,13755,21716,35.4439123227114%,63.3403941794069%,7512,21871,30307,24.7863529877586%,72.1648464051209%,9135,24891,34429,26.5328647361236%,72.296610415638%,0.641198955808316,0.744341966443181,0.731528830894022,21452,29383,34026
2019,33,NORTH CAROLINA,SAMPSON,8768,10410,19239,45.5740942876449%,54.108841415874%,10547,14838,25928,40.678031471768%,57.2277074976859%,10966,17411,28618,38.318540778531%,60.8393318890209%,0.542809469183439,0.58451841638763,0.613560277689678,19178,25385,28377
2020,33,NORTH CAROLINA,SCOTLAND,5627,3740,9403,59.842603424439%,39.7745400404126%,7319,6256,13928,52.5488225157955%,44.9167145318782%,7186,7473,14775,48.6362098138748%,50.5786802030457%,0.399274047186933,0.460847145488029,0.509789207995088,9367,13575,14659
2021,33,NORTH CAROLINA,STANLY,7066,15548,22818,30.9667806117977%,68.1391883600666%,7094,21964,29917,23.7122706153692%,73.4164521843768%,8129,25458,33939,23.9517958690592%,75.0110492353929%,0.68753869284514,0.755867575194439,0.757971834340667,22614,29058,33587
2022,33,NORTH CAROLINA,STOKES,5030,12028,17182,29.2748224886509%,70.0034920265394%,4665,17116,22550,20.6873614190687%,75.9024390243903%,5286,20142,25701,20.5672931014357%,78.3704914205673%,0.705123695626685,0.785822505853726,0.792118924020765,17058,21781,25428
2023,33,NORTH CAROLINA,SURRY,7757,15401,23358,33.2091788680538%,65.934583440363%,7488,23671,32196,23.2575475214312%,73.5215554727295%,8721,27538,36638,23.8031551940608%,75.1623996943065%,0.665040158908369,0.75968420039154,0.759480404864999,23158,31159,36259
2024,33,NORTH CAROLINA,SWAIN,2097,2224,4370,47.9862700228833%,50.8924485125858%,2196,3565,6124,35.8589157413455%,58.2135858915741%,2780,4161,7068,39.3322014714205%,58.8709677419355%,0.514695672298079,0.618816177746919,0.599481342746002,4321,5761,6941
2025,33,NORTH CAROLINA,TRANSYLVANIA,5044,9011,14225,35.4586994727592%,63.3462214411248%,6558,10520,17869,36.7004309138732%,58.8729083888298%,8444,11636,20404,41.3840423446383%,57.0280337188787%,0.641124155104945,0.615997189366436,0.579482071713147,14055,17078,20080
2026,33,NORTH CAROLINA,TYRRELL,849,706,1566,54.2145593869732%,45.0830140485313%,720,975,1739,41.4031052328925%,56.0667050028752%,758,1044,1817,41.7171161254816%,57.4573472757292%,0.454019292604502,0.575221238938053,0.579356270810211,1555,1695,1802
2027,33,NORTH CAROLINA,UNION,14890,31876,47161,31.5726977799453%,67.5897457645088%,34337,66707,105710,32.4822627944376%,63.1037744773437%,48725,80382,131011,37.191533535352%,61.355153384067%,0.681606295171706,0.660177744348996,0.622599859031656,46766,101044,129107
2028,33,NORTH CAROLINA,VANCE,7092,5564,12701,55.8381229824423%,43.8075742067554%,12229,7332,19977,61.2153977073635%,36.7022075386695%,12431,8391,20999,59.1980570503357%,39.9590456688414%,0.439633375474083,0.37482746280865,0.402987225050427,12656,19561,20822
2029,33,NORTH CAROLINA,WAKE,123466,142494,268220,46.0316158377451%,53.125792260085%,302736,196082,527624,57.3772231740785%,37.1632071323518%,393336,226197,631830,62.2534542519349%,35.8002943829828%,0.535772296585953,0.393093272496181,0.365108880398623,265960,498818,619533
2030,33,NORTH CAROLINA,WARREN,4576,2202,6795,67.3436350257542%,32.4061810154525%,6413,3214,9842,65.1595204226783%,32.6559642349116%,6400,3752,10293,62.1781793451861%,36.4519576411153%,0.324874594275597,0.333852705931235,0.369582348305753,6778,9627,10152
2031,33,NORTH CAROLINA,WASHINGTON,2704,2169,4890,55.2965235173824%,44.3558282208589%,3510,2564,6165,56.9343065693431%,41.5896188158962%,3396,2781,6205,54.7300564061241%,44.8186946011281%,0.445105684383337,0.422127099110965,0.450218552695483,4873,6074,6177
2032,33,NORTH CAROLINA,WATAUGA,7959,10438,18723,42.5092132671046%,55.7496127757304%,14138,13697,29985,47.1502417875604%,45.6795064198766%,17122,14451,32220,53.1409062693979%,44.8510242085661%,0.567375115507963,0.492078318663553,0.457701200392741,18397,27835,31573
2033,33,NORTH CAROLINA,WAYNE,13005,20758,33884,38.3809467595325%,61.2619525439736%,21770,27540,50689,42.9481741600742%,54.3313144863777%,24215,30709,55537,43.601562922016%,55.294668419252%,0.614815034209045,0.558507402149665,0.559118054038308,33763,49310,54924
2034,33,NORTH CAROLINA,WILKES,7226,16826,24323,29.7085063520125%,69.1773218764133%,6638,23752,31296,21.2103783231084%,75.8946830265849%,7511,27592,35466,21.1780296622117%,77.798454858174%,0.699567603525694,0.781572885817703,0.786029684072586,24052,30390,35103
2035,33,NORTH CAROLINA,WILSON,11266,13466,24826,45.3798437122372%,54.241520986063%,19663,17531,38135,51.5615576242297%,45.9708928805559%,20754,19581,40735,50.9488155149135%,48.0692279366638%,0.544476791201682,0.471339463354304,0.485459278542209,24732,37194,40335
2036,33,NORTH CAROLINA,YADKIN,3127,10435,13682,22.8548457827803%,76.2680894606052%,3160,13880,17624,17.9300953245574%,78.7562414888788%,3763,15933,19923,18.8877177131958%,79.9728956482457%,0.769429287715676,0.814553990610329,0.80894597887896,13562,17040,19696
2037,33,NORTH CAROLINA,YANCEY,3714,4970,8764,42.3779096303058%,56.7092651757188%,3196,6385,9960,32.0883534136546%,64.1064257028112%,3688,7516,11352,32.4876673713883%,66.2085976039464%,0.572316904652234,0.666423129109696,0.670831845769368,8684,9581,11204
2039,34,NORTH DAKOTA,ADAMS,286,826,1160,24.6551724137931%,71.2068965517241%,216,909,1218,17.7339901477833%,74.6305418719212%,258,981,1269,20.3309692671395%,77.3049645390071%,0.742805755395684,0.808,0.791767554479419,1112,1125,1239
2040,34,NORTH DAKOTA,BARNES,1933,3452,5748,33.6290883785665%,60.0556715379262%,1597,3160,5344,29.8839820359281%,59.1317365269461%,1820,3568,5565,32.7044025157233%,64.115004492363%,0.641039925719591,0.664284212739121,0.662212323682257,5385,4757,5388
2041,34,NORTH DAKOTA,BENSON,952,1055,2154,44.196843082637%,48.9786443825441%,842,929,2011,41.8697165589259%,46.1959224266534%,822,1094,1961,41.9173890872004%,55.7878633350332%,0.525660189337319,0.524562394127612,0.57098121085595,2007,1771,1916
2042,34,NORTH DAKOTA,BILLINGS,82,394,525,15.6190476190476%,75.0476190476191%,59,495,605,9.75206611570248%,81.8181818181818%,72,541,635,11.3385826771654%,85.1968503937008%,0.827731092436975,0.893501805054152,0.882544861337684,476,554,613
2043,34,NORTH DAKOTA,BOTTINEAU,1173,2349,3690,31.7886178861789%,63.6585365853659%,736,2494,3494,21.0646823125358%,71.3795077275329%,821,2575,3471,23.6531259003169%,74.1861135119562%,0.66695059625213,0.772136222910217,0.758244994110718,3522,3230,3396
2044,34,NORTH DAKOTA,BOWMAN,330,1080,1471,22.4337185588035%,73.4194425560843%,227,1446,1787,12.7028539451595%,80.917739227756%,228,1395,1657,13.7598068799034%,84.1882920941461%,0.765957446808511,0.864315600717274,0.859519408502773,1410,1673,1623
2045,34,NORTH DAKOTA,BURKE,296,698,1039,28.4889316650626%,67.1799807507219%,119,895,1052,11.3117870722433%,85.0760456273764%,137,994,1155,11.8614718614719%,86.0606060606061%,0.702213279678068,0.882642998027613,0.878868258178603,994,1014,1131
2046,34,NORTH DAKOTA,BURLEIGH,9842,22467,34482,28.5424279334145%,65.1557334261354%,10881,32532,47979,22.6786719189645%,67.8046645407366%,14348,34744,50753,28.2702500344807%,68.457037022442%,0.695378996564425,0.74936079054661,0.70773242076102,32309,43413,49092
2047,34,NORTH DAKOTA,CASS,21451,33536,58995,36.3607085346216%,56.8454953809645%,31361,39816,80821,38.8030338649608%,49.2644238502369%,40311,42619,86053,46.8443865989565%,49.5264546267998%,0.609889610271519,0.559394186324234,0.51391535029543,54987,71177,82930
2048,34,NORTH DAKOTA,CAVALIER,618,1513,2371,26.0649514972585%,63.8127372416702%,476,1357,2006,23.728813559322%,67.6470588235294%,474,1499,2020,23.4653465346535%,74.2079207920792%,0.709995307367433,0.740316421167485,0.759756715661429,2131,1833,1973
2049,34,NORTH DAKOTA,DICKEY,806,1853,2786,28.9303661162958%,66.5111270638909%,554,1667,2407,23.0162027420025%,69.2563356875779%,608,1742,2424,25.0825082508251%,71.8646864686469%,0.696878525761565,0.75056280954525,0.741276595744681,2659,2221,2350
2050,34,NORTH DAKOTA,DIVIDE,306,443,794,38.5390428211587%,55.7934508816121%,245,867,1219,20.0984413453651%,71.123872026251%,265,904,1202,22.0465890183028%,75.2079866888519%,0.591455273698264,0.779676258992806,0.773310521813516,749,1112,1169
2051,34,NORTH DAKOTA,DUNN,474,1124,1728,27.4305555555556%,65.0462962962963%,358,1771,2243,15.9607668301382%,78.9567543468569%,342,1951,2338,14.6278870829769%,83.4473909324209%,0.703379224030037,0.831845937059652,0.850850414304405,1598,2129,2293
2052,34,NORTH DAKOTA,EDDY,458,703,1268,36.1198738170347%,55.4416403785489%,355,791,1231,28.838342810723%,64.2567018683997%,383,854,1261,30.3727200634417%,67.7240285487708%,0.605512489233419,0.69022687609075,0.690379951495554,1161,1146,1237
2053,34,NORTH DAKOTA,EMMONS,405,1430,1992,20.3313253012048%,71.7871485943775%,215,1677,1981,10.8531044926805%,84.6542150429076%,237,1738,2009,11.7969138875062%,86.5107018417123%,0.779291553133515,0.886363636363636,0.88,1835,1892,1975
2054,34,NORTH DAKOTA,FOSTER,474,1172,1743,27.1944922547332%,67.2403901319564%,347,1241,1719,20.1861547411286%,72.1931355439209%,373,1362,1778,20.9786276715411%,76.6029246344207%,0.712029161603888,0.781486146095718,0.785014409221902,1646,1588,1735
2055,34,NORTH DAKOTA,GOLDEN VALLEY,156,611,812,19.2118226600985%,75.2463054187192%,99,796,957,10.3448275862069%,83.1765935214211%,137,871,1026,13.3528265107212%,84.8927875243665%,0.796610169491525,0.889385474860335,0.864087301587302,767,895,1008
2056,34,NORTH DAKOTA,GRAND FORKS,10593,15875,28385,37.3190065175269%,55.9274264576361%,10851,16340,30365,35.7352214720896%,53.8119545529392%,12880,16987,30970,41.5886341620923%,54.8498546980949%,0.599780867462596,0.60093413261741,0.568754813004319,26468,27191,29867
2057,34,NORTH DAKOTA,GRANT,235,1077,1427,16.4681149264191%,75.4730203223546%,185,1108,1381,13.3960897900072%,80.231716147719%,207,1145,1381,14.9891383055757%,82.9109341057205%,0.820884146341463,0.8569218870843,0.84689349112426,1312,1293,1352
2058,34,NORTH DAKOTA,GRIGGS,484,920,1469,32.9475833900613%,62.6276378488768%,298,847,1265,23.5573122529644%,66.9565217391304%,308,907,1250,24.64%,72.56%,0.655270655270655,0.739737991266376,0.746502057613169,1404,1145,1215
2059,34,NORTH DAKOTA,HETTINGER,353,1057,1519,23.2389730085583%,69.5852534562212%,168,1050,1296,12.962962962963%,81.0185185185185%,196,1091,1312,14.9390243902439%,83.1554878048781%,0.749645390070922,0.862068965517241,0.847707847707848,1410,1218,1287
2060,34,NORTH DAKOTA,KIDDER,283,837,1276,22.1786833855799%,65.5956112852665%,179,1111,1376,13.0087209302326%,80.7412790697675%,221,1215,1460,15.1369863013699%,83.2191780821918%,0.747321428571429,0.861240310077519,0.846100278551532,1120,1290,1436
2061,34,NORTH DAKOTA,LAMOURE,689,1590,2468,27.9173419773096%,64.4246353322528%,502,1481,2151,23.3379823337982%,68.8516968851697%,527,1645,2219,23.7494366831906%,74.1324921135647%,0.697674418604651,0.746848209783157,0.757366482504604,2279,1983,2172
2062,34,NORTH DAKOTA,LOGAN,223,812,1145,19.4759825327511%,70.9170305676856%,114,888,1067,10.6841611996251%,83.223992502343%,128,930,1076,11.8959107806691%,86.4312267657992%,0.784541062801932,0.88622754491018,0.879017013232514,1035,1002,1058
2063,34,NORTH DAKOTA,MCHENRY,888,1682,2737,32.4442820606503%,61.4541468761418%,490,2050,2820,17.3758865248227%,72.6950354609929%,564,2364,3003,18.7812187812188%,78.7212787212787%,0.654474708171206,0.807086614173228,0.807377049180328,2570,2540,2928
2064,34,NORTH DAKOTA,MCINTOSH,350,1178,1637,21.3805742211362%,71.9609040928528%,235,1100,1446,16.2517289073306%,76.0719225449516%,261,1153,1455,17.9381443298969%,79.2439862542955%,0.770942408376963,0.823970037453183,0.815417256011315,1528,1335,1414
2065,34,NORTH DAKOTA,MCKENZIE,653,1634,2364,27.6226734348562%,69.1201353637902%,698,3670,4672,14.9400684931507%,78.5530821917808%,814,4482,5419,15.0212216276066%,82.7089868979516%,0.714473108876257,0.840201465201465,0.846299093655589,2287,4368,5296
2066,34,NORTH DAKOTA,MCLEAN,1465,2891,4646,31.5325010761946%,62.2255703831253%,1081,3860,5315,20.3386641580433%,72.6246472248354%,1230,4198,5536,22.2182080924855%,75.8309248554913%,0.663682277318641,0.781218376846792,0.773397199705232,4356,4941,5428
2067,34,NORTH DAKOTA,MERCER,1011,2984,4353,23.2253618194349%,68.5504249942568%,621,3759,4682,13.263562580094%,80.2862024775737%,704,3856,4675,15.0588235294118%,82.4812834224599%,0.746933667083855,0.858219178082192,0.845614035087719,3995,4380,4560
2068,34,NORTH DAKOTA,MORTON,3439,6993,11223,30.6424307226232%,62.3095429029671%,3080,11336,15832,19.4542698332491%,71.6018191005558%,3872,12243,16619,23.2986340935074%,73.6686924604368%,0.670341257668712,0.786348501664817,0.759726962457338,10432,14416,16115
2069,34,NORTH DAKOTA,MOUNTRAIL,1256,1466,2896,43.3701657458564%,50.621546961326%,1220,2582,4106,29.7126156843643%,62.8835849975645%,1256,2824,4165,30.15606242497%,67.8031212484994%,0.538574577516532,0.679116254602841,0.692156862745098,2722,3802,4080
2070,34,NORTH DAKOTA,NELSON,687,1031,1840,37.3369565217391%,56.0326086956522%,536,1025,1717,31.2172393709959%,59.6971461852067%,586,1141,1777,32.97692740574%,64.2093415869443%,0.60011641443539,0.656630365150545,0.660683265778807,1718,1561,1727
2071,34,NORTH DAKOTA,OLIVER,244,709,1051,23.2159847764034%,67.4595623215985%,119,830,1017,11.701081612586%,81.6125860373648%,129,918,1066,12.1013133208255%,86.1163227016885%,0.743966421825813,0.874604847207587,0.876790830945559,953,949,1047
2072,34,NORTH DAKOTA,PEMBINA,1093,2430,3779,28.9229955014554%,64.3027255887801%,681,2208,3153,21.5984776403425%,70.0285442435776%,786,2460,3331,23.5965175622936%,73.8516961873311%,0.689753051376668,0.764278296988577,0.757855822550832,3523,2889,3246
2073,34,NORTH DAKOTA,PIERCE,500,1348,1971,25.3678335870117%,68.3916793505835%,431,1437,2071,20.8112023177209%,69.3867696764848%,497,1585,2128,23.3552631578947%,74.4830827067669%,0.729437229437229,0.769271948608137,0.761287223823247,1848,1868,2082
2074,34,NORTH DAKOTA,RAMSEY,1658,3005,4977,33.3132409081776%,60.3777375929275%,1505,3217,5305,28.3694627709708%,60.6409048067861%,1639,3577,5372,30.5100521221147%,66.5860014892033%,0.644434913146043,0.681279119017365,0.685774539877301,4663,4722,5216
2075,34,NORTH DAKOTA,RANSOM,1080,1488,2719,39.7204854726002%,54.7260022066936%,838,1210,2359,35.5235269181857%,51.2929207291225%,945,1418,2454,38.5085574572127%,57.7832110839446%,0.579439252336449,0.5908203125,0.600084638171815,2568,2048,2363
2076,34,NORTH DAKOTA,RENVILLE,443,820,1332,33.2582582582583%,61.5615615615616%,201,993,1293,15.5452436194896%,76.7981438515081%,220,1065,1319,16.6793025018954%,80.7429871114481%,0.649247822644497,0.831658291457286,0.828793774319066,1263,1194,1285
2077,34,NORTH DAKOTA,RICHLAND,2490,4999,8015,31.0667498440424%,62.3705552089832%,2064,4767,7592,27.186512118019%,62.7897787144363%,2510,5072,7812,32.1300563236047%,64.9257552483359%,0.667512351448791,0.697848045674133,0.668952782906885,7489,6831,7582
2078,34,NORTH DAKOTA,ROLETTE,2681,1416,4398,60.9595270577535%,32.1964529331514%,2099,1217,3755,55.8988015978695%,32.410119840213%,2482,1257,3804,65.2471083070452%,33.0441640378549%,0.345618745423481,0.367008443908323,0.33618614602835,4097,3316,3739
2079,34,NORTH DAKOTA,SARGENT,959,1103,2184,43.9102564102564%,50.503663003663%,694,1088,1997,34.7521281922884%,54.4817225838758%,738,1266,2070,35.6521739130435%,61.1594202898551%,0.534917555771096,0.610549943883277,0.631736526946108,2062,1782,2004
2080,34,NORTH DAKOTA,SHERIDAN,161,707,928,17.3491379310345%,76.1853448275862%,95,650,787,12.0711562897078%,82.5921219822109%,104,688,812,12.807881773399%,84.7290640394089%,0.814516129032258,0.87248322147651,0.868686868686869,868,745,792
2081,34,NORTH DAKOTA,SIOUX,724,269,1041,69.5485110470701%,25.8405379442843%,758,260,1232,61.525974025974%,21.1038961038961%,804,258,1186,67.7908937605396%,21.7537942664418%,0.270896273917422,0.255402750491159,0.242937853107345,993,1018,1062
2082,34,NORTH DAKOTA,SLOPE,85,316,442,19.2307692307692%,71.4932126696833%,43,362,430,10%,84.1860465116279%,44,380,427,10.3044496487119%,88.9929742388759%,0.788029925187032,0.893827160493827,0.89622641509434,401,405,424
2083,34,NORTH DAKOTA,STARK,2784,6387,9777,28.4749923289353%,65.3267873580853%,1753,9755,12322,14.2265865930855%,79.1673429638046%,2499,12110,15050,16.6046511627907%,80.4651162790698%,0.696434412823029,0.847671185262426,0.828941063727839,9171,11508,14609
2084,34,NORTH DAKOTA,STEELE,475,655,1210,39.2561983471074%,54.1322314049587%,361,538,999,36.1361361361361%,53.8538538538539%,392,652,1088,36.0294117647059%,59.9264705882353%,0.579646017699115,0.598442714126808,0.624521072796935,1130,899,1044
2085,34,NORTH DAKOTA,STUTSMAN,3067,5488,9118,33.6367624479052%,60.1886378591797%,2498,6718,10155,24.5987198424421%,66.1546036435254%,2676,6994,9959,26.8701676875188%,70.2279345315795%,0.641496201052016,0.728949652777778,0.723267838676319,8555,9216,9670
2086,34,NORTH DAKOTA,TOWNER,410,694,1189,34.4827586206897%,58.3683767872162%,305,733,1157,26.3612791702679%,63.3535004321521%,317,830,1174,27.0017035775128%,70.6984667802385%,0.628623188405797,0.70616570327553,0.723626852659111,1104,1038,1147
2087,34,NORTH DAKOTA,TRAILL,1512,2392,4112,36.7704280155642%,58.1712062256809%,1241,2265,3933,31.5535214848716%,57.5896262395118%,1493,2522,4136,36.0976789168278%,60.9767891682785%,0.612704918032787,0.646035367940673,0.628144458281445,3904,3506,4015
2088,34,NORTH DAKOTA,WALSH,1743,3099,5182,33.6356619065998%,59.803164801235%,1167,2995,4636,25.1725625539258%,64.6031061259707%,1333,3324,4783,27.8695379468953%,69.4961321346435%,0.64002478314746,0.719605958673715,0.7137642258965,4842,4162,4657
2089,34,NORTH DAKOTA,WARD,7533,13997,22482,33.5068054443555%,62.2586958455653%,5806,18636,27412,21.1805048883701%,67.9848241645994%,7293,19974,28246,25.8195850739928%,70.7144374424697%,0.650116117045982,0.762458063988217,0.732533832104742,21530,24442,27267
2090,34,NORTH DAKOTA,WELLS,661,1610,2410,27.4273858921162%,66.804979253112%,419,1796,2383,17.5828787242971%,75.3671842215694%,442,1893,2374,18.6183656276327%,79.7388374052233%,0.708938793483047,0.810835214446953,0.810706638115632,2271,2215,2335
2091,34,NORTH DAKOTA,WILLIAMS,2330,5187,7807,29.8450108876649%,66.4403740233124%,1735,10069,12807,13.5472788318888%,78.6210666042008%,2169,11739,14334,15.1318543323566%,81.896190874843%,0.690035918584542,0.853015926804473,0.84404659188956,7517,11804,13908
2093,35,OHIO,ADAMS,3581,6380,10235,34.9877870053737%,62.3351245725452%,2326,8659,11359,20.4771546791091%,76.230301963201%,2156,9870,12145,17.7521613832853%,81.2680115273775%,0.640497941973697,0.788256713700501,0.820721769499418,9961,10985,12026
2094,35,OHIO,ALLEN,13996,28647,43795,31.9579860714693%,65.4115766640027%,13294,30487,45894,28.9667494661612%,66.429162853532%,14149,33116,48006,29.4733991584385%,68.9830437861934%,0.671786694181929,0.696352298942464,0.700645297789062,42643,43781,47265
2095,35,OHIO,ASHLAND,6685,13533,21258,31.4469846645969%,63.660739486311%,5740,17493,24590,23.3428222854819%,71.1386742578284%,6541,19407,26405,24.771823518273%,73.4974436659724%,0.669354040953606,0.752937631816812,0.747918914752582,20218,23233,25948
2096,35,OHIO,ASHTABULA,19831,17940,39472,50.2406769355493%,45.4499391974058%,15577,23318,40867,38.1163285780703%,57.058262167519%,16497,26890,44147,37.3683375993839%,60.9101411194419%,0.474967567710678,0.599511505334876,0.619770899117247,37771,38895,43387
2097,35,OHIO,ATHENS,13158,9703,25447,51.7074704287342%,38.1302314614689%,16370,11354,29443,55.5989539109466%,38.5626464694494%,14772,10862,26059,56.6867492996661%,41.6823362370007%,0.424434626656752,0.409536863367479,0.423734103144261,22861,27724,25634
2098,35,OHIO,AUGLAIZE,5564,13770,19892,27.9710436356324%,69.2238085662578%,3980,18658,23627,16.8451348034029%,78.9689761713294%,4651,20798,25777,18.0432168211972%,80.6843309927455%,0.712216820109651,0.824189416026151,0.817242327792841,19334,22638,25449
2099,35,OHIO,BELMONT,15980,12625,30141,53.0174844895657%,41.8864669387214%,8785,21108,31122,28.2276203328835%,67.8234046655099%,9138,23560,33088,27.6172630560928%,71.2040618955513%,0.441356406222688,0.706118489278426,0.720533365955104,28605,29893,32698
2100,35,OHIO,BROWN,5972,10027,16429,36.3503560776675%,61.0323208959766%,4353,14573,19607,22.2012546539501%,74.3254959963278%,4380,16480,21096,20.7622298065984%,78.1190747061054%,0.626726670416901,0.769998943252668,0.790028763183126,15999,18926,20860
2101,35,OHIO,BUTLER,46390,86587,136737,33.92644273313%,63.3237528978989%,58642,106976,173839,33.7335120427522%,61.5373995478575%,69613,114392,186737,37.2786325152487%,61.2583473012847%,0.651142678809117,0.645920129454528,0.621678758729382,132977,165618,184005
2102,35,OHIO,CARROLL,4960,6732,12261,40.4534703531523%,54.9057988744801%,3154,9254,13074,24.1242160012238%,70.7817041456326%,3251,10745,14212,22.8750351815367%,75.6051224317478%,0.575778309955525,0.745809155383623,0.767719348385253,11692,12408,13996
2103,35,OHIO,CHAMPAIGN,5955,9220,15680,37.9783163265306%,58.8010204081633%,4594,12631,18104,25.3756076005303%,69.7691117984976%,5062,14589,19972,25.345483677148%,73.0472661726417%,0.607578253706755,0.733294629898403,0.742404966668363,15175,17225,19651
2104,35,OHIO,CLARK,27984,27660,57559,48.6179398530204%,48.0550391771921%,23328,35205,61429,37.9755490077976%,57.3100652786143%,24076,39032,64212,37.4945493054258%,60.7861458917336%,0.49708863489325,0.601455589154836,0.618495277936236,55644,58533,63108
2105,35,OHIO,CLERMONT,20927,47129,69877,29.9483377935515%,67.4456545072055%,26715,67518,99121,26.9519072648581%,68.11674619909%,34092,74570,110480,30.8580738595221%,67.4963794351919%,0.69250323263195,0.716500588965649,0.686256465001564,68056,94233,108662
2106,35,OHIO,CLINTON,4791,9824,15070,31.7916390179164%,65.1891174518912%,4066,13838,18675,21.7724230254351%,74.09906291834%,4697,15488,20527,22.8820577775613%,75.4518439128952%,0.672186110160794,0.772899910634495,0.767302452316076,14615,17904,20185
2107,35,OHIO,COLUMBIANA,20657,21804,44427,46.4964998762014%,49.0782632183132%,12432,31676,46201,26.9085084738426%,68.5612865522391%,13359,35726,49860,26.7930204572804%,71.6526273565985%,0.51350651185794,0.718146368005804,0.727839462157482,42461,44108,49085
2108,35,OHIO,COSHOCTON,5594,8243,14268,39.2066162040931%,57.7726380712083%,4013,10785,15552,25.8037551440329%,69.3479938271605%,4125,12325,16739,24.6430491666169%,73.6304438735886%,0.595721615957216,0.728814704689823,0.749240121580547,13837,14798,16450
2109,35,OHIO,CRAWFORD,6721,11666,19176,35.0490196078431%,60.8364622444723%,4625,13611,19237,24.0422103238551%,70.7542756147008%,4916,15436,20686,23.7648651261723%,74.6205162912114%,0.634470005982488,0.746380785259925,0.758451257861635,18387,18236,20352
2110,35,OHIO,CUYAHOGA,359913,192099,574782,62.6173053435911%,33.4211927304613%,398271,184211,603822,65.958345340183%,30.5075005547993%,416176,202699,625670,66.5168539325843%,32.3971102977608%,0.34799786961153,0.316251832674658,0.327528176126035,552012,582482,618875
2111,35,OHIO,DARKE,7741,14817,23267,33.2702969871492%,63.6824687325396%,4470,20012,25484,17.5404175168733%,78.5277036571967%,4731,22004,27134,17.4356895407975%,81.0938306184123%,0.656840145402961,0.81741687770607,0.823040957546288,22558,24482,26735
2112,35,OHIO,DEFIANCE,6175,9540,16242,38.0187169067849%,58.7366087920207%,5368,11688,18192,29.5074758135444%,64.2480211081794%,5981,13038,19381,30.8601207368041%,67.2720705845932%,0.60706331530385,0.685272045028143,0.685525001314475,15715,17056,19019
2113,35,OHIO,DELAWARE,17134,36639,55403,30.9261231341263%,66.1317979170803%,40872,57568,103860,39.3529751588677%,55.4284613903331%,57735,66356,126070,45.7959863567859%,52.6342508130404%,0.681364253435739,0.584802925639984,0.534736604588568,53773,98440,124091
2114,35,OHIO,ERIE,17732,16105,35015,50.6411537912323%,45.9945737541054%,16057,19648,37578,42.7297887061579%,52.2859119697696%,17493,22160,40335,43.3692822610636%,54.9398785174166%,0.475958270532258,0.550287074639406,0.558848006456006,33837,35705,39653
2115,35,OHIO,FAIRFIELD,19065,33523,54094,35.2442045328502%,61.9717528746257%,24881,44314,72913,34.1242302470067%,60.7765419061073%,31224,50797,83311,37.4788443302805%,60.9727406945061%,0.637464820871682,0.640421995808946,0.619317004181856,52588,69195,82021
2116,35,OHIO,FAYETTE,3363,5685,9278,36.2470359991377%,61.2739814615219%,2739,7995,11162,24.5386131517649%,71.6269485755241%,2975,9473,12612,23.5886457342214%,75.1110053916905%,0.628315649867374,0.744829513694802,0.761005784061697,9048,10734,12448
2117,35,OHIO,FRANKLIN,202018,197862,414074,48.7878978153663%,47.7842124837589%,351198,199331,581140,60.4325979970403%,34.2999965584885%,409144,211237,630577,64.8840664978266%,33.4990017079595%,0.49480344103231,0.362071752805029,0.340495598672429,399880,550529,620381
2118,35,OHIO,FULTON,6805,11546,18896,36.0129127857748%,61.1028789161727%,6069,13709,21225,28.5936395759717%,64.5889281507656%,6664,15731,22770,29.2665788317962%,69.0865173473869%,0.629175521769931,0.693143897259581,0.702433578923867,18351,19778,22395
2119,35,OHIO,GALLIA,4872,7511,12776,38.1340012523482%,58.7899185973701%,2628,9822,12931,20.3232541953445%,75.9570025520068%,2990,10645,13799,21.6682368287557%,77.14327125154%,0.60655737704918,0.788915662650602,0.780711404473781,12383,12450,13635
2120,35,OHIO,GEAUGA,15327,25417,42600,35.9788732394366%,59.6643192488263%,17569,30227,49941,35.1795118239523%,60.5254199955948%,21201,34143,56021,37.8447367951304%,60.9467878117135%,0.623821912428824,0.632416938655955,0.616923243712056,40744,47796,55344
2121,35,OHIO,GREENE,25059,37946,65204,38.4316913072818%,58.1958162075946%,28943,48540,81858,35.3575704268367%,59.297808399912%,34798,52072,88643,39.2563428584321%,58.7434992046749%,0.602269661138005,0.62645999767691,0.599424427305169,63005,77483,86870
2122,35,OHIO,GUERNSEY,6643,8181,15430,43.0524951393389%,53.0200907323396%,4359,11445,16557,26.3272331944193%,69.1248414567856%,4577,13407,18230,25.1069665386725%,73.5436094349973%,0.55187533729088,0.724183750949127,0.745495996441281,14824,15804,17984
2123,35,OHIO,HAMILTON,161578,204175,377899,42.7569271154462%,54.0289865810706%,215719,173665,409109,52.7289793184701%,42.4495672302492%,246266,177886,430929,57.147697184455%,41.2796539569163%,0.55823192154268,0.44599932200604,0.419392104717177,365753,389384,424152
2124,35,OHIO,HANCOCK,8798,20985,30617,28.7356697259692%,68.5403533984388%,9609,24183,36023,26.6746245454293%,67.1321100408073%,11757,26310,38771,30.3242113951149%,67.8599984524516%,0.704596581942719,0.715642755681818,0.691149814800221,29783,33792,38067
2125,35,OHIO,HARDIN,4557,7124,12068,37.7610208816705%,59.0321511435201%,2920,8717,12294,23.7514234585977%,70.9045062632178%,3062,9949,13247,23.1146674718804%,75.1037970861327%,0.609879291156579,0.749076222394088,0.764660671739297,11681,11637,13011
2126,35,OHIO,HARRISON,3351,3417,7161,46.7951403435274%,47.7167993297026%,1688,5098,7079,23.8451758722983%,72.0158214437067%,1768,5792,7655,23.0960156760287%,75.6629653821032%,0.504875886524823,0.751252578838786,0.766137566137566,6768,6786,7560
2127,35,OHIO,HENRY,4367,8530,13252,32.9535164503471%,64.3676426199819%,3756,9301,13932,26.9595176571921%,66.7599770312949%,4062,10479,14764,27.5128691411542%,70.9767000812788%,0.661394122664186,0.712338209389599,0.720651949659583,12897,13057,14541
2128,35,OHIO,HIGHLAND,5328,9728,15447,34.4921343950282%,62.9766297662977%,3773,14020,18501,20.3934922436625%,75.7796875844549%,3799,15678,19676,19.3077861353934%,79.6808294368774%,0.646121147715197,0.787950317540606,0.804949427529907,15056,17793,19477
2129,35,OHIO,HOCKING,4474,5702,10756,41.5953886203049%,53.0122722201562%,3775,8497,12838,29.4048917276834%,66.1863218569871%,3880,9737,13824,28.0671296296296%,70.435474537037%,0.560338050314465,0.692389178617992,0.715062054784461,10176,12272,13617
2130,35,OHIO,HOLMES,2066,6754,9145,22.5915800984144%,73.8545653362493%,1788,8720,11054,16.1751402207346%,78.8854713225981%,1994,10796,12947,15.401251255117%,83.3861126129605%,0.765759637188209,0.829843928435478,0.844096950742768,8820,10508,12790
2131,35,OHIO,HURON,8183,12286,21360,38.309925093633%,57.5187265917603%,7192,16226,24834,28.9602963678827%,65.3378432793751%,7759,18956,27190,28.5362265538801%,69.7168076498713%,0.600224730079633,0.692885814330857,0.709563915403331,20469,23418,26715
2132,35,OHIO,JACKSON,5131,6958,12490,41.0808646917534%,55.7085668534828%,3226,9949,13693,23.5594829474914%,72.6575622580881%,3311,11309,14794,22.3806948763012%,76.4431526294444%,0.575564562825709,0.755142314990512,0.773529411764706,12089,13175,14620
2133,35,OHIO,JEFFERSON,17488,15038,34636,50.4908188012473%,43.4172537244486%,9675,21117,32201,30.0456507561877%,65.5787087357535%,10018,22828,33362,30.0281757688388%,68.4251543672442%,0.462337822050052,0.685795011691348,0.695000913353224,32526,30792,32846
2134,35,OHIO,KNOX,7133,13393,21260,33.5512699905927%,62.9962370649106%,8171,19131,28687,28.4832851117231%,66.688744030397%,8589,22340,31398,27.3552455570419%,71.1510287279445%,0.652489525479879,0.700717896124826,0.722299460053671,20526,27302,30929
2135,35,OHIO,LAKE,46497,51747,102564,45.3346203346203%,50.4533754533755%,46397,64255,116246,39.912771192127%,55.2750202157494%,55514,73278,130509,42.5365300477362%,56.1478518722847%,0.526719188958104,0.580694429382207,0.568963910801913,98244,110652,128792
2136,35,OHIO,LAWRENCE,11307,12531,24452,46.2416162277114%,51.2473417307378%,6974,18689,26607,26.2111474424024%,70.2409140451761%,7489,20306,28127,26.6256621751342%,72.1939773171686%,0.525673294739492,0.728246892413202,0.730563050908437,23838,25663,27795
2137,35,OHIO,LICKING,23196,37180,62466,37.1338007876285%,59.5203790862229%,27376,51241,82761,33.0783823298413%,61.9144282935199%,33055,59514,94210,35.086508863178%,63.171637830379%,0.615807605671128,0.651780149331569,0.642915014745757,60376,78617,92569
2138,35,OHIO,LOGAN,5945,11849,18455,32.2134922785153%,64.2048225413167%,4647,15957,21571,21.5428121088498%,73.9743173705438%,5055,17964,23368,21.6321465251626%,76.8743580965423%,0.665898617511521,0.774461269656377,0.780398800990486,17794,20604,23019
2139,35,OHIO,LORAIN,59809,47957,112180,53.3152077019077%,42.7500445712248%,66949,66818,140562,47.6295158008566%,47.536318492907%,75667,79520,157437,48.061764388295%,50.5090925258993%,0.445010485681941,0.499510342610659,0.512414055301024,107766,133767,155187
2140,35,OHIO,LUCAS,108344,73342,187350,57.8297304510275%,39.1470509741126%,110833,75698,197556,56.1020672619409%,38.3172366316386%,115411,81763,200623,57.5263055581863%,40.7545495780643%,0.403674471340665,0.405819944137972,0.41467434854494,181686,186531,197174
2141,35,OHIO,MADISON,5287,8892,14667,36.0469080248176%,60.6258948660258%,4779,11631,17290,27.6402544823597%,67.2700983227299%,5698,13835,19855,28.6980609418283%,69.6801813145303%,0.627124620918259,0.708775137111517,0.708288537347054,14179,16410,19533
2142,35,OHIO,MAHONING,69212,40460,114119,60.6489716874491%,35.4542188417354%,57381,53616,115072,49.8653017241379%,46.5934371523916%,57641,59903,118966,48.4516584570381%,50.3530420456265%,0.368918228900722,0.483040082164383,0.509621928809637,109672,110997,117544
2143,35,OHIO,MARION,10370,13617,24815,41.7892403788031%,54.8740681039694%,7928,16961,26322,30.1192918471241%,64.4365929640605%,8269,19023,27818,29.7253576820764%,68.3837802861457%,0.567682494684621,0.681465707742376,0.697017441008354,23987,24889,27292
2144,35,OHIO,MEDINA,26635,37349,66883,39.8232734775653%,55.8422917632283%,32182,54810,91373,35.2204699418865%,59.9848970702505%,39800,64598,105825,37.6092605716986%,61.0422867942358%,0.583724056014003,0.630057936361964,0.618766643039139,63984,86992,104398
2145,35,OHIO,MEIGS,3674,5750,9795,37.5089331291475%,58.7034201123022%,2260,7309,9985,22.6339509263896%,73.1997996995493%,2492,8316,10951,22.7559127020363%,75.938270477582%,0.610144312393888,0.763820670916501,0.769430051813471,9424,9569,10808
2146,35,OHIO,MERCER,5212,12485,18294,28.4902153711599%,68.2464195911228%,3384,17506,21726,15.5758077879039%,80.5762680659118%,4030,19452,23761,16.9605656327596%,81.8652413618955%,0.705486805673278,0.838008616562949,0.828379184055873,17697,20890,23482
2147,35,OHIO,MIAMI,15584,26037,42841,36.3763684321094%,60.7758922527485%,13120,37079,52734,24.879584328896%,70.3132703758486%,15663,41371,57972,27.0182156903333%,71.3637618160491%,0.625573628697052,0.738640211956414,0.725374338114107,41621,50199,57034
2148,35,OHIO,MONROE,3605,3145,7115,50.6676036542516%,44.2023893183415%,1662,4868,6795,24.4591611479029%,71.6409124356144%,1605,5463,7148,22.4538332400672%,76.4269725797426%,0.465925925925926,0.745482388973966,0.772920203735144,6750,6530,7068
2149,35,OHIO,MONTGOMERY,114597,109792,230987,49.611882919818%,47.5316792719937%,122016,123909,258301,47.2379123580629%,47.9707782780555%,135064,129034,268505,50.3022290087708%,48.0564607735424%,0.489293147168533,0.503848734370235,0.488583783292566,224389,245925,264098
2150,35,OHIO,MORGAN,2261,3451,5993,37.7273485733356%,57.5838478224595%,1736,4431,6443,26.9439702002173%,68.772311035232%,1725,5041,6847,25.193515408208%,73.6234847378414%,0.604166666666667,0.71850170261067,0.745048773278155,5712,6167,6766
2151,35,OHIO,MORROW,4529,7842,12839,35.2753329698575%,61.0795233273619%,3761,11948,16548,22.7278220933043%,72.2020788010636%,4048,14077,18457,21.9320582976648%,76.2691661700168%,0.633901867270229,0.760583105226303,0.776662068965517,12371,15709,18125
2152,35,OHIO,MUSKINGUM,13415,17995,32624,41.1200343305542%,55.1587788131437%,11123,24056,36991,30.0694763591144%,65.0320348192804%,11971,27867,40465,29.5835907574447%,68.8669220313851%,0.572906717605858,0.683817049944569,0.699508007430092,31410,35179,39838
2153,35,OHIO,NOBLE,2296,3435,5988,38.3433533734135%,57.3647294589178%,1221,4549,6013,20.3060036587394%,75.6527523698653%,1170,5135,6343,18.4455305060697%,80.9553838877503%,0.599371837375676,0.788388214904679,0.814432989690722,5731,5770,6305
2154,35,OHIO,OTTAWA,9485,9917,19968,47.5010016025641%,49.6644631410256%,8285,12653,22218,37.289585021154%,56.9493203708705%,9008,14628,24007,37.5223893031199%,60.9322281001375%,0.511132872899701,0.604307956824912,0.618886444406837,19402,20938,23636
2155,35,OHIO,PAULDING,3384,5210,8946,37.8269617706237%,58.2383188016991%,2093,6500,9047,23.1347407980546%,71.8470211119708%,2213,7086,9467,23.3759374669906%,74.8494771310869%,0.606236909471724,0.75642965204236,0.762017421228089,8594,8593,9299
2156,35,OHIO,PERRY,5895,6440,12828,45.9541627689429%,50.2026816339258%,4138,10228,14995,27.5958652884295%,68.2094031343781%,4098,12357,16675,24.575712143928%,74.1049475262369%,0.522091609241994,0.711958791591257,0.750957155879672,12335,14366,16455
2157,35,OHIO,PICKAWAY,6598,10717,17740,37.1927846674183%,60.4114994363022%,6529,17076,24745,26.3851283087492%,69.0078803798747%,7304,20593,28271,25.8356619857805%,72.8414276113332%,0.618943112907883,0.723406058038551,0.738179732587733,17315,23605,27897
2158,35,OHIO,PIKE,4923,5333,10560,46.6193181818182%,50.5018939393939%,3539,7902,11879,29.7920700395656%,66.5207509049583%,3110,9157,12412,25.0563970351273%,73.7753786658073%,0.519988299531981,0.690673892142295,0.746474280590201,10256,11441,12267
2159,35,OHIO,PORTAGE,31446,28271,62899,49.9944355236172%,44.9466605192451%,32397,39971,76139,42.5498102155269%,52.4974060599693%,35661,45990,82872,43.0314219519259%,55.4952215464813%,0.473416280121239,0.552329759009507,0.563250909358122,59717,72368,81651
2160,35,OHIO,PREBLE,6375,11176,18166,35.0930309369151%,61.5215237256413%,4325,15446,20565,21.0308777048383%,75.1081935327012%,4493,17022,21809,20.6015865009858%,78.0503461873539%,0.636772833456783,0.781245258206464,0.791168951894028,17551,19771,21515
2161,35,OHIO,PUTNAM,4063,12837,17344,23.4259686346863%,74.0140682656827%,2922,14961,18767,15.5698833058027%,79.7197207864869%,3195,16412,19921,16.0383514883791%,82.3854224185533%,0.759585798816568,0.836604596544204,0.837047993063702,16900,17883,19607
2162,35,OHIO,RICHLAND,20572,30138,52779,38.9776236760833%,57.1022565793213%,16085,36590,55214,29.132104176477%,66.2694244213424%,17640,41472,59975,29.4122551062943%,69.1488120050021%,0.594320646815224,0.694636924537257,0.701583434835566,50710,52675,59112
2163,35,OHIO,ROSS,11662,13706,26016,44.8262607626076%,52.6829643296433%,10356,18652,30380,34.0882159315339%,61.395655036208%,10557,22278,33299,31.7036547644073%,66.9029099972972%,0.540286975717439,0.642995035852179,0.678483325719507,25368,29008,32835
2164,35,OHIO,SANDUSKY,11146,13699,25744,43.2955251709136%,53.2123990055935%,9929,16316,28044,35.4050777349879%,58.1800028526601%,10596,18896,30074,35.2330917071224%,62.8316818514331%,0.551378546991346,0.621680320060964,0.640716126407161,24845,26245,29492
2165,35,OHIO,SCIOTO,13997,15022,29945,46.7423609951578%,50.1653030556019%,9132,20550,30784,29.6647609147609%,66.7554573804574%,9080,22609,32047,28.3333853402815%,70.5495054139233%,0.517660842896034,0.692338791186578,0.713465240304207,29019,29682,31689
2166,35,OHIO,SENECA,9512,13863,24351,39.0620508398012%,56.929900209437%,7404,14825,23987,30.8667194730479%,61.8043106682787%,8266,17086,25810,32.0263463773731%,66.1991476172026%,0.593069518716578,0.666921588915381,0.673950773114547,23375,22229,25352
2167,35,OHIO,SHELBY,6593,12476,19670,33.5180477885104%,63.4265378749365%,4243,18590,23740,17.8727885425442%,78.3066554338669%,4465,20422,25258,17.6775675033653%,80.8535909414839%,0.654255598091143,0.81417246967109,0.820589062562784,19069,22833,24887
2168,35,OHIO,STARK,75308,78153,159844,47.1134355997097%,48.8932959635645%,68146,98388,175239,38.8874622658198%,56.1450362076935%,75904,111097,189879,39.9749314036834%,58.5093664912918%,0.509269456083305,0.59079827542724,0.594098427281137,153461,166534,187001
2169,35,OHIO,SUMMIT,119759,96721,224839,53.2643358136266%,43.0178928032948%,134256,112026,257979,52.0414452339144%,43.4244647820171%,151668,124833,280473,54.0757933918773%,44.5080275106695%,0.446789541759054,0.454868808926353,0.451473954886239,216480,246282,276501
2170,35,OHIO,TRUMBULL,57643,34654,96239,59.8956763889899%,36.0082710751359%,43014,49024,96029,44.7927188661758%,51.0512449364255%,44519,55194,101001,44.0777814081049%,54.6469836932308%,0.375461824327985,0.532649557791347,0.553528627159949,92297,92038,99713
2171,35,OHIO,TUSCARAWAS,15879,19549,37118,42.7797833935018%,52.6671695673258%,12188,26918,41289,29.5187580227179%,65.1941194991402%,12889,30458,44015,29.2831989094627%,69.1991366579575%,0.551795190245004,0.688334270955864,0.702655316400212,35428,39106,43347
2172,35,OHIO,UNION,5040,11502,17024,29.6052631578947%,67.5634398496241%,7718,18096,27429,28.1381020088228%,65.9739691567319%,11141,21669,33445,33.3114067872627%,64.7899536552549%,0.695321001088139,0.701014953126211,0.66043889058214,16542,25814,32810
2173,35,OHIO,VAN WERT,4209,8679,13219,31.84053256676%,65.6554958771465%,2697,10469,13770,19.5860566448802%,76.0275962236747%,3067,11650,14965,20.4944871366522%,77.8483127297026%,0.673417132216015,0.795154185022026,0.791601549228783,12888,13166,14717
2174,35,OHIO,VINTON,2037,2720,4946,41.1847957945815%,54.9939344925192%,1351,3883,5502,24.5547073791349%,70.574336604871%,1331,4632,6030,22.0729684908789%,76.81592039801%,0.571788942610889,0.741880015284677,0.776790206272011,4757,5234,5963
2175,35,OHIO,WARREN,19142,48318,69078,27.7107038420336%,69.9470164162251%,33730,77643,117267,28.7634202290499%,66.2104428355803%,46069,87988,136100,33.8493754592212%,64.6495224099927%,0.716246664690187,0.697143831988004,0.656347673004767,67460,111373,134057
2176,35,OHIO,WASHINGTON,10383,15342,26515,39.1589666226664%,57.8615877805016%,8026,20514,29840,26.8967828418231%,68.7466487935657%,9243,22307,32031,28.8564203427929%,69.6419094002685%,0.596384839650146,0.718780658724597,0.707036450079239,25725,28540,31550
2177,35,OHIO,WAYNE,14779,25901,42436,34.8265623527194%,61.0354416061834%,15031,32270,49853,30.1506428900969%,64.7303071028825%,16660,36759,54283,30.6910082346223%,67.7173332350828%,0.636701081612586,0.682226591403987,0.688125947696512,40680,47301,53419
2178,35,OHIO,WILLIAMS,5454,9941,15919,34.2609460393241%,62.4473899114266%,4358,11939,17308,25.1791079269702%,68.9796625837763%,4842,13452,18651,25.9610744732186%,72.1248190445553%,0.645729132835336,0.732588820028226,0.735323056739915,15395,16297,18294
2179,35,OHIO,WOOD,22687,27504,52194,43.4666819940989%,52.6957121508219%,27318,32498,64341,42.458152655383%,50.5090066986836%,30617,35757,67597,45.2934301818128%,52.8973179283104%,0.547986690840987,0.543299451651732,0.53871998071534,50191,59816,66374
2180,35,OHIO,WYANDOT,3397,6113,9827,34.5680268647604%,62.2061666836267%,2515,7468,10592,23.744335347432%,70.5060422960725%,2733,8462,11390,23.9947322212467%,74.2932396839333%,0.64279705573081,0.748071721927276,0.755873157659669,9510,9983,11195
2182,36,OKLAHOMA,ADAIR,2361,3503,5977,39.5014221181195%,58.6079973230718%,1382,4787,6513,21.2191002610164%,73.4991555350837%,1387,5585,7108,19.5132245357344%,78.5734383792909%,0.59737380627558,0.775976657480953,0.801061388410786,5864,6169,6972
2183,36,OKLAHOMA,ALFALFA,583,1886,2507,23.2548863183087%,75.2293577981651%,216,1933,2258,9.56598759964571%,85.6067316209035%,232,1978,2262,10.2564102564103%,87.4447391688771%,0.763872012960713,0.899488134015821,0.895022624434389,2469,2149,2210
2184,36,OKLAHOMA,ATOKA,1906,2375,4324,44.0795559666975%,54.9259944495837%,795,4084,5018,15.8429653248306%,81.3870067756078%,765,4557,5389,14.1955835962145%,84.5611430692151%,0.554776921280075,0.837056773929084,0.856257046223224,4281,4879,5322
2185,36,OKLAHOMA,BEAVER,339,2092,2456,13.8029315960912%,85.1791530944626%,176,1993,2243,7.84663397235845%,88.8542131074454%,190,1968,2178,8.72359963269054%,90.3581267217631%,0.86055121349239,0.918856615952052,0.911955514365153,2431,2169,2158
2186,36,OKLAHOMA,BECKHAM,2408,4067,6532,36.8646662584201%,62.2627066748316%,960,6308,7552,12.7118644067797%,83.5275423728814%,1048,6767,7948,13.1857070961248%,85.1409159536991%,0.628108108108108,0.867914144193726,0.865898912348049,6475,7268,7815
2187,36,OKLAHOMA,BLAINE,1402,2633,4094,34.2452369320957%,64.3136297020029%,711,2884,3793,18.7450566833641%,76.0348009491168%,688,3136,3901,17.6365034606511%,80.3896436811074%,0.652540272614622,0.802225312934631,0.820083682008368,4035,3595,3824
2188,36,OKLAHOMA,BRYAN,5554,6084,11746,47.2841818491401%,51.7963562063681%,2804,10478,13818,20.2923722680562%,75.8286293240701%,3323,12344,15976,20.7999499248873%,77.2658988482724%,0.522770235435642,0.788887215780756,0.787898129827025,11638,13282,15667
2189,36,OKLAHOMA,CADDO,4272,4835,9210,46.3843648208469%,52.4972855591748%,2420,6482,9348,25.8878904578519%,69.3410355156183%,2670,7013,9859,27.0818541434223%,71.1329749467492%,0.530910288788844,0.72815097730847,0.724259010637199,9107,8902,9683
2190,36,OKLAHOMA,CANADIAN,8367,22679,31360,26.6804846938775%,72.3182397959184%,11674,39986,55278,21.1187090705163%,72.3361916133%,16742,43550,61940,27.0293832741363%,70.3099773974814%,0.730496682342331,0.774022454510259,0.722318052146222,31046,51660,60292
2191,36,OKLAHOMA,CARTER,6659,9667,16458,40.4605662899502%,58.7373921497144%,4002,13752,18534,21.5927484622855%,74.1987698284234%,4470,14699,19479,22.9477899276144%,75.4607526053699%,0.592122993997305,0.774586008786752,0.766810996922114,16326,17754,19169
2192,36,OKLAHOMA,CHEROKEE,7256,6918,14468,50.1520597179983%,47.8158695051147%,5456,9994,16490,33.086719223772%,60.6064281382656%,6027,11223,17714,34.0239358699334%,63.3566670430168%,0.488076760265274,0.646860841423948,0.650608695652174,14174,15450,17250
2193,36,OKLAHOMA,CHOCTAW,2799,2461,5315,52.6622765757291%,46.3029162746943%,1067,4206,5426,19.6645779579801%,77.5156653151493%,1082,4698,5832,18.5528120713306%,80.5555555555556%,0.46787072243346,0.797648397496681,0.81280276816609,5260,5273,5780
2194,36,OKLAHOMA,CIMARRON,227,1230,1484,15.2964959568733%,82.8840970350404%,71,963,1079,6.58016682113068%,89.2493049119555%,70,970,1054,6.64136622390892%,92.0303605313093%,0.844200411805079,0.931334622823984,0.932692307692308,1457,1034,1040
2195,36,OKLAHOMA,CLEVELAND,27792,47393,76171,36.4863268172927%,62.2192172874191%,38829,62538,109450,35.4764732754683%,57.1384193695751%,49827,66677,119778,41.5994589991484%,55.6671508958239%,0.630351798896056,0.616946343484566,0.572315113644167,75185,101367,116504
2196,36,OKLAHOMA,COAL,1148,1196,2362,48.6028789161727%,50.6350550381033%,411,1898,2399,17.1321383909963%,79.1162984576907%,374,2091,2524,14.8177496038035%,82.8446909667195%,0.510238907849829,0.822000866175834,0.848275862068966,2344,2309,2465
2197,36,OKLAHOMA,COMANCHE,11971,17103,29333,40.8106910305799%,58.3063443902772%,11463,19183,32564,35.2014494533841%,58.9086107357818%,13747,20905,35631,38.581572226432%,58.6708203530633%,0.588257549700764,0.625954447562488,0.603284081726884,29074,30646,34652
2198,36,OKLAHOMA,COTTON,1068,1388,2482,43.0298146655923%,55.9226430298147%,424,2054,2602,16.2951575710992%,78.9392774788624%,393,2117,2572,15.2799377916019%,82.3094867807154%,0.56514657980456,0.828894269572236,0.843426294820717,2456,2478,2510
2199,36,OKLAHOMA,CRAIG,2568,2815,5484,46.8271334792123%,51.3311451495259%,1252,4283,5785,21.6421780466724%,74.0363007778738%,1217,4686,6032,20.1757294429708%,77.6856763925729%,0.522942597064834,0.773803071364047,0.793833643909876,5383,5535,5903
2200,36,OKLAHOMA,CREEK,9753,13580,23741,41.0808306305547%,57.2006233941283%,5841,21575,28830,20.2601456815817%,74.8352410683316%,6577,23294,30505,21.560399934437%,76.3612522537289%,0.582008314404492,0.786949226728917,0.77981989220314,23333,27416,29871
2201,36,OKLAHOMA,CUSTER,3115,6527,9743,31.9716719696192%,66.99168633891%,2104,7826,10541,19.9601555829618%,74.2434304145717%,2369,8060,10691,22.158825180058%,75.3905153867739%,0.676934246007052,0.788116817724069,0.772844951577332,9642,9930,10429
2202,36,OKLAHOMA,DELAWARE,5514,7618,13353,41.2940912154572%,57.0508499962555%,3311,11826,15716,21.0677017052685%,75.2481547467549%,3472,13557,17245,20.1333719918817%,78.6140910408814%,0.58010965580262,0.781264451344388,0.796112513946797,13132,15137,17029
2203,36,OKLAHOMA,DEWEY,599,1607,2220,26.981981981982%,72.3873873873874%,222,1965,2248,9.87544483985765%,87.4110320284698%,214,2124,2359,9.07164052564646%,90.03815175922%,0.728467815049864,0.898491083676269,0.90846877673225,2206,2187,2338
2204,36,OKLAHOMA,ELLIS,468,1513,2013,23.2488822652757%,75.1614505712866%,155,1611,1827,8.48385331143952%,88.1773399014778%,162,1688,1873,8.64922584089696%,90.1227976508276%,0.763755678950025,0.912231030577576,0.912432432432432,1981,1766,1850
2205,36,OKLAHOMA,GARFIELD,6543,14902,21683,30.1757136927547%,68.7266522160218%,4397,16009,21710,20.2533394748964%,73.7402118839245%,4919,16970,22430,21.9304502897905%,75.6576014266607%,0.694893914665423,0.784524159560913,0.775275252409886,21445,20406,21889
2206,36,OKLAHOMA,GARVIN,4189,5536,9843,42.5581631616377%,56.2430153408514%,1855,8253,10546,17.5896074340982%,78.2571591124597%,1865,8878,10922,17.0756271745102%,81.2854788500275%,0.569254498714653,0.816481994459834,0.826398585125198,9725,10108,10743
2207,36,OKLAHOMA,GRADY,6037,10040,16276,37.0914229540428%,61.6859179159499%,3882,17316,22286,17.4190074486225%,77.6990038589249%,4144,18538,23101,17.9386173758712%,80.2476083286438%,0.624494619642968,0.816869515992075,0.817300061722952,16077,21198,22682
2208,36,OKLAHOMA,GRANT,709,1762,2503,28.3260087894527%,70.3955253695565%,288,1827,2201,13.0849613811904%,83.0077237619264%,280,1916,2226,12.5786163522013%,86.0736747529201%,0.713071630918656,0.863829787234043,0.872495446265938,2471,2115,2196
2209,36,OKLAHOMA,GREER,839,1287,2152,38.9869888475836%,59.8048327137547%,323,1482,1896,17.035864978903%,78.1645569620253%,328,1605,1973,16.6244298023315%,81.3482007095793%,0.605362182502352,0.821052631578947,0.830315571650285,2126,1805,1933
2210,36,OKLAHOMA,HARMON,507,692,1205,42.0746887966805%,57.4273858921162%,225,715,977,23.0296827021494%,73.1832139201638%,177,747,933,18.9710610932476%,80.064308681672%,0.577147623019183,0.76063829787234,0.808441558441558,1199,940,924
2211,36,OKLAHOMA,HARPER,374,1296,1683,22.2222222222222%,77.0053475935829%,134,1318,1499,8.93929286190794%,87.9252835223482%,136,1327,1487,9.14593140551446%,89.2400806993948%,0.776047904191617,0.90771349862259,0.90704032809296,1670,1452,1463
2212,36,OKLAHOMA,HASKELL,2510,2039,4628,54.2350907519447%,44.0579083837511%,882,3701,4738,18.615449556775%,78.1131279020684%,783,4165,5014,15.6162744315915%,83.0674112485042%,0.448230380303363,0.807549639973816,0.841754244139046,4549,4583,4948
2213,36,OKLAHOMA,HUGHES,2334,2196,4585,50.9051254089422%,47.8953107960742%,961,3388,4526,21.2328767123288%,74.856385329209%,919,3875,4857,18.9211447395512%,79.7817582870084%,0.48476821192053,0.779029661991262,0.808302044221944,4530,4349,4794
2214,36,OKLAHOMA,JACKSON,2515,5591,8159,30.8248559872533%,68.5255546022797%,1473,5969,7806,18.8700999231361%,76.4668203945683%,1646,6392,8221,20.0218951465758%,77.7520982848802%,0.689735998026154,0.802069336199946,0.795222692211993,8106,7442,8038
2215,36,OKLAHOMA,JEFFERSON,1245,1320,2593,48.0138835325877%,50.9062861550328%,365,1910,2350,15.531914893617%,81.2765957446809%,319,2026,2385,13.3752620545073%,84.9475890985325%,0.514619883040936,0.83956043956044,0.863965884861407,2565,2275,2345
2216,36,OKLAHOMA,JOHNSTON,1809,2072,3930,46.030534351145%,52.7226463104326%,786,3093,4018,19.5619711299154%,76.9785963165754%,738,3441,4251,17.3606210303458%,80.9456598447424%,0.533883019840247,0.797370456303171,0.823402727925341,3881,3879,4179
2217,36,OKLAHOMA,KAY,6122,11768,18162,33.7077414381676%,64.7946261424953%,3738,12172,16803,22.2460274950902%,72.4394453371422%,4040,12834,17249,23.4216476317468%,74.4043132935243%,0.657797652319732,0.765053425518542,0.760578404646201,17890,15910,16874
2218,36,OKLAHOMA,KINGFISHER,1304,4693,6056,21.5323645970938%,77.4933949801849%,786,5156,6131,12.820094601207%,84.0972108954494%,854,5521,6465,13.2095901005414%,85.3982985305491%,0.782557945639486,0.86772130595759,0.866039215686275,5997,5942,6375
2219,36,OKLAHOMA,KIOWA,1544,2173,3750,41.1733333333333%,57.9466666666667%,767,2596,3493,21.9582021185228%,74.3200687088463%,699,2673,3427,20.396848555588%,77.9982491975489%,0.584611245628195,0.771929824561403,0.79270462633452,3717,3363,3372
2220,36,OKLAHOMA,LATIMER,1865,1739,3669,50.831289179613%,47.3971109294086%,797,3100,4056,19.6499013806706%,76.4299802761341%,762,3437,4249,17.9336314426924%,80.8896210873147%,0.482519422863485,0.795483705414421,0.818528221005001,3604,3897,4199
2221,36,OKLAHOMA,LE FLORE,6536,8215,14985,43.616950283617%,54.8214881548215%,3250,13362,17221,18.8723070669531%,77.5913129318855%,3299,15213,18805,17.543206593991%,80.898697155012%,0.55691139583757,0.804358295208283,0.821791270527226,14751,16612,18512
2222,36,OKLAHOMA,LINCOLN,4140,7387,11701,35.3815913169815%,63.1313562943338%,2430,10854,14025,17.3262032085561%,77.3903743315508%,2609,12013,14888,17.5241805480924%,80.6891456206341%,0.640843237616032,0.817073170731707,0.821570236629736,11527,13284,14622
2223,36,OKLAHOMA,LOGAN,4510,8187,12870,35.042735042735%,63.6130536130536%,4248,13633,18979,22.3826334369566%,71.8320248695927%,5455,15608,21574,25.2850653564476%,72.3463428200612%,0.644797983775695,0.762429394329176,0.741015050087832,12697,17881,21063
2224,36,OKLAHOMA,LOVE,1530,1807,3372,45.373665480427%,53.5883748517201%,735,2922,3789,19.3982581155978%,77.1179730799683%,711,3305,4076,17.4435721295388%,81.0843964671246%,0.541504345220258,0.79901558654635,0.822958167330677,3337,3657,4016
2225,36,OKLAHOMA,MAJOR,635,2672,3352,18.9439140811456%,79.7136038186158%,310,2948,3407,9.09891400058703%,86.527737012034%,320,3084,3467,9.22988174214018%,88.952985289876%,0.807983066223163,0.904849600982198,0.90599294947121,3307,3258,3404
2226,36,OKLAHOMA,MARSHALL,2210,2641,4900,45.1020408163265%,53.8979591836735%,1096,4206,5492,19.9563000728332%,76.5841223597961%,1100,4891,6064,18.1398416886544%,80.6563324538259%,0.544423830138116,0.793285552621652,0.816391253546987,4851,5302,5991
2227,36,OKLAHOMA,MAYES,6618,7132,14001,47.2680522819799%,50.9392186272409%,3423,11555,15717,21.778965451422%,73.5191194248266%,3581,12749,16626,21.5385540719355%,76.6811018886082%,0.518690909090909,0.771464815062091,0.780710349050827,13750,14978,16330
2228,36,OKLAHOMA,MCCLAIN,3679,6750,10539,34.9084353354208%,64.0478223740393%,2894,13169,16858,17.1669237157433%,78.1172143789299%,3582,15295,19236,18.6213349968808%,79.5123726346434%,0.647233675328411,0.81983440204196,0.810245272024156,10429,16063,18877
2229,36,OKLAHOMA,MCCURTAIN,3752,6601,10482,35.7946956687655%,62.9746231635184%,1802,8656,10726,16.8002983404811%,80.701100130524%,1858,9485,11467,16.2030173541467%,82.7156187320136%,0.637592968221771,0.827691719257984,0.836198536542361,10353,10458,11343
2230,36,OKLAHOMA,MCINTOSH,4206,3444,7781,54.0547487469477%,44.2616630253181%,2123,5505,7963,26.6608062288082%,69.1322365942484%,2031,6172,8335,24.3671265746851%,74.0491901619676%,0.450196078431373,0.721683272155218,0.752407655735706,7650,7628,8203
2231,36,OKLAHOMA,MURRAY,2263,2609,4922,45.9772450223486%,53.0069077610727%,1087,4175,5528,19.6635311143271%,75.5246020260492%,1156,4612,5894,19.6131659314557%,78.2490668476417%,0.535509031198686,0.793424553401748,0.799583911234397,4872,5262,5768
2232,36,OKLAHOMA,MUSKOGEE,12520,11820,24693,50.7026282752197%,47.8678167901835%,7977,15043,24216,32.9410307234886%,62.1200858936241%,8027,16526,25081,32.0043060484032%,65.8905147322675%,0.485620377978636,0.653475238922676,0.673074573371889,24340,23020,24553
2233,36,OKLAHOMA,NOBLE,1416,3230,4697,30.1469022780498%,68.767298275495%,901,3715,4878,18.4706847068471%,76.1582615826158%,1003,3821,4938,20.3118671526934%,77.379505872823%,0.695221696082652,0.804809358752166,0.792081260364842,4646,4616,4824
2234,36,OKLAHOMA,NOWATA,1703,2069,3849,44.2452585087036%,53.7542218758119%,742,3321,4237,17.5123908425773%,78.3809299032334%,712,3610,4391,16.2149851969939%,82.213618765657%,0.548515376458112,0.817376322914103,0.835261453031004,3772,4063,4322
2235,36,OKLAHOMA,OKFUSKEE,1814,1910,3788,47.8880675818374%,50.4223864836325%,943,2800,3943,23.9158001521684%,71.0119198579762%,896,3058,4038,22.1892025755324%,75.7305596830114%,0.512889366272825,0.748063051028587,0.773394031360647,3724,3743,3954
2236,36,OKLAHOMA,OKLAHOMA,81590,139078,223111,36.5692413193433%,62.3357880158307%,112813,141569,273942,41.1813449562316%,51.6784574837009%,141724,145050,294740,48.0844133812852%,49.2128655764403%,0.630259031667482,0.556521294745697,0.505798991540377,220668,254382,286774
2237,36,OKLAHOMA,OKMULGEE,7186,5797,13178,54.53027773562%,43.9899833055092%,4385,8944,13949,31.4359452290487%,64.1192917054986%,4357,9668,14313,30.4408579612939%,67.5469852581569%,0.446506970653932,0.671018080876285,0.68934046345811,12983,13329,14025
2238,36,OKLAHOMA,OSAGE,7540,8138,15909,47.3945565403231%,51.1534351624866%,5597,12577,18966,29.5107033639144%,66.3134029315617%,6002,14121,20538,29.2238776901354%,68.7554776511832%,0.519071310116086,0.692032574006823,0.701734333846842,15678,18174,20123
2239,36,OKLAHOMA,OTTAWA,5647,5625,11411,49.4873367802997%,49.294540355797%,2584,7631,10690,24.1721234798877%,71.3844714686623%,2686,8545,11438,23.4831264207029%,74.7071166287813%,0.49902413058907,0.747038668624572,0.760840530674027,11272,10215,11231
2240,36,OKLAHOMA,PAWNEE,2435,3386,5925,41.0970464135021%,57.1476793248945%,1344,4729,6364,21.1187932118165%,74.3086109365179%,1363,5267,6786,20.0854700854701%,77.6156793398173%,0.581686995361622,0.77869257368681,0.794419306184012,5821,6073,6630
2241,36,OKLAHOMA,PAYNE,9319,15256,24947,37.3551930091795%,61.1536457289454%,8788,16651,27760,31.657060518732%,59.9819884726225%,10904,17813,29643,36.7844010390311%,60.0917585939345%,0.620793489318413,0.65454616926766,0.620294599018003,24575,25439,28717
2242,36,OKLAHOMA,PITTSBURG,7627,8514,16357,46.6283548327933%,52.0511096166779%,3711,12753,17271,21.4868855306583%,73.8405419489317%,3768,13851,17924,21.0220932827494%,77.2762776166034%,0.527476612353634,0.774599125364432,0.786139962540439,16141,16464,17619
2243,36,OKLAHOMA,PONTOTOC,5387,7299,12836,41.9679027734497%,56.8635088812714%,3637,10431,14831,24.5229586676556%,70.3324118400647%,4117,10805,15320,26.8733681462141%,70.5287206266319%,0.575358663093174,0.741470002843332,0.724098646294063,12686,14068,14922
2244,36,OKLAHOMA,POTTAWATOMIE,8763,13235,22316,39.2677899265101%,59.3072235167593%,6015,17848,25452,23.6327204148986%,70.1241552726701%,7275,20240,28185,25.8116019159127%,71.811247117261%,0.601645604145831,0.747936135439802,0.735598764310376,21998,23863,27515
2245,36,OKLAHOMA,PUSHMATAHA,1969,2331,4348,45.2851885924563%,53.6108555657774%,748,3581,4483,16.6852554093241%,79.8795449475797%,668,4016,4739,14.0958008018569%,84.7436167967926%,0.542093023255814,0.827211827211827,0.857386848847139,4300,4329,4684
2246,36,OKLAHOMA,ROGER MILLS,441,1234,1687,26.1410788381743%,73.1475992886781%,151,1547,1759,8.58442296759523%,87.9476975554292%,168,1629,1834,9.16030534351145%,88.8222464558342%,0.736716417910448,0.911071849234393,0.906510851419032,1675,1698,1797
2247,36,OKLAHOMA,ROGERS,10813,17713,28951,37.3493143587441%,61.1826879900522%,7902,30913,40862,19.3382604865156%,75.6521951935784%,9589,34031,44553,21.5226808520189%,76.3831840729019%,0.620942298254224,0.796418910215123,0.78016964695094,28526,38815,43620
2248,36,OKLAHOMA,SEMINOLE,3783,4011,7866,48.093058733791%,50.9916094584287%,2071,5613,8037,25.7683215130024%,69.839492347891%,2150,6011,8337,25.7886529926832%,72.1002758786134%,0.514626635873749,0.730478917230609,0.736551893150349,7794,7684,8161
2249,36,OKLAHOMA,SEQUOYAH,5425,6614,12254,44.2712583646156%,53.9742125020402%,3061,10888,14437,21.2024658862645%,75.4173304703193%,3035,12113,15386,19.7257246847784%,78.7274145326921%,0.549381177838691,0.780557746074987,0.799643517296013,12039,13949,15148
2250,36,OKLAHOMA,STEPHENS,6467,10860,17488,36.9796431838975%,62.099725526075%,3086,14182,17904,17.2363717605004%,79.2113494191242%,3154,15560,19057,16.5503489531406%,81.6497874796663%,0.626767472730421,0.821287931433866,0.831463075772149,17327,17268,18714
2251,36,OKLAHOMA,TEXAS,1084,4964,6088,17.8055190538765%,81.5374507227333%,858,4621,5780,14.8442906574394%,79.9480968858132%,894,4505,5521,16.1927187103786%,81.597536678138%,0.820767195767196,0.843402080671655,0.834413780329691,6048,5479,5399
2252,36,OKLAHOMA,TILLMAN,1400,1920,3349,41.8035234398328%,57.3305464317707%,657,1944,2706,24.2793791574279%,71.840354767184%,597,2076,2708,22.0457902511078%,76.6617429837519%,0.578313253012048,0.747404844290657,0.77665544332211,3320,2601,2673
2253,36,OKLAHOMA,TULSA,81656,134152,218691,37.3385278772332%,61.343173701707%,87847,144258,247054,35.5578132715924%,58.3912828774276%,108996,150574,266678,40.8717629500746%,56.462850328861%,0.621626631079478,0.621520432562849,0.58009014909273,215808,232105,259570
2254,36,OKLAHOMA,WAGONER,8244,12981,21517,38.3138913417298%,60.3290421527165%,6723,23005,31300,21.4792332268371%,73.4984025559105%,8464,26165,35338,23.9515535683966%,74.0421076461599%,0.611590106007067,0.773849569429494,0.755580582748563,21225,29728,34629
2255,36,OKLAHOMA,WASHINGTON,6644,13788,20744,32.0285383725415%,66.4674122637871%,5048,15825,22224,22.7141828653708%,71.2068034557236%,5790,17076,23501,24.6372494787456%,72.6607378409429%,0.674823805794832,0.758156470080966,0.746785620572028,20432,20873,22866
2256,36,OKLAHOMA,WASHITA,1564,2850,4468,35.0044762757386%,63.7869292748433%,588,3854,4631,12.697041675664%,83.2217663571583%,598,4086,4777,12.5183169353151%,85.5348545111995%,0.64567285908473,0.867627194957226,0.872331340734415,4414,4442,4684
2257,36,OKLAHOMA,WOODS,1235,2774,4046,30.5239742956006%,68.5615422639644%,522,2947,3668,14.2311886586696%,80.3435114503817%,591,2993,3678,16.068515497553%,81.3757476889614%,0.691943127962085,0.849524358604785,0.835100446428571,4009,3469,3584
2258,36,OKLAHOMA,WOODWARD,1950,5067,7100,27.4647887323944%,71.3661971830986%,873,6347,7595,11.4944042132982%,83.5681369321922%,1005,6611,7785,12.9094412331407%,84.9197174052665%,0.722103463018384,0.879085872576177,0.868040966386555,7017,7220,7616
2260,37,OREGON,BAKER,2195,5618,8258,26.5802857834827%,68.0310002421894%,1797,6218,8779,20.4693017427953%,70.8281125412917%,2346,7352,9932,23.6206202174789%,74.0233588401128%,0.719057980289261,0.775795383655646,0.758094452464426,7813,8015,9698
2261,37,OREGON,BENTON,19444,15825,38226,50.8659027886779%,41.3985245644326%,29193,13445,48753,59.8793920374131%,27.5777900847127%,35827,14878,52799,67.8554518077994%,28.1785639879543%,0.44869432079163,0.315329049204935,0.293422739374815,35269,42638,50705
2262,37,OREGON,CLACKAMAS,76421,77539,162262,47.0972871035732%,47.7862962369501%,102095,88392,214039,47.6992510710665%,41.2971467816613%,139043,110509,257679,53.9597716538794%,42.886304277803%,0.503630813198233,0.464031666202943,0.442829550554594,153960,190487,249552
2263,37,OREGON,CLATSOP,8296,6950,16474,50.3581400995508%,42.1876896928493%,9252,8138,19664,47.0504475183076%,41.3852725793328%,12916,10218,23910,54.0192388122125%,42.7352572145546%,0.455857274039092,0.467970097757332,0.441687559436327,15246,17390,23134
2264,37,OREGON,COLUMBIA,10331,9369,21195,48.7426279782968%,44.203821656051%,10167,13217,26618,38.1959576226614%,49.6543692238335%,13835,17150,32221,42.9378355730735%,53.2261568542255%,0.475583756345178,0.565215531987684,0.553493625948039,19700,23384,30985
2265,37,OREGON,COOS,11610,15626,29379,39.5180230777086%,53.1876510432622%,10448,17865,31313,33.366333471721%,57.0529811899211%,14243,21829,37075,38.4167228590695%,58.8779501011463%,0.573725950947276,0.630982234309328,0.605150809492127,27236,28313,36072
2266,37,OREGON,CROOK,2474,5363,8277,29.8900567838589%,64.7940074906367%,2637,8511,12172,21.6644758462044%,69.9227735787052%,3801,11287,15448,24.6051268772657%,73.0644743656137%,0.684317978818425,0.763455328310011,0.748077942735949,7837,11148,15088
2267,37,OREGON,CURRY,4090,6551,11513,35.5250586293755%,56.9008946408408%,4300,7212,12611,34.0972167155658%,57.1881690587582%,6058,8484,14925,40.5896147403685%,56.8442211055276%,0.615637628042477,0.626476719944406,0.583413560720671,10641,11512,14542
2268,37,OREGON,DESCHUTES,22061,32132,57885,38.1117733436987%,55.5100630560594%,42444,45692,98557,43.065434215733%,46.3609890723135%,65962,55646,125234,52.6709998882093%,44.4336202628679%,0.592917904526415,0.518426068802759,0.457585027300835,54193,88136,121608
2269,37,OREGON,DOUGLAS,14193,30294,47220,30.0571791613723%,64.1550190597205%,14096,34582,53521,26.337325535771%,64.6138898750023%,19160,43298,64349,29.7751324806912%,67.2862049138293%,0.680962977948614,0.710423599983566,0.693233853149316,44487,48678,62458
2270,37,OREGON,GILLIAM,359,679,1090,32.9357798165138%,62.2935779816514%,239,671,1019,23.4543670264966%,65.8488714425908%,324,834,1178,27.5042444821732%,70.7979626485569%,0.654142581888247,0.737362637362637,0.72020725388601,1038,910,1158
2271,37,OREGON,GRANT,589,3078,3846,15.3146125845034%,80.0312012480499%,739,3210,4340,17.0276497695853%,73.963133640553%,929,3545,4596,20.213228894691%,77.1322889469104%,0.839378238341969,0.812864016206635,0.792355833705856,3667,3949,4474
2272,37,OREGON,HARNEY,766,2799,3734,20.5141938939475%,74.9598286020354%,683,2912,3974,17.1867136386512%,73.2762959235028%,894,3475,4481,19.9509038161125%,77.5496540950681%,0.785133239831697,0.810013908205841,0.795376516365301,3565,3595,4369
2273,37,OREGON,HOOD RIVER,4072,3721,8549,47.6313019066558%,43.5255585448591%,6510,3272,10910,59.6700274977085%,29.9908340971586%,8764,3955,13090,66.951871657754%,30.2139037433155%,0.477479789554729,0.334491923941934,0.31095211887727,7793,9782,12719
2274,37,OREGON,JACKSON,33153,46052,84796,39.0973630831643%,54.3091655266758%,44447,53870,109327,40.6550989234133%,49.2741957613398%,59478,63869,127165,46.7723036999174%,50.2252978413872%,0.581427940155293,0.547921519167591,0.517799378987734,79205,98317,123347
2275,37,OREGON,JEFFERSON,2681,3838,6897,38.8719733217341%,55.6473829201102%,2980,5483,9459,31.5043873559573%,57.9659583465483%,4393,7189,11913,36.8756820280366%,60.3458406782507%,0.588740604387176,0.647879002717712,0.62070454152996,6519,8463,11582
2276,37,OREGON,JOSEPHINE,11864,22186,36733,32.2979337380557%,60.398007241445%,13453,26923,44560,30.1907540394973%,60.4196588868941%,18451,31751,51641,35.7293623283825%,61.4840920973645%,0.651571218795888,0.666807014067763,0.632464842038166,34050,40376,50202
2277,37,OREGON,KLAMATH,7541,18855,27844,27.0830340468323%,67.7165637121103%,7210,20435,30507,23.6339200839152%,66.9846264791687%,10388,25308,36726,28.2851385939117%,68.9103087730763%,0.714312774662828,0.739193344185205,0.708987001344689,26396,27645,35696
2278,37,OREGON,LAKE,707,2830,3729,18.959506570126%,75.8916599624564%,639,3022,3930,16.2595419847328%,76.8956743002545%,792,3470,4363,18.1526472610589%,79.5324318129727%,0.800113090189426,0.825457525266321,0.814171750351947,3537,3661,4262
2279,37,OREGON,LANE,78583,61578,152188,51.6354771729703%,40.4617972507688%,102753,67141,191950,53.5311278978901%,34.9783797864027%,134366,80336,222253,60.4563267987384%,36.1461937521653%,0.439337618881144,0.395193473577642,0.374174437126808,140161,169894,214702
2280,37,OREGON,LINCOLN,10861,8446,21118,51.430059664741%,39.9943176437163%,12501,10039,25256,49.4971491922711%,39.7489705416535%,17385,12460,30726,56.580745948057%,40.5519755256135%,0.437457916817735,0.445385980479148,0.417490366895627,19307,22540,29845
2281,37,OREGON,LINN,16682,25359,44388,37.5822294313778%,57.1303054879697%,17995,33488,58719,30.6459578671299%,57.0309439874657%,26512,43486,72640,36.4977973568282%,59.8650881057269%,0.603196879236935,0.650467144494299,0.621246321323466,42041,51483,69998
2282,37,OREGON,MALHEUR,2336,7624,10404,22.4529027297193%,73.279507881584%,2246,7194,10435,21.5237182558697%,68.941063727839%,3260,8187,11804,27.6177566926466%,69.3578447983734%,0.765461847389558,0.762076271186441,0.715209225124487,9960,9440,11447
2283,37,OREGON,MARION,49430,57443,113334,43.6144493267687%,50.684701854695%,57788,63377,136840,42.2303420052616%,46.3146740719088%,80872,79002,165534,48.855220075634%,47.7255427887926%,0.537488420835946,0.52306359097099,0.494151644419981,106873,121165,159874
2284,37,OREGON,MORROW,1197,2224,3609,33.1670822942643%,61.6237184815738%,1017,2721,4167,24.4060475161987%,65.2987760979122%,1371,3586,5118,26.7878077373974%,70.0664322000782%,0.650102309266296,0.72792937399679,0.723421424248537,3421,3738,4957
2285,37,OREGON,MULTNOMAH,188441,83677,296685,63.51551308627%,28.2039873940375%,292561,67954,399103,73.3046356454349%,17.0266823351365%,367249,82995,463659,79.2067014767318%,17.900008411354%,0.307502627536583,0.188491463600682,0.184333383676407,272118,360515,450244
2286,37,OREGON,POLK,11921,14988,28449,41.9030545889135%,52.6837498681852%,16420,18940,40295,40.7494726392853%,47.0033502915995%,22917,23732,48291,47.4560477107536%,49.1437327866476%,0.556988368203947,0.535633484162896,0.508735449848871,26909,35360,46649
2287,37,OREGON,SHERMAN,326,679,1062,30.6967984934087%,63.9359698681733%,202,732,1017,19.8623402163225%,71.976401179941%,260,921,1208,21.523178807947%,76.2417218543046%,0.675621890547264,0.78372591006424,0.779847586790855,1005,934,1181
2288,37,OREGON,TILLAMOOK,5762,5775,12376,46.5578539107951%,46.6628959276018%,5768,6538,13803,41.7880170977324%,47.3665145258277%,8066,8354,16888,47.761724301279%,49.4670772145902%,0.500563404697928,0.531285551763367,0.508769792935445,11537,12306,16420
2289,37,OREGON,UMATILLA,7809,14140,23060,33.8638334778838%,61.3183000867303%,7673,17059,27597,27.8037467840707%,61.8146900025365%,10707,21270,33038,32.4081360857195%,64.3804104364671%,0.644220693425669,0.689754164644994,0.665165587766207,21949,24732,31977
2290,37,OREGON,UNION,3577,7836,12076,29.6207353428287%,64.8890361046704%,3249,8431,12968,25.053979025293%,65.0138803207896%,4254,10298,14944,28.4662740899358%,68.9105995717345%,0.686585472706563,0.721832191780822,0.707669048927982,11413,11680,14552
2291,37,OREGON,WALLOWA,836,3279,4294,19.4690265486726%,76.3623660922217%,1116,2848,4366,25.5611543747137%,65.2313330279432%,1625,3404,5149,31.559526121577%,66.1099242571373%,0.796840826245443,0.718466195761857,0.676874130045735,4115,3964,5029
2292,37,OREGON,WASCO,4616,5356,10664,43.2858214553638%,50.225056264066%,4781,5833,11964,39.9615513206286%,48.7545971247075%,6604,7035,14130,46.7374380750177%,49.7876857749469%,0.537103890894505,0.549557188618805,0.515800278612802,9972,10614,13639
2293,37,OREGON,WASHINGTON,90662,86091,185974,48.749825244389%,46.2919547893792%,153251,83197,269232,56.9215397872467%,30.9016015926784%,209940,99073,320326,65.5394816530659%,30.928803781148%,0.487069526401249,0.351861720124509,0.320611106976082,176753,236448,309013
2294,37,OREGON,WHEELER,202,584,841,24.0190249702735%,69.4411414982164%,155,591,818,18.9486552567237%,72.2493887530562%,217,711,965,22.4870466321244%,73.6787564766839%,0.743002544529262,0.792225201072386,0.766163793103448,786,746,928
2295,37,OREGON,YAMHILL,14254,19193,35539,40.108050310926%,54.0054587917499%,19301,23250,48753,39.5893586035731%,47.6893729616639%,27174,29551,58923,46.1178147752151%,50.1518931486856%,0.573833228690167,0.546403139761698,0.520951961216395,33447,42551,56725
2297,38,PENNSYLVANIA,ADAMS,11682,20848,33433,34.9415248407262%,62.357550922741%,14219,31423,47489,29.941670702689%,66.1690075596454%,18207,37523,56540,32.201980898479%,66.3654050229926%,0.640885336612358,0.688466763069103,0.673299838507088,32530,45642,55730
2298,38,PENNSYLVANIA,ALLEGHENY,329963,235361,582478,56.6481480845629%,40.4068479839582%,367617,259480,650114,56.5465441445654%,39.9129998738683%,429065,282324,719733,59.6144681430475%,39.2262130540075%,0.416329396947591,0.413779686396203,0.396863038365789,565324,627097,711389
2299,38,PENNSYLVANIA,ARMSTRONG,11127,15508,27423,40.5754293840936%,56.5510702694818%,7178,23484,31618,22.7022582073502%,74.2741476374217%,8457,27489,36370,23.2526807808633%,75.5815232334341%,0.582241411676366,0.765899158567608,0.764730428976799,26635,30662,35946
2300,38,PENNSYLVANIA,BEAVER,38925,32491,73593,52.8922587746117%,44.1495794436971%,32531,48167,83571,38.9261825274318%,57.6360220650704%,38122,54759,94122,40.5027517477317%,58.1787467329636%,0.454954071916657,0.59687972440457,0.589560835908313,71416,80698,92881
2301,38,PENNSYLVANIA,BEDFORD,5474,13598,19435,28.1656804733728%,69.9665551839465%,3645,19552,23637,15.4207386724204%,82.7177729830351%,4367,23025,27574,15.8373830419961%,83.5025748893886%,0.712982382550335,0.842867612191232,0.840573890186916,19072,23197,27392
2302,38,PENNSYLVANIA,BERKS,59150,71273,135163,43.761976280491%,52.7311468375221%,78437,96626,183065,42.8465299210663%,52.7823450686915%,92895,109736,205540,45.1955823683955%,53.3891213389121%,0.546475698304747,0.55194986947556,0.541555833016666,130423,175063,202631
2303,38,PENNSYLVANIA,BLAIR,15774,28376,45140,34.9446167478954%,62.8622064687639%,13958,39135,54909,25.420240761988%,71.272468994154%,17636,45306,63595,27.7317399166601%,71.2414497995125%,0.642718006795017,0.737102819580736,0.719805535254679,44150,53093,62942
2304,38,PENNSYLVANIA,BRADFORD,7911,14660,23330,33.9091298756965%,62.8375482211745%,6369,18141,25708,24.774389295161%,70.5655826979929%,8046,21600,30159,26.6786034019696%,71.620411817368%,0.649506003278543,0.740146878824969,0.728597449908925,22571,24510,29646
2305,38,PENNSYLVANIA,BUCKS,132914,121927,263422,50.4566816742717%,46.2858075635292%,167060,164361,344297,48.5220608950993%,47.7381446832241%,204712,187367,396234,51.6644205191882%,47.2869566973051%,0.478443421584439,0.495928139737675,0.477880733219581,254841,331421,392079
2306,38,PENNSYLVANIA,BUTLER,25037,44009,70824,35.3510109567378%,62.1385406077036%,28584,64428,97071,29.4464876224619%,66.3720369626356%,37508,74359,113305,33.1035700101496%,65.627289175235%,0.637386669756394,0.692684814862598,0.664708984776565,69046,93012,111867
2307,38,PENNSYLVANIA,CAMBRIA,30308,28001,60286,50.2736953853299%,46.4469362704442%,18867,42258,63072,29.9134322678843%,66.9996194824962%,21730,48085,70574,30.7903760591719%,68.1341570550061%,0.48021746214135,0.691337423312883,0.688748836209984,58309,61125,69815
2308,38,PENNSYLVANIA,CAMERON,779,1383,2246,34.6838824577026%,61.5761353517364%,531,1589,2186,24.2909423604758%,72.6898444647758%,634,1771,2434,26.0476581758422%,72.7608874281019%,0.639685476410731,0.749528301886792,0.736382536382536,2162,2120,2405
2309,38,PENNSYLVANIA,CARBON,10668,9717,21277,50.1386473657001%,45.6690322883865%,8936,18743,28776,31.053655824298%,65.1341395607451%,11212,21984,33629,33.3402717892295%,65.3721490380327%,0.476674025018396,0.677155966617291,0.662248463670322,20385,27679,33196
2310,38,PENNSYLVANIA,CENTRE,21409,26172,49538,43.2173281117526%,52.8321692438128%,37088,35274,76148,48.705153122866%,46.3229500446499%,40055,36372,77493,51.6885396100293%,46.9358522705277%,0.550051491141422,0.487465796965258,0.475905112067725,47581,72362,76427
2311,38,PENNSYLVANIA,CHESTER,82047,100080,187562,43.7439353387147%,53.3583561702264%,141682,116114,268800,52.7090773809524%,43.1971726190476%,182372,128565,314502,57.9875485688485%,40.878913329645%,0.549506662933008,0.450410402023305,0.413476041770519,182127,257796,310937
2312,38,PENNSYLVANIA,CLARION,5605,9796,15843,35.3784005554504%,61.8317237896863%,4273,12576,17535,24.3684060450528%,71.7194183062446%,4678,14578,19493,23.9983583850613%,74.785820550967%,0.636062593338095,0.746394444774171,0.757062733693394,15401,16849,19256
2313,38,PENNSYLVANIA,CLEARFIELD,11718,18019,30609,38.2828579829462%,58.8683067071776%,8200,24932,34271,23.9269353097371%,72.7495550173616%,9673,29203,39422,24.5370605245802%,74.0779260311501%,0.605945455156875,0.752505130991187,0.751183249305484,29737,33132,38876
2314,38,PENNSYLVANIA,CLINTON,5521,6064,11994,46.0313490078373%,50.5586126396532%,4744,10022,15394,30.8172015070807%,65.1032869949331%,5502,11902,17625,31.2170212765957%,67.5290780141844%,0.523435476909797,0.678721386970066,0.683865777982073,11585,14766,17404
2315,38,PENNSYLVANIA,COLUMBIA,8975,12095,21894,40.9929661094364%,55.2434456928839%,8934,18004,28228,31.6494261017429%,63.780643332861%,10532,20098,31171,33.7878155978313%,64.4765968368034%,0.574038917892739,0.668349543395946,0.656154097290238,21070,26938,30630
2316,38,PENNSYLVANIA,CRAWFORD,13250,18858,33321,39.7647129437892%,56.5949401278473%,10971,24987,37492,29.2622426117572%,66.6462178598101%,12924,28559,42004,30.768498238263%,67.9911437005999%,0.587330260371247,0.694894043050225,0.68845069064436,32108,35958,41483
2317,38,PENNSYLVANIA,CUMBERLAND,31053,54802,88062,35.2626558561014%,62.2311553223865%,47085,69076,121617,38.7158045339056%,56.797980545483%,62245,77212,141595,43.9598855891804%,54.5301740880681%,0.638308776425368,0.594657415139332,0.55366170217343,85855,116161,139457
2318,38,PENNSYLVANIA,DAUPHIN,44390,53631,100658,44.0998231635836%,53.2804148701544%,64706,60863,130872,49.4422030686472%,46.5057460724983%,78983,66408,147368,53.5957602736008%,45.0627001791434%,0.547137858214056,0.484697656268665,0.45675454464169,98021,125569,145391
2319,38,PENNSYLVANIA,DELAWARE,134861,105836,248077,54.3625567868041%,42.66256041471%,177402,110667,297634,59.6040774911469%,37.1822439640632%,206423,118532,327931,62.9470833803453%,36.1454086377927%,0.439706352800409,0.384168376326505,0.364764351987198,240697,288069,324955
2320,38,PENNSYLVANIA,ELK,5754,7347,13578,42.3773751657092%,54.1095890410959%,3853,10025,14426,26.7087203660058%,69.4925828365451%,4522,12140,16906,26.7479001537916%,71.8088252691352%,0.560796885733913,0.722366335206802,0.728604009122554,13101,13878,16662
2321,38,PENNSYLVANIA,ERIE,59399,49027,112335,52.8766635509859%,43.6435661191971%,58112,60069,123679,46.9861496292823%,48.5684716079529%,68286,66869,137083,49.8136165680646%,48.7799362430061%,0.452170143692472,0.508279672705426,0.494757870593023,108426,118181,135155
2322,38,PENNSYLVANIA,FAYETTE,28152,20013,49532,56.8359848178955%,40.4041831543245%,17946,34590,53767,33.3773504194022%,64.3331411460561%,20444,41227,62139,32.9004329004329%,66.3464169040377%,0.415509187169106,0.658405664687072,0.668498970342625,48165,52536,61671
2323,38,PENNSYLVANIA,FOREST,843,1371,2283,36.9250985545335%,60.0525624178712%,626,1683,2401,26.0724698042482%,70.0957934194086%,728,1882,2646,27.5132275132275%,71.1262282690854%,0.619241192411924,0.728886964053703,0.721072796934866,2214,2309,2610
2324,38,PENNSYLVANIA,FRANKLIN,14922,33042,48969,30.4723396434479%,67.4753415426086%,17465,49768,69731,25.0462491574766%,71.3714130013911%,22422,57245,80783,27.7558397187527%,70.862681504772%,0.688891668751564,0.740231731441405,0.718553478855737,47964,67233,79667
2325,38,PENNSYLVANIA,FULTON,1425,3753,5285,26.9631031220435%,71.0122989593188%,912,5694,6771,13.4692069118299%,84.0939299955693%,1085,6824,7977,13.6016046132631%,85.5459445906983%,0.724797219003476,0.861943687556767,0.862814515109369,5178,6606,7909
2326,38,PENNSYLVANIA,GREENE,7230,5890,13634,53.0291917265659%,43.2008214757225%,4482,10849,15764,28.4318700837351%,68.8213651357524%,4911,12579,17669,27.7944422434773%,71.1924840115456%,0.448932926829268,0.707651164307612,0.719210977701544,13120,15331,17490
2327,38,PENNSYLVANIA,HUNTINGDON,5073,10408,15957,31.7916901673247%,65.22529297487%,4539,14494,19706,23.0335938292906%,73.551202679387%,5445,17061,22792,23.8899613899614%,74.8552123552124%,0.672307990439894,0.761519466190301,0.758064516129032,15481,19033,22506
2328,38,PENNSYLVANIA,INDIANA,13667,16799,31401,43.5240915894398%,53.4982962326041%,11528,24888,37770,30.5215779719354%,65.8935663224782%,12634,28089,41198,30.6665372105442%,68.1804941987475%,0.551401562397427,0.683435852372584,0.689757630822877,30466,36416,40723
2329,38,PENNSYLVANIA,JEFFERSON,5566,11473,17574,31.671787868442%,65.2839421873222%,3650,15192,19478,18.7390902556731%,77.9956874422425%,4527,17960,22824,19.8343848580442%,78.6890991938311%,0.673337637185281,0.806283833987899,0.798683683906257,17039,18842,22487
2330,38,PENNSYLVANIA,JUNIATA,2656,5795,8667,30.6449751932618%,66.862812968732%,1821,8273,10454,17.4191696958102%,79.1371723742108%,2253,9649,12043,18.7079631321099%,80.1212322511002%,0.685717666548337,0.819595799484842,0.810704083347336,8451,10094,11902
2331,38,PENNSYLVANIA,LACKAWANNA,57471,35096,96381,59.6289725153298%,36.4138160010791%,51983,48384,103456,50.2464815960408%,46.7677080111352%,61991,52334,115410,53.7137163157439%,45.346157178754%,0.379141594736785,0.4820708001634,0.457765143232014,92567,100367,114325
2332,38,PENNSYLVANIA,LANCASTER,54968,115900,175317,31.3534911046847%,66.1088200231581%,91093,137914,241112,37.7803676299811%,57.1991439662895%,115847,160209,280239,41.3386430867938%,57.1687024289981%,0.678301378842147,0.602226132825634,0.58034963920364,170868,229007,276056
2333,38,PENNSYLVANIA,LAWRENCE,20593,18060,39640,51.9500504540868%,45.5600403632694%,14009,25428,40753,34.3753834073565%,62.3954064731431%,15978,29597,46076,34.6774893653963%,64.235176664641%,0.467234108607353,0.644775211096179,0.649413055403182,38653,39437,45575
2334,38,PENNSYLVANIA,LEBANON,16093,28534,45880,35.0762859633827%,62.1926765475153%,18953,40525,61845,30.6459697631175%,65.5267200258711%,23932,46731,71652,33.4003237871937%,65.2193937363926%,0.639388710870101,0.681344362621473,0.661322049728995,44627,59478,70663
2335,38,PENNSYLVANIA,LEHIGH,56667,55492,116280,48.7332301341589%,47.7227382180943%,81324,73690,160993,50.513997502997%,45.7721764300311%,98288,84259,184713,53.2111979124371%,45.6161721156605%,0.494761900516231,0.475376417613893,0.461574279500622,112159,155014,182547
2336,38,PENNSYLVANIA,LUZERNE,62199,52328,119586,52.0119411971301%,43.7576304918636%,52451,78688,134983,38.8574857574658%,58.2947482275546%,64873,86929,153321,42.3118816078685%,56.6973865289165%,0.456905358561736,0.600035077284408,0.572647264199418,114527,131139,151802
2337,38,PENNSYLVANIA,LYCOMING,14663,27137,43183,33.9554917444365%,62.8418590649098%,13020,35627,50565,25.7490358943934%,70.4578265598734%,16971,41462,59254,28.6411043980153%,69.9733351334931%,0.649210526315789,0.732357596562995,0.709564800711927,41800,48647,58433
2338,38,PENNSYLVANIA,MCKEAN,5510,9661,15804,34.8645912427234%,61.1300936471779%,4025,11635,16296,24.6993127147766%,71.3978890525282%,5098,14083,19466,26.1892530566115%,72.3466557073872%,0.636807066112979,0.742975734355045,0.734216151399823,15171,15660,19181
2339,38,PENNSYLVANIA,MERCER,23817,23132,48725,48.8804515135967%,47.4746023601847%,18733,31544,52309,35.8121929304709%,60.3031983023954%,21067,36143,57954,36.3512440901405%,62.3649791213721%,0.492704849943556,0.627404180838157,0.631760181786401,46949,50277,57210
2340,38,PENNSYLVANIA,MIFFLIN,4835,9400,14614,33.0847132886273%,64.3218831257698%,3877,14094,18601,20.842965431966%,75.7701198860276%,4603,16670,21502,21.4073109478188%,77.5276718444796%,0.660344221988058,0.7842635356964,0.78362243219104,14235,17971,21273
2341,38,PENNSYLVANIA,MONROE,21939,23265,46878,46.8002047868936%,49.6288237552797%,33918,33386,69752,48.6265626792063%,47.863860534465%,44060,38726,83829,52.5593768266352%,46.196423671999%,0.514666843642156,0.496047783192678,0.467784407991689,45204,67304,82786
2342,38,PENNSYLVANIA,MONTGOMERY,177990,145623,332422,53.5433876217579%,43.8066674287502%,256082,162731,434687,58.9118147080543%,37.4363622560601%,319511,185460,510157,62.6299354904471%,36.3535147023367%,0.449991193184452,0.388552886371722,0.36726861542544,323613,418813,504971
2343,38,PENNSYLVANIA,MONTOUR,2356,3960,6492,36.2908194701171%,60.9981515711645%,2857,5288,8556,33.3917718560075%,61.8045815801777%,3771,5844,9771,38.5937979735953%,59.8096407737181%,0.626979100696643,0.649232658072437,0.607800312012481,6316,8145,9615
2344,38,PENNSYLVANIA,NORTHAMPTON,53097,47396,104690,50.7183112045085%,45.2727099054351%,66272,71736,143519,46.1764644402483%,49.9836258613842%,85087,83854,170942,49.7753624036223%,49.0540651215032%,0.471634840237628,0.519795953857747,0.496350797023813,100493,138008,168941
2345,38,PENNSYLVANIA,NORTHUMBERLAND,13670,18142,33251,41.1115455174281%,54.5607650897717%,9788,25427,36622,26.7271039266015%,69.4309431489269%,12677,28952,42283,29.9813163682804%,68.4719627273372%,0.570287941657236,0.722050262672157,0.695476710946696,31812,35215,41629
2346,38,PENNSYLVANIA,PERRY,4459,11184,16071,27.7456287723228%,69.591189098376%,4632,15616,21158,21.8924283958786%,73.8065979771245%,5950,18293,24652,24.1359727405484%,74.2049326626643%,0.714952374864157,0.771236665349664,0.754568329002186,15643,20248,24243
2347,38,PENNSYLVANIA,PHILADELPHIA,449182,100959,561180,80.042410634734%,17.9904843365765%,584025,108748,707631,82.5324215586937%,15.3678965449507%,603790,132740,741377,81.4416956555167%,17.9045209117628%,0.183514771667627,0.15697493984321,0.180223480374187,550141,692773,736530
2348,38,PENNSYLVANIA,PIKE,7330,9339,17364,42.2137756277355%,53.7836903939184%,9256,16056,26101,35.4622428259454%,61.5148844871844%,13019,19213,32554,39.9920132702586%,59.0188609694661%,0.560261563381127,0.634323640960809,0.5960846363862,16669,25312,32232
2349,38,PENNSYLVANIA,POTTER,2037,4858,7090,28.7306064880113%,68.5190409026798%,1302,6251,7784,16.726618705036%,80.3057553956834%,1726,7239,9064,19.0423654015887%,79.8654015887026%,0.704568527918782,0.827618164967562,0.807473508087005,6895,7553,8965
2350,38,PENNSYLVANIA,SCHUYLKILL,26215,29841,58300,44.9656946826758%,51.1852487135506%,16770,44001,62869,26.6745136712847%,69.9883885539773%,20727,48871,70603,29.3571094712689%,69.2194382674957%,0.532342657342657,0.724046008787086,0.702189718095348,56056,60771,69598
2351,38,PENNSYLVANIA,SNYDER,3536,8963,12841,27.5367961996729%,69.7998598240013%,4002,11725,16363,24.4576177962476%,71.6555643830593%,4910,13983,19140,25.6530825496343%,73.0564263322884%,0.717097367789423,0.745533159534558,0.740115386651141,12499,15727,18893
2352,38,PENNSYLVANIA,SOMERSET,12028,20218,32985,36.4650598757011%,61.2945278156738%,7376,27379,35773,20.6189025242501%,76.5353758421156%,8654,31466,40543,21.3452383888711%,77.611424906889%,0.626992495193202,0.787771543662782,0.784297108673978,32246,34755,40120
2353,38,PENNSYLVANIA,SULLIVAN,1066,1928,3105,34.3317230273752%,62.0933977455717%,750,2291,3136,23.9158163265306%,73.0548469387755%,921,2619,3595,25.6189151599444%,72.8511821974965%,0.643954575818303,0.753370601775732,0.739830508474576,2994,3041,3540
2354,38,PENNSYLVANIA,SUSQUEHANNA,6481,10226,17271,37.5253314805165%,59.2090788026171%,5123,12891,18863,27.1589884959975%,68.3401367756985%,6236,15207,21752,28.6686281721221%,69.9108127988231%,0.612078769378105,0.715610081048074,0.709182483794245,16707,18014,21443
2355,38,PENNSYLVANIA,TIOGA,4617,9635,14772,31.2550771730301%,65.2247495261305%,3901,13614,18325,21.2878581173261%,74.2919508867667%,4955,15742,21075,23.5112692763938%,74.6951364175564%,0.676045467302835,0.777276620039966,0.760593322703773,14252,17515,20697
2356,38,PENNSYLVANIA,UNION,4209,8523,13175,31.9468690702087%,64.6907020872865%,6180,10622,17468,35.3789787039157%,60.8083352415846%,7475,12356,20115,37.1613223962217%,61.4267959234402%,0.669415645617342,0.63218664444709,0.623064898391407,12732,16802,19831
2357,38,PENNSYLVANIA,VENANGO,8196,11642,20523,39.9356819178483%,56.7265994250353%,6309,16021,23348,27.021586431386%,68.6182970704129%,7585,18569,26528,28.5924306393245%,69.997738238842%,0.586853513459018,0.717465293327362,0.70998700007647,19838,22330,26154
2358,38,PENNSYLVANIA,WARREN,7537,9290,17541,42.9679037683142%,52.9616327461376%,5145,12477,18434,27.910382987957%,67.6847130302702%,6066,14237,20650,29.3753026634383%,68.9443099273608%,0.552088904736435,0.708035410282601,0.701226419740925,16827,17622,20303
2359,38,PENNSYLVANIA,WASHINGTON,44961,37339,84441,53.2454613280279%,44.2190405134946%,36322,61386,101450,35.8028585510104%,60.5086249383933%,45088,72080,118478,38.056010398555%,60.8382990935026%,0.453693803159174,0.628259712613092,0.615185033456234,82300,97708,117168
2360,38,PENNSYLVANIA,WAYNE,6904,11201,18914,36.5020619646822%,59.2206830918896%,7008,16244,24018,29.1781164126905%,67.6326088766758%,9191,18637,28089,32.7209939834099%,66.3498166542063%,0.618668876001105,0.698606571477722,0.669721144171338,18105,23252,27828
2361,38,PENNSYLVANIA,WESTMORELAND,71792,80858,156709,45.8123017822844%,51.5975470457983%,59669,116522,182051,32.7759803571527%,64.0051414164163%,72129,130218,204697,35.2369599945285%,63.615001685418%,0.529695381591877,0.661339114937766,0.643538080623879,152650,176191,202347
2362,38,PENNSYLVANIA,WYOMING,4363,6922,11693,37.3129222611819%,59.197810655948%,3811,8837,13144,28.9942178940962%,67.2321972002435%,4704,9936,14858,31.6597119396958%,66.8730650154799%,0.613380593708463,0.698687539531942,0.678688524590164,11285,12648,14640
2363,38,PENNSYLVANIA,YORK,51958,87652,144244,36.0209090152797%,60.7664790216578%,68524,128528,205986,33.2663384890235%,62.3964735467459%,88114,146733,238471,36.9495661946316%,61.5307521669302%,0.627834682329346,0.652254227310558,0.624802531009551,139610,197052,234847
2365,39,RHODE ISLAND,BRISTOL,13424,8375,23272,57.6830525953936%,35.9874527328979%,14609,8965,25475,57.3464180569185%,35.1913640824338%,18050,9745,28415,63.5227872602499%,34.2952665845504%,0.384191935409881,0.38029184695003,0.35060262637165,21799,23574,27795
2366,39,RHODE ISLAND,FEDERAL PRECINCT,0,0,0,#DIV/0!,#DIV/0!,637,53,728,87.5%,7.28021978021978%,1276,85,1374,92.8675400291121%,6.1863173216885%,#DIV/0!,0.0768115942028986,0.0624540778839089,0,690,1361
2367,39,RHODE ISLAND,KENT,43265,25291,73470,58.8879814890432%,34.4235742479924%,37788,38336,82053,46.0531607619466%,46.7210217786065%,49113,42001,93093,52.756920498856%,45.1172483430548%,0.368910088103157,0.503599390468184,0.460971969181465,68556,76124,91114
2368,39,RHODE ISLAND,NEWPORT,20790,14258,37838,54.9447645224378%,37.6816956498758%,22851,15077,41045,55.6730417834085%,36.7328541844317%,29486,15722,46148,63.8944266273728%,34.0686486955014%,0.406813512896599,0.397516346762286,0.347770306140506,35048,37928,45208
2369,39,RHODE ISLAND,PROVIDENCE,142469,61378,218308,65.2605493156458%,28.1153233046888%,142899,90882,248474,57.5106449769392%,36.5760602718997%,165012,102551,272667,60.5177744281486%,37.6103452196269%,0.301098372799207,0.388748444056617,0.383277956967144,203847,233781,267563
2370,39,RHODE ISLAND,WASHINGTON,29560,21253,56224,52.5754126351736%,37.8005833807627%,33741,27230,66369,50.8384938751526%,41.0281908722446%,44549,29818,76060,58.5708651064949%,39.2032605837497%,0.418259106921457,0.446605763395713,0.400957413906706,50813,60971,74367
2372,40,SOUTH CAROLINA,ABBEVILLE,3766,4450,8374,44.9725340339145%,53.1406735132553%,3741,6763,10775,34.7192575406032%,62.7656612529002%,4101,8215,12433,32.9847985200676%,66.0741574841149%,0.541626095423564,0.643849961919269,0.66701851250406,8216,10504,12316
2373,40,SOUTH CAROLINA,AIKEN,16409,33203,50782,32.3126304596117%,65.3834035681935%,25455,46025,74851,34.0075616892226%,61.488824464603%,32275,51589,85185,37.8881258437518%,60.561131654634%,0.669253406433927,0.643886401790711,0.615150720213679,49612,71480,83864
2374,40,SOUTH CAROLINA,ALLENDALE,2338,967,3340,70%,28.9520958083832%,2735,789,3592,76.141425389755%,21.9654788418708%,2718,835,3593,75.6470915669357%,23.2396326189814%,0.292586989409985,0.223893303064699,0.235012665353223,3305,3524,3553
2375,40,SOUTH CAROLINA,ANDERSON,19606,35827,56681,34.5900742753304%,63.2081297083679%,21097,56232,80483,26.2129890784389%,69.8681709180821%,27169,67565,96093,28.2736515667114%,70.3120934927622%,0.646311763750834,0.727178678115584,0.713207507336331,55433,77329,94734
2376,40,SOUTH CAROLINA,BAMBERG,3451,2047,5551,62.1689785624212%,36.8762385155828%,3898,2204,6214,62.7293208883167%,35.4682973929836%,4010,2417,6482,61.8636223387843%,37.2878741129281%,0.372317206256821,0.361193051458538,0.376069705928116,5498,6102,6427
2377,40,SOUTH CAROLINA,BARNWELL,3661,4521,8276,44.236346060899%,54.6278395360077%,4400,4889,9485,46.3890353189246%,51.5445440168687%,4720,5492,10321,45.7320027129154%,53.2118980718923%,0.552554387680274,0.526321455484982,0.537798668233451,8182,9289,10212
2378,40,SOUTH CAROLINA,BEAUFORT,17487,25561,44148,39.6099483555314%,57.8984325450756%,32138,42922,78524,40.9276144872905%,54.6609953644746%,43419,53194,97835,44.3798231716666%,54.3711350743599%,0.593779037353652,0.57183586464162,0.550588430128451,43048,75060,96613
2379,40,SOUTH CAROLINA,BERKELEY,17707,24796,43316,40.8786591559701%,57.2444362360329%,30705,44587,79517,38.6143843454859%,56.072286429317%,45223,57397,104458,43.2929981427942%,54.9474429914415%,0.583394113356704,0.592187749030441,0.559315922822062,42503,75292,102620
2380,40,SOUTH CAROLINA,CALHOUN,3063,3216,6373,48.0621371410639%,50.4628903185313%,3573,3787,7549,47.3307722877202%,50.1655848456749%,3905,4305,8291,47.0992642624533%,51.9237727656495%,0.512183468705208,0.514538043478261,0.524360535931791,6279,7360,8210
2381,40,SOUTH CAROLINA,CHARLESTON,49520,58229,111476,44.4221177652589%,52.2345616993792%,89299,75443,176345,50.6388046159517%,42.7814794862344%,121485,93297,218857,55.5088482433735%,42.629205371544%,0.540413368105504,0.457946364618616,0.43437997597564,107749,164742,214782
2382,40,SOUTH CAROLINA,CHEROKEE,6138,9900,16323,37.6033817312994%,60.6506156956442%,6092,15167,21759,27.9976101842916%,69.7044900960522%,6983,18043,25270,27.6335575781559%,71.4008705975465%,0.617283950617284,0.713439014064632,0.720970191001359,16038,21259,25026
2383,40,SOUTH CAROLINA,CHESTER,5242,4986,10432,50.2492331288344%,47.795245398773%,6579,7265,14192,46.3571025930102%,51.1908117249154%,6941,8660,15757,44.0502633750079%,54.9597004505934%,0.487485334376222,0.524776076278532,0.555092622267803,10228,13844,15601
2384,40,SOUTH CAROLINA,CHESTERFIELD,6111,6266,12526,48.7865240300176%,50.0239501836181%,6858,9312,16581,41.3605934503347%,56.1606658223268%,7431,11297,18876,39.3674507310871%,59.8484848484849%,0.50626161428456,0.575881261595547,0.603214438274242,12377,16170,18728
2385,40,SOUTH CAROLINA,CLARENDON,5999,5186,11290,53.1355181576616%,45.9344552701506%,7732,7386,15395,50.224098733355%,47.9766157843456%,8250,8361,16733,49.303770991454%,49.967130819339%,0.463656683057666,0.488556687392512,0.503341159472639,11185,15118,16611
2386,40,SOUTH CAROLINA,COLLETON,6449,6767,13390,48.1628080657207%,50.537714712472%,7627,9091,17251,44.2119297432033%,52.6983942959828%,8602,10440,19283,44.6092413006275%,54.1409531711871%,0.512030871670702,0.543785141763369,0.548261737212478,13216,16718,19042
2387,40,SOUTH CAROLINA,DARLINGTON,10253,11290,21863,46.8965832685359%,51.6397566665142%,13888,14989,29674,46.801914133585%,50.5122329311856%,15220,16832,32417,46.9506740290588%,51.9233735385754%,0.524068142784199,0.51906361464141,0.525146636715338,21543,28877,32052
2388,40,SOUTH CAROLINA,DILLON,4930,3975,8990,54.8387096774194%,44.2157953281424%,5834,5637,11698,49.8717729526415%,48.1877243973329%,6436,6582,13101,49.126020914434%,50.2404396610946%,0.446378439079169,0.49141312875948,0.50560762021816,8905,11471,13018
2389,40,SOUTH CAROLINA,DORCHESTER,12168,20734,33641,36.170149519931%,61.6331262447609%,24055,34987,62567,38.4467850464302%,55.9192545591126%,33824,41913,77278,43.7692486865602%,54.2366520872693%,0.630174457479789,0.592578164696318,0.553401903957115,32902,59042,75737
2390,40,SOUTH CAROLINA,EDGEFIELD,3950,4760,8834,44.7136065202626%,53.8827258320127%,4491,6842,11644,38.5692201992442%,58.7598763311577%,4953,8184,13304,37.2294046903187%,61.5153337342153%,0.546498277841561,0.603723638930557,0.622973281571135,8710,11333,13137
2391,40,SOUTH CAROLINA,FAIRFIELD,5263,3011,8398,62.6696832579186%,35.8537747082639%,6945,4027,11267,61.6401881601136%,35.7415461081033%,7382,4625,12136,60.8272907053395%,38.109756097561%,0.363911046652163,0.367025154939847,0.385191971350046,8274,10972,12007
2392,40,SOUTH CAROLINA,FLORENCE,17157,23678,41437,41.4050244950165%,57.1421676279653%,26710,29573,57931,46.1065750634375%,51.0486613384889%,31153,32615,64510,48.2917377150829%,50.5580530150364%,0.579845720582833,0.525433967627881,0.511463429933509,40835,56283,63768
2393,40,SOUTH CAROLINA,GEORGETOWN,9445,10535,20351,46.4104957987323%,51.7664979607882%,13310,17389,31657,42.0444135578229%,54.9293995009003%,15822,20487,36668,43.1493400239991%,55.8716046689211%,0.527277277277277,0.566435388774879,0.564240271007188,19980,30699,36309
2394,40,SOUTH CAROLINA,GREENVILLE,43810,92714,140293,31.2275024413192%,66.0859772048499%,74483,127832,215165,34.6166895173472%,59.4111495828783%,103030,150021,258155,39.9101315101393%,58.1127617129244%,0.679104040315256,0.631846378172652,0.592848872361698,136524,202315,253051
2395,40,SOUTH CAROLINA,GREENWOOD,8139,12193,20860,39.0172579098754%,58.4515819750719%,10711,16961,28763,37.2388137537809%,58.9681187636895%,12145,19431,32006,37.9460101231019%,60.7104917827907%,0.599695061971277,0.612930037583116,0.615372434760578,20332,27672,31576
2396,40,SOUTH CAROLINA,HAMPTON,4896,2798,7759,63.1009150663745%,36.0613481118701%,5170,3488,8806,58.7099704746764%,39.6093572564161%,5323,3906,9305,57.2058033315422%,41.9774314884471%,0.363659994801144,0.402864402864403,0.423231119297865,7694,8658,9229
2397,40,SOUTH CAROLINA,HORRY,29113,40300,71265,40.8517505086648%,56.5494983512243%,39410,89288,132920,29.6494131808607%,67.1742401444478%,59180,118821,179744,32.9246038810753%,66.1056836389532%,0.580582887931655,0.693779235108549,0.667529957696867,69413,128698,178001
2398,40,SOUTH CAROLINA,JASPER,3646,2414,6469,56.3611068171278%,37.3164322151801%,5956,5187,11427,52.1221667979347%,45.3924914675768%,7185,7078,14394,49.9166319299708%,49.1732666388773%,0.398349834983498,0.465494032127793,0.496249035967188,6060,11143,14263
2399,40,SOUTH CAROLINA,KERSHAW,7428,11911,19677,37.7496569599024%,60.5326015144585%,10330,17542,28995,35.6268322124504%,60.5000862217624%,12699,20471,33629,37.7620506110797%,60.8730559933391%,0.615905682817105,0.629377152698048,0.617154054868857,19339,27872,33170
2400,40,SOUTH CAROLINA,LANCASTER,8782,11676,20705,42.4148756339049%,56.3921758029461%,13812,23719,38938,35.4717756433304%,60.914787611074%,18937,30312,49868,37.9742520253469%,60.7844710034491%,0.570730276664386,0.631984226372865,0.615484578367073,20458,37531,49249
2401,40,SOUTH CAROLINA,LAURENS,7920,12102,20410,38.8045075943165%,59.2944634982852%,8889,16816,26566,33.4600617330422%,63.2989535496499%,10159,20004,30488,33.3213067436368%,65.6127000787195%,0.604435121366497,0.654191791480257,0.663196631634784,20022,25705,30163
2402,40,SOUTH CAROLINA,LEE,3899,2675,6642,58.7021981330924%,40.2740138512496%,5199,2803,8156,63.7444825895047%,34.3673369298676%,5329,3008,8431,63.2072114814376%,35.6778555331515%,0.406905993306967,0.350287428142964,0.360801247451122,6574,8002,8337
2403,40,SOUTH CAROLINA,LEXINGTON,22830,58095,83081,27.4792070389138%,69.9257351259614%,35230,80026,122093,28.8550531152482%,65.545117246689%,49301,92817,144568,34.1022909634221%,64.2030048143434%,0.717886932344764,0.694332616089401,0.653098129723188,80925,115256,142118
2404,40,SOUTH CAROLINA,MARION,7358,4687,12149,60.5646555272039%,38.5793069388427%,8569,5444,14276,60.0238161950126%,38.1339310731297%,8872,5711,14704,60.3373231773667%,38.8397714907508%,0.389124117891241,0.388496396203525,0.391620379894398,12045,14013,14583
2405,40,SOUTH CAROLINA,MARLBORO,5060,2699,7883,64.1887606241279%,34.2382341748065%,5954,4267,10389,57.3106169987487%,41.0722879969198%,6290,5044,11446,54.9536956141884%,44.0677966101695%,0.347854104910427,0.417473828392525,0.445032645138521,7759,10221,11334
2406,40,SOUTH CAROLINA,MCCORMICK,1896,1704,3661,51.7891286533734%,46.5446599289812%,2479,2652,5216,47.5268404907976%,50.8435582822086%,2687,2958,5697,47.1651746533263%,51.9220642443391%,0.473333333333333,0.51685831221984,0.52400354295837,3600,5131,5645
2407,40,SOUTH CAROLINA,NEWBERRY,4428,7492,12372,35.7904946653734%,60.5560944067249%,6217,10017,16807,36.9905396560957%,59.6001665972512%,6958,11443,18631,37.3463582201707%,61.4191401427728%,0.628523489932886,0.617038314648269,0.621868376718657,11920,16234,18401
2408,40,SOUTH CAROLINA,OCONEE,7571,15364,23575,32.1145281018028%,65.1707317073171%,7998,24178,33635,23.778801843318%,71.8834547346514%,10414,29698,40668,25.6073571358316%,73.0254745746041%,0.669893176367996,0.751429636996519,0.740376944555245,22935,32176,40112
2409,40,SOUTH CAROLINA,ORANGEBURG,19802,12657,32734,60.4936762998717%,38.6662186106189%,26318,11931,38910,67.6381392958109%,30.6630686198921%,27295,13603,41205,66.241960927072%,33.0129838611819%,0.389938075726301,0.311929723652906,0.33260795148907,32459,38249,40898
2410,40,SOUTH CAROLINA,PICKENS,8927,24681,34582,25.8140072870279%,71.3694985830779%,10354,36236,49049,21.1095027421558%,73.8771432648984%,13645,42907,57546,23.7114656101206%,74.5612205887464%,0.734378719352535,0.777763468555484,0.758717640401754,33608,46590,56552
2411,40,SOUTH CAROLINA,RICHLAND,63179,50164,116481,54.2397472549171%,43.066251148256%,108000,52469,168722,64.0106210215621%,31.0979006887069%,132570,58313,193822,68.3978082983356%,30.0858519672689%,0.442585779448224,0.326972810947909,0.305490798028111,113343,160469,190883
2412,40,SOUTH CAROLINA,SALUDA,2682,4098,6891,38.9203308663474%,59.4688724423161%,2813,5526,8564,32.8468005604858%,64.5259224661373%,2963,6210,9274,31.9495363381497%,66.9613974552512%,0.604424778761062,0.662669384818323,0.676986809113703,6780,8339,9173
2413,40,SOUTH CAROLINA,SPARTANBURG,29559,52114,83553,35.3775447919285%,62.3723863894773%,39997,76277,121090,33.0308035345611%,62.9919894293501%,52926,93560,148655,35.6032424069153%,62.9376744811813%,0.638081128402287,0.65601080207097,0.638695848067392,81673,116274,146486
2414,40,SOUTH CAROLINA,SUMTER,14365,15915,30672,46.834246218049%,51.8877151799687%,24047,18745,44086,54.5456607539809%,42.5191670825205%,27379,21000,48920,55.9668847097302%,42.9272281275552%,0.525594451783355,0.438049168068798,0.434072634820893,30280,42792,48379
2415,40,SOUTH CAROLINA,UNION,4662,5768,10589,44.0268202852016%,54.4716214940032%,4729,7061,12092,39.1085014885875%,58.3939794905723%,4935,8183,13257,37.2256166553519%,61.7258806668175%,0.553020134228188,0.598897370653096,0.623799359658485,10430,11790,13118
2416,40,SOUTH CAROLINA,WILLIAMSBURG,6723,4524,11331,59.3328038125496%,39.9258670902833%,9953,4864,15054,66.1153181878571%,32.310349408795%,10289,5532,15985,64.3665936815765%,34.6074444791993%,0.402240597492665,0.328271579941959,0.349661841855761,11247,14817,15821
2417,40,SOUTH CAROLINA,YORK,19251,33776,54351,35.4197714853453%,62.1442107780906%,41593,66754,114357,36.3711884711911%,58.3733396294062%,59008,82727,144050,40.9635543214162%,57.4293648038875%,0.636958530559904,0.616113044200578,0.583673757364095,53027,108347,141735
2419,41,SOUTH DAKOTA,AURORA,513,847,1413,36.3057324840764%,59.9433828733192%,340,974,1407,24.1648898365316%,69.225302061123%,317,1052,1405,22.5622775800712%,74.8754448398577%,0.622794117647059,0.741248097412481,0.768444119795471,1360,1314,1369
2420,41,SOUTH DAKOTA,BEADLE,3216,4347,7739,41.5557565576948%,56.1700478097946%,1912,4455,6772,28.2339043118724%,65.785587714117%,2107,4808,7081,29.7556842253919%,67.9000141222991%,0.574771915906386,0.699701586304382,0.69530007230658,7563,6367,6915
2421,41,SOUTH DAKOTA,BENNETT,377,712,1116,33.7813620071685%,63.7992831541219%,412,666,1149,35.8572671888599%,57.9634464751958%,466,694,1183,39.3913778529163%,58.6644125105664%,0.653810835629017,0.617810760667904,0.598275862068966,1089,1078,1160
2422,41,SOUTH DAKOTA,BON HOMME,1162,1901,3139,37.0181586492514%,60.5606881172348%,704,2105,2974,23.6718224613315%,70.7800941492939%,721,2235,3001,24.0253248917028%,74.4751749416861%,0.620633365981064,0.74937700249199,0.756089309878214,3063,2809,2956
2423,41,SOUTH DAKOTA,BROOKINGS,4546,6212,10984,41.3874726875455%,56.5549890750182%,4879,6748,12680,38.4779179810726%,53.217665615142%,6110,8000,14567,41.9441202718473%,54.9186517470996%,0.57743074920989,0.580373269114991,0.566973777462792,10758,11627,14110
2424,41,SOUTH DAKOTA,BROWN,7173,9060,16556,43.3256825320126%,54.7233631311911%,5452,9613,16114,33.8339332257664%,59.6561995780067%,6538,10580,17547,37.2599304724454%,60.2952071579187%,0.558122343374607,0.638101559907069,0.618062857810492,16233,15065,17118
2425,41,SOUTH DAKOTA,BRULE,818,1268,2167,37.7480387632672%,58.5140747577296%,571,1565,2288,24.9562937062937%,68.4003496503496%,673,1750,2490,27.0281124497992%,70.281124497992%,0.607861936720997,0.732677902621723,0.722245150639703,2086,2136,2423
2426,41,SOUTH DAKOTA,BUFFALO,256,140,408,62.7450980392157%,34.3137254901961%,296,171,490,60.4081632653061%,34.8979591836735%,352,183,549,64.1165755919854%,33.3333333333333%,0.353535353535353,0.366167023554604,0.342056074766355,396,467,535
2427,41,SOUTH DAKOTA,BUTTE,840,2760,3689,22.7703984819734%,74.817023583627%,696,3357,4351,15.9963226844404%,77.1546770857274%,939,3731,4802,19.5543523531862%,77.6967930029155%,0.766666666666667,0.828275351591414,0.798929336188437,3600,4053,4670
2428,41,SOUTH DAKOTA,CAMPBELL,147,739,917,16.030534351145%,80.5888767720829%,105,704,831,12.6353790613718%,84.7172081829121%,117,747,873,13.4020618556701%,85.5670103092784%,0.834085778781038,0.870210135970334,0.864583333333333,886,809,864
2429,41,SOUTH DAKOTA,CHARLES MIX,1300,2205,3579,36.3229952500699%,61.6093880972339%,935,2382,3433,27.2356539469851%,69.3853772210894%,1177,2552,3783,31.1128733809146%,67.4596880782448%,0.629101283880171,0.718118782031957,0.684365781710914,3505,3317,3729
2430,41,SOUTH DAKOTA,CLARK,791,1272,2108,37.5237191650854%,60.3415559772296%,398,1139,1657,24.019312009656%,68.7386843693422%,437,1373,1850,23.6216216216216%,74.2162162162162%,0.616577799321377,0.741054001301236,0.758563535911602,2063,1537,1810
2431,41,SOUTH DAKOTA,CLAY,2638,2363,5105,51.6748285994123%,46.2879529872674%,2608,2109,5069,51.4499901361215%,41.6058394160584%,3083,2456,5698,54.1067041067041%,43.1028431028431%,0.47250549890022,0.447106211575154,0.443401335981224,5001,4717,5539
2432,41,SOUTH DAKOTA,CODINGTON,4192,6718,11138,37.6369186568504%,60.3160351948285%,3174,7764,11669,27.2002742308681%,66.5352643756963%,3837,8958,13161,29.154319580579%,68.0647367221336%,0.615765352887259,0.709818979703785,0.700117233294256,10910,10938,12795
2433,41,SOUTH DAKOTA,CORSON,549,629,1243,44.1673370876911%,50.603378921963%,535,588,1175,45.531914893617%,50.0425531914894%,622,647,1283,48.4801247077163%,50.4286827747467%,0.533955857385399,0.52359750667854,0.509850275807723,1178,1123,1269
2434,41,SOUTH DAKOTA,CUSTER,955,2495,3573,26.7282395745872%,69.8292751189477%,1121,3293,4721,23.7449692861682%,69.7521711501801%,1522,3852,5494,27.7029486712778%,70.1128503822352%,0.723188405797101,0.746035342093339,0.71678451804987,3450,4414,5374
2435,41,SOUTH DAKOTA,DAVISON,2936,4445,7528,39.0010626992561%,59.0462274176408%,2355,5157,7952,29.6151911468813%,64.8516096579477%,2648,5613,8454,31.3224509108114%,66.3946061036196%,0.602221921148896,0.686501597444089,0.679457692773272,7381,7512,8261
2436,41,SOUTH DAKOTA,DAY,1492,1623,3197,46.6687519549578%,50.7663434469816%,974,1627,2747,35.4568620313069%,59.2282489989079%,1052,1869,2964,35.4925775978408%,63.0566801619433%,0.521027287319422,0.625528642829681,0.639849366655255,3115,2601,2921
2437,41,SOUTH DAKOTA,DEUEL,926,1245,2224,41.636690647482%,55.9802158273381%,570,1366,2080,27.4038461538462%,65.6730769230769%,609,1699,2350,25.9148936170213%,72.2978723404255%,0.573468447719945,0.705578512396694,0.736135181975737,2171,1936,2308
2438,41,SOUTH DAKOTA,DEWEY,880,761,1681,52.3497917906008%,45.2706722189173%,888,723,1708,51.9906323185012%,42.3302107728337%,1131,790,1966,57.527975584944%,40.1831129196338%,0.463741620962828,0.4487895716946,0.411244143675169,1641,1611,1921
2439,41,SOUTH DAKOTA,DOUGLAS,363,1311,1709,21.2404915155061%,76.7115272088941%,214,1338,1605,13.3333333333333%,83.3644859813084%,216,1468,1707,12.6537785588752%,85.9988283538371%,0.783154121863799,0.862113402061856,0.871733966745843,1674,1552,1684
2440,41,SOUTH DAKOTA,EDMUNDS,676,1257,1986,34.0382678751259%,63.2930513595166%,380,1433,1918,19.8123044838373%,74.7132429614181%,417,1538,1985,21.007556675063%,77.4811083123426%,0.65028453181583,0.790402647545505,0.786700767263427,1933,1813,1955
2441,41,SOUTH DAKOTA,FALL RIVER,1133,2185,3429,33.0417031204433%,63.7212015164771%,821,2511,3563,23.0423800168397%,70.4743193937693%,1053,2878,4042,26.051459673429%,71.2023750618506%,0.658529234478602,0.75360144057623,0.732129229203765,3318,3332,3931
2442,41,SOUTH DAKOTA,FAULK,388,904,1329,29.1948833709556%,68.0210684725357%,204,858,1118,18.2468694096601%,76.7441860465116%,198,964,1182,16.751269035533%,81.5566835871404%,0.69969040247678,0.807909604519774,0.82960413080895,1292,1062,1162
2443,41,SOUTH DAKOTA,GRANT,1475,2235,3830,38.5117493472585%,58.355091383812%,971,2382,3564,27.2446689113356%,66.8350168350168%,1056,2618,3745,28.1975967957276%,69.9065420560748%,0.602425876010782,0.710408589322994,0.712574850299401,3710,3353,3674
2444,41,SOUTH DAKOTA,GREGORY,718,1487,2257,31.8121400088613%,65.8839167035888%,391,1600,2091,18.6991869918699%,76.518412242946%,455,1771,2258,20.1505757307352%,78.4322409211692%,0.67437641723356,0.803616273229533,0.79559748427673,2205,1991,2226
2445,41,SOUTH DAKOTA,HAAKON,164,938,1129,14.5261293179805%,83.0823737821081%,77,936,1044,7.37547892720307%,89.6551724137931%,105,1026,1137,9.23482849604222%,90.2374670184697%,0.851179673321234,0.923988153998026,0.907161803713528,1102,1013,1131
2446,41,SOUTH DAKOTA,HAMLIN,923,1731,2723,33.8964377524789%,63.5695923613662%,555,2051,2762,20.0941346850109%,74.2577842143375%,647,2372,3083,20.9860525462212%,76.938047356471%,0.652223059532781,0.787029930928626,0.785690626035111,2654,2606,3019
2447,41,SOUTH DAKOTA,HAND,565,1419,2031,27.8188084687346%,69.8670605612999%,334,1391,1818,18.3718371837184%,76.5126512651265%,373,1433,1836,20.3159041394336%,78.0501089324619%,0.715221774193548,0.806376811594203,0.793466223698782,1984,1725,1806
2448,41,SOUTH DAKOTA,HANSON,457,944,1421,32.1604503870514%,66.4320900774103%,424,1497,2006,21.1365902293121%,74.6261216350947%,557,1793,2388,23.3249581239531%,75.0837520938024%,0.673804425410421,0.779281624154086,0.762978723404255,1401,1921,2350
2449,41,SOUTH DAKOTA,HARDING,64,650,731,8.75512995896033%,88.9192886456908%,38,695,770,4.93506493506494%,90.2597402597403%,49,748,813,6.02706027060271%,92.0049200492005%,0.910364145658263,0.948158253751705,0.938519447929737,714,733,797
2450,41,SOUTH DAKOTA,HUGHES,2212,5188,7534,29.3602336076453%,68.861162728962%,2450,5174,8175,29.9694189602446%,63.2905198776758%,2953,5522,8723,33.853032213688%,63.3039092055486%,0.701081081081081,0.678646379853095,0.651563421828909,7400,7624,8475
2451,41,SOUTH DAKOTA,HUTCHINSON,1052,2497,3625,29.0206896551724%,68.8827586206897%,692,2517,3365,20.5646359583952%,74.7994056463596%,762,2944,3767,20.2282983806743%,78.1523758959384%,0.703578472809242,0.7843564973512,0.794387479762547,3549,3209,3706
2452,41,SOUTH DAKOTA,HYDE,218,592,835,26.1077844311377%,70.8982035928144%,125,543,690,18.1159420289855%,78.695652173913%,136,564,710,19.1549295774648%,79.4366197183099%,0.730864197530864,0.812874251497006,0.805714285714286,810,668,700
2453,41,SOUTH DAKOTA,JACKSON,319,687,1040,30.6730769230769%,66.0576923076923%,323,722,1095,29.4977168949772%,65.9360730593607%,359,738,1115,32.1973094170404%,66.1883408071749%,0.682902584493042,0.690909090909091,0.672743846855059,1006,1045,1097
2454,41,SOUTH DAKOTA,JERAULD,468,624,1122,41.7112299465241%,55.6149732620321%,264,648,967,27.300930713547%,67.0113753877973%,270,721,1006,26.8389662027833%,71.6699801192843%,0.571428571428571,0.710526315789474,0.727547931382442,1092,912,991
2455,41,SOUTH DAKOTA,JONES,137,509,664,20.6325301204819%,76.6566265060241%,69,450,558,12.3655913978495%,80.6451612903226%,90,498,599,15.025041736227%,83.1385642737897%,0.787925696594427,0.867052023121387,0.846938775510204,646,519,588
2456,41,SOUTH DAKOTA,KINGSBURY,1049,1612,2727,38.4671800513385%,59.1125779244591%,703,1680,2551,27.5578204625637%,65.8565268522148%,819,1904,2779,29.4710327455919%,68.5138539042821%,0.605787298008268,0.704993705413344,0.699228791773779,2661,2383,2723
2457,41,SOUTH DAKOTA,LAKE,2331,2724,5154,45.2270081490105%,52.8521536670547%,2314,4038,6786,34.0996168582375%,59.5048629531388%,2068,3681,5873,35.2119870594245%,62.6766558828537%,0.538872403560831,0.635705289672544,0.640285267002957,5055,6352,5749
2458,41,SOUTH DAKOTA,LAWRENCE,2797,6327,9406,29.7363385073357%,67.2655751647884%,3356,7411,11842,28.3398074649552%,62.5823340651917%,4537,8753,13828,32.8102400925658%,63.2991032687301%,0.693445857080228,0.688306863564595,0.658615500376223,9124,10767,13290
2459,41,SOUTH DAKOTA,LINCOLN,3844,6546,10556,36.4153088291019%,62.0121258052293%,8076,15499,25231,32.0082438270382%,61.4284015694978%,11981,19617,32396,36.9829608593654%,60.553772070626%,0.630028873917228,0.657433722163309,0.620830432305842,10390,23575,31598
2460,41,SOUTH DAKOTA,LYMAN,482,875,1386,34.7763347763348%,63.1313131313131%,369,977,1421,25.9676284306826%,68.7543983110486%,525,1042,1597,32.874139010645%,65.2473387601753%,0.644804716285925,0.725854383358098,0.664964901084876,1357,1346,1567
2461,41,SOUTH DAKOTA,MARSHALL,939,1097,2079,45.1659451659452%,52.7657527657528%,754,1056,1947,38.7262455059065%,54.2372881355932%,858,1287,2178,39.3939393939394%,59.0909090909091%,0.538801571709234,0.583425414364641,0.6,2036,1810,2145
2462,41,SOUTH DAKOTA,MCCOOK,965,1610,2631,36.6780691752185%,61.1934625617636%,623,1794,2587,24.0819482025512%,69.3467336683417%,769,2068,2900,26.5172413793103%,71.3103448275862%,0.625242718446602,0.742242449317336,0.728939020091646,2575,2417,2837
2463,41,SOUTH DAKOTA,MCPHERSON,295,1073,1417,20.818630910374%,75.7233592095978%,192,892,1137,16.8865435356201%,78.4520668425682%,222,1075,1324,16.7673716012085%,81.1933534743202%,0.784356725146199,0.822878228782288,0.828835774865073,1368,1084,1297
2464,41,SOUTH DAKOTA,MEADE,2267,6870,9366,24.2045697202648%,73.3504163997438%,2223,8441,11621,19.1291627226573%,72.635745632906%,3285,9875,13670,24.0307242136064%,72.2384784198976%,0.751887928204006,0.791541635408852,0.750379939209726,9137,10664,13160
2465,41,SOUTH DAKOTA,MELLETTE,222,495,733,30.2864938608458%,67.5306957708049%,238,402,683,34.8462664714495%,58.8579795021962%,298,449,769,38.7516254876463%,58.3875162548765%,0.690376569037657,0.628125,0.601070950468541,717,640,747
2466,41,SOUTH DAKOTA,MINER,523,724,1266,41.3112164296998%,57.1879936808847%,281,706,1064,26.4097744360902%,66.3533834586466%,320,787,1138,28.1195079086116%,69.1564147627417%,0.580593424218124,0.715298885511651,0.71093044263776,1247,987,1107
2467,41,SOUTH DAKOTA,MINNEHAHA,27042,33428,61369,44.064592872623%,54.4704981342372%,30610,42043,78263,39.1117130700331%,53.7201487292846%,40482,49249,92326,43.8468037172627%,53.3425037367589%,0.552803042831156,0.578682229226598,0.54885156746275,60470,72653,89731
2468,41,SOUTH DAKOTA,MOODY,1318,1361,2735,48.1901279707495%,49.7623400365631%,1043,1731,2933,35.5608591885442%,59.018070235254%,1179,1951,3206,36.7747972551466%,60.8546475358702%,0.50802538260545,0.624008651766402,0.62332268370607,2679,2774,3130
2469,41,SOUTH DAKOTA,PENNINGTON,11123,24696,36557,30.4264573132369%,67.554777470799%,2510,241,2905,86.4027538726334%,8.2960413080895%,2829,297,3200,88.40625%,9.28125%,0.689466484268126,0.0876045074518357,0.0950095969289827,35819,2751,3126
2470,41,SOUTH DAKOTA,PERKINS,297,1237,1614,18.4014869888476%,76.6418835192069%,14074,29804,47743,29.4786670297216%,62.4259053683262%,20606,35063,57518,35.8253068604611%,60.9600472895441%,0.80638852672751,0.679247003053922,0.629847850688893,1534,43878,55669
2471,41,SOUTH DAKOTA,POTTER,356,1112,1494,23.8286479250335%,74.4310575635877%,188,1333,1606,11.706102117061%,83.0012453300125%,239,1401,1669,14.3199520671061%,83.9424805272618%,0.757493188010899,0.876397107166338,0.854268292682927,1468,1521,1640
2472,41,SOUTH DAKOTA,ROBERTS,1700,2237,4074,41.7280314187531%,54.9091801669121%,215,1071,1337,16.0807778608826%,80.1047120418848%,227,1139,1380,16.4492753623188%,82.536231884058%,0.568199136398273,0.832814930015552,0.833821376281113,3937,1286,1366
2473,41,SOUTH DAKOTA,SANBORN,468,767,1268,36.9085173501577%,60.4889589905363%,1540,2144,3889,39.5988686037542%,55.1298534327591%,1828,2404,4307,42.4425354074762%,55.8161133039238%,0.621052631578947,0.581976112920738,0.568052930056711,1235,3684,4232
2474,41,SOUTH DAKOTA,SHANNON,1667,252,1953,85.3558627752176%,12.9032258064516%,241,819,1123,21.4603739982191%,72.9296527159395%,257,905,1185,21.6877637130802%,76.3713080168776%,0.131318394997394,0.772641509433962,0.778829604130809,1919,1060,1162
2475,41,SOUTH DAKOTA,SPINK,1274,1957,3284,38.7941534713764%,59.5919610231425%,919,1854,2951,31.1419857675364%,62.8261606235174%,998,2104,3163,31.5523237432817%,66.5191274106861%,0.605694831321572,0.668589974756581,0.678272082527402,3231,2773,3102
2476,41,SOUTH DAKOTA,STANLEY,402,955,1381,29.1093410572049%,69.1527878349022%,329,1148,1567,20.9955328653478%,73.2610082961072%,421,1203,1652,25.4842615012107%,72.8208232445521%,0.703758290346352,0.777251184834123,0.74076354679803,1357,1477,1624
2477,41,SOUTH DAKOTA,SULLY,209,633,871,23.9954075774971%,72.6750861079219%,137,679,861,15.9117305458769%,78.8617886178862%,185,726,930,19.8924731182796%,78.0645161290323%,0.751781472684085,0.832107843137255,0.796926454445664,842,816,911
2478,41,SOUTH DAKOTA,TODD,993,478,1494,66.4658634538153%,31.9946452476573%,1505,487,2125,70.8235294117647%,22.9176470588235%,1963,532,2539,77.3139031114612%,20.9531311539976%,0.324949014276003,0.244477911646586,0.213226452905812,1471,1992,2495
2479,41,SOUTH DAKOTA,TRIPP,799,1909,2765,28.8969258589512%,69.0415913200723%,462,2069,2630,17.5665399239544%,78.6692015209126%,495,2161,2696,18.3605341246291%,80.1557863501484%,0.704948301329394,0.817463453180561,0.813629518072289,2708,2531,2656
2480,41,SOUTH DAKOTA,TURNER,1414,2514,4004,35.3146853146853%,62.7872127872128%,961,2937,4150,23.1566265060241%,70.7710843373494%,1139,3290,4548,25.0439753737907%,72.339489885664%,0.640020366598778,0.753463314520267,0.742831338902687,3928,3898,4429
2481,41,SOUTH DAKOTA,UNION,2358,3265,5772,40.8523908523909%,56.5661815661816%,2227,5290,7897,28.2005824996834%,66.9874635937698%,2725,5944,8855,30.7735742518351%,67.1259175607002%,0.580650898097101,0.703738193428229,0.685661552658899,5623,7517,8669
2482,41,SOUTH DAKOTA,WALWORTH,721,1758,2553,28.2412847630239%,68.8601645123384%,457,1896,2477,18.4497375857893%,76.5442067016552%,565,1966,2580,21.8992248062016%,76.2015503875969%,0.709156918112142,0.805779855503612,0.776768075859344,2479,2353,2531
2483,41,SOUTH DAKOTA,YANKTON,3596,4904,8740,41.1441647597254%,56.1098398169336%,3301,5659,9623,34.3032318403824%,58.8070248363296%,4016,6581,10900,36.8440366972477%,60.3761467889908%,0.576941176470588,0.631584821428571,0.621024818344815,8500,8960,10597
2484,41,SOUTH DAKOTA,ZIEBACH,314,384,721,43.5506241331484%,53.2593619972261%,353,368,767,46.0234680573664%,47.9791395045632%,481,404,906,53.0905077262693%,44.5916114790287%,0.550143266475645,0.510402219140083,0.456497175141243,698,721,885
2486,42,TENNESSEE,ANDERSON,13556,14688,28779,47.1037909586852%,51.0372146356719%,9013,19212,29881,30.1629798199525%,64.2950369800208%,11741,23184,35570,33.008152937869%,65.178521225752%,0.520039654439881,0.680673162090345,0.663822476735863,28244,28225,34925
2487,42,TENNESSEE,BEDFORD,6136,5911,12207,50.2662406815761%,48.4230359629721%,3395,11486,15355,22.110061869098%,74.8029957668512%,4453,14354,19088,23.3287929589271%,75.199077954736%,0.490661575495974,0.771856730058464,0.763226458233636,12047,14881,18807
2488,42,TENNESSEE,BENTON,3700,2484,6311,58.62779274283%,39.3598478846458%,1474,4716,6328,23.2932996207332%,74.5259165613148%,1529,5668,7260,21.0606060606061%,78.0716253443526%,0.401681759379043,0.761873990306947,0.787550368208976,6184,6190,7197
2489,42,TENNESSEE,BLEDSOE,1756,2380,4196,41.8493803622498%,56.7206863679695%,897,3622,4664,19.2324185248714%,77.6586620926244%,971,4725,5758,16.8634942688433%,82.0597429663077%,0.575435203094778,0.801504757689754,0.829529494382022,4136,4519,5696
2490,42,TENNESSEE,BLOUNT,14688,25273,40662,36.1221779548473%,62.1538537209188%,12100,37443,52208,23.1765246705486%,71.7188936561447%,17932,47369,66609,26.9212869131799%,71.1150144875317%,0.632441630589825,0.755767716932765,0.725394710647616,39961,49543,65301
2491,42,TENNESSEE,BRADLEY,8768,20167,29443,29.779574092314%,68.4950582481405%,7070,29768,38666,18.2847980137589%,76.9875342678322%,9851,35204,45865,21.4782513899488%,76.7556960645372%,0.696975980646276,0.808078614474184,0.781356120297414,28935,36838,45055
2492,42,TENNESSEE,CAMPBELL,6492,5784,12421,52.2663231623863%,46.5662990097416%,2248,9870,12532,17.9380785189914%,78.7583785509097%,2441,12331,14933,16.3463470166745%,82.5755039174982%,0.471163245356794,0.814490840072619,0.834754941781749,12276,12118,14772
2493,42,TENNESSEE,CANNON,2697,1924,4697,57.4196295507771%,40.9623163721524%,1127,4007,5314,21.2081294693263%,75.4045916447121%,1261,5190,6557,19.2313558029587%,79.1520512429465%,0.416360095217485,0.780483054148812,0.804526430010851,4621,5134,6451
2494,42,TENNESSEE,CARROLL,5239,5465,10827,48.3882885379145%,50.4756626951141%,2327,7756,10384,22.4094761171032%,74.6918335901387%,2559,9205,11905,21.4951700965981%,77.3204535909282%,0.510556801195815,0.769215511256571,0.782471948316899,10704,10083,11764
2495,42,TENNESSEE,CARTER,6724,12111,19102,35.2005025651764%,63.4017380379018%,3453,16898,21084,16.3773477518497%,80.1460823373174%,4529,19584,24492,18.4917524089499%,79.9608035276825%,0.643005043801433,0.83032774802221,0.812176004644797,18835,20351,24113
2496,42,TENNESSEE,CHEATHAM,6062,6356,12616,48.0500951173114%,50.3804692454027%,3878,11297,15924,24.3531775935695%,70.9432303441347%,5514,14438,20260,27.2161895360316%,71.2635735439289%,0.511837655016911,0.744448105436573,0.723636728147554,12418,15175,19952
2497,42,TENNESSEE,CHESTER,2192,3487,5728,38.268156424581%,60.8763966480447%,1243,5081,6507,19.1025049946212%,78.0851390809897%,1412,5952,7584,18.6181434599156%,78.4810126582278%,0.614016552209896,0.803447185325743,0.808256382400869,5679,6324,7364
2498,42,TENNESSEE,CLAIBORNE,3841,5023,9000,42.6777777777778%,55.8111111111111%,1832,8602,10740,17.0577281191806%,80.0931098696462%,2202,10604,12945,17.0104287369641%,81.915797605253%,0.566674187725632,0.824420164845697,0.828049351866313,8864,10434,12806
2499,42,TENNESSEE,CLAY,1931,1468,3442,56.1011040092969%,42.6496223126089%,707,2141,2920,24.2123287671233%,73.3219178082192%,735,2733,3506,20.9640616086708%,77.9520821448945%,0.431891732862607,0.751755617977528,0.788062283737024,3399,2848,3468
2500,42,TENNESSEE,COCKE,3872,6185,10239,37.8161929875964%,60.4062896767262%,1981,9791,12126,16.3367969651987%,80.7438561768102%,2533,12162,14859,17.0469075980887%,81.8493842115889%,0.614994531172318,0.831719334012912,0.827628445049336,10057,11772,14695
2501,42,TENNESSEE,COFFEE,8741,8788,17788,49.1398695749944%,49.4040926467281%,4743,14417,19971,23.7494366831906%,72.1896750287917%,5705,17883,24282,23.4947697883206%,73.6471460340993%,0.501340635518284,0.752453027139875,0.758139732067153,17529,19160,23588
2502,42,TENNESSEE,CROCKETT,2705,2676,5440,49.7242647058824%,49.1911764705882%,1303,3982,5397,24.1430424309802%,73.7817305910691%,1382,4673,6114,22.6038599934576%,76.4311416421328%,0.497305333581119,0.753453169347209,0.771758876961189,5381,5285,6055
2503,42,TENNESSEE,CUMBERLAND,7644,10994,19017,40.1956144502288%,57.8114318767419%,5202,20413,26360,19.7344461305008%,77.4393019726859%,6728,25168,32279,20.8432727160073%,77.9701973419251%,0.589870157742247,0.796915869607652,0.789064459493353,18638,25615,31896
2504,42,TENNESSEE,DAVIDSON,120508,84117,208588,57.7732180182944%,40.3268644409074%,148864,84550,249068,59.7684166572984%,33.946552748647%,199703,100218,309658,64.4914712360088%,32.3640919982691%,0.411078802687844,0.362231914109693,0.33414799230464,204625,233414,299921
2505,42,TENNESSEE,DECATUR,2278,2046,4370,52.1281464530892%,46.8192219679634%,894,3588,4592,19.4686411149826%,78.1358885017422%,904,4229,5241,17.2486166762068%,80.6907078801755%,0.473172987974098,0.80053547523427,0.823884667835574,4324,4482,5133
2506,42,TENNESSEE,DEKALB,3765,2411,6265,60.0957701516361%,38.4836392657622%,1569,5171,6955,22.5593098490295%,74.3493889288282%,1750,6672,8513,20.5567954892517%,78.3742511453072%,0.390382124352332,0.767210682492582,0.792210876276419,6176,6740,8422
2507,42,TENNESSEE,DICKSON,8332,7016,15556,53.5613268192337%,45.1015685266135%,4722,13233,18699,25.2526873094818%,70.7684902935986%,6106,17643,24323,25.1038112074991%,72.5362825309378%,0.457127964555642,0.737009189640769,0.742894437660533,15348,17955,23749
2508,42,TENNESSEE,DYER,5425,6282,11841,45.8153872139177%,53.0529516088168%,2816,10180,13336,21.1157768446311%,76.3347330533893%,3158,11768,15079,20.9430333576497%,78.0423104980436%,0.536602032971726,0.783317943982764,0.788422886238778,11707,12996,14926
2509,42,TENNESSEE,FAYETTE,5037,6402,11529,43.6898256570388%,55.5295342180588%,5874,13055,19394,30.2877178508817%,67.3146333917707%,7027,15690,22984,30.5734423947094%,68.2648799164636%,0.559664306320483,0.689682497754768,0.69067218382709,11439,18929,22717
2510,42,TENNESSEE,FENTRESS,2529,3417,6029,41.9472549344833%,56.6760656825344%,1100,6038,7333,15.000681849175%,82.3401063684713%,1214,7441,8729,13.9076641081453%,85.2445870088212%,0.574672048435923,0.845895208741945,0.859734257654535,5946,7138,8655
2511,42,TENNESSEE,FRANKLIN,7828,6560,14691,53.2843237356204%,44.6531890272956%,4374,11532,16404,26.6642282370154%,70.2999268471105%,4864,13987,19132,25.4233744511813%,73.1078820823751%,0.455935501807061,0.725009430403621,0.741976552968012,14388,15906,18851
2512,42,TENNESSEE,GIBSON,8663,8286,17137,50.5514384081228%,48.3515201027018%,5258,13786,19547,26.8992684299381%,70.5274466670077%,5771,16259,22335,25.8383702708753%,72.7960599955227%,0.488878399905599,0.723902541482882,0.738039037675897,16949,19044,22030
2513,42,TENNESSEE,GILES,5527,4377,10066,54.9076097754818%,43.483012120008%,2917,7970,11137,26.1919727036006%,71.5632576097692%,3298,9784,13203,24.9791714004393%,74.1043702188896%,0.441942649434572,0.732065766510517,0.747897874942669,9904,10887,13082
2514,42,TENNESSEE,GRAINGER,2361,3746,6194,38.117533096545%,60.4778818211172%,1154,6626,8008,14.4105894105894%,82.7422577422577%,1467,8565,10134,14.4760213143872%,84.5174659561871%,0.613394465367611,0.851670951156812,0.853767942583732,6107,7780,10032
2515,42,TENNESSEE,GREENE,7909,12540,20816,37.9948116833205%,60.2421214450423%,4216,18562,23583,17.8772844845864%,78.7092397065683%,5199,22259,28087,18.5103428632463%,79.2501869192153%,0.613232920925229,0.814909122837826,0.81065627503824,20449,22778,27458
2516,42,TENNESSEE,GRUNDY,2970,1553,4596,64.621409921671%,33.7902523933856%,999,3636,4763,20.9741759395339%,76.3384421583036%,988,4802,5855,16.8744662681469%,82.0153714773698%,0.343356179526863,0.784466019417476,0.829360967184801,4523,4635,5790
2517,42,TENNESSEE,HAMBLEN,7564,11824,19699,38.397888217676%,60.0233514391593%,4075,15857,20692,19.6936013918423%,76.6334815387589%,5500,18811,24631,22.3295846697251%,76.3712394949454%,0.609861770167114,0.795554886614489,0.773764962362716,19388,19932,24311
2518,42,TENNESSEE,HAMILTON,51708,66605,120379,42.9543358891501%,55.3294179217305%,55316,78733,142408,38.8433234087973%,55.2869220830291%,75522,92108,171113,44.1357465534471%,53.8287564358056%,0.562955888194873,0.587344926109109,0.549472051542087,118313,134049,167630
2519,42,TENNESSEE,HANCOCK,690,1343,2075,33.2530120481928%,64.7228915662651%,322,1843,2231,14.4329896907216%,82.6086956521739%,362,2372,2744,13.1924198250729%,86.4431486880467%,0.660600098376783,0.851270207852194,0.867593269934162,2033,2165,2734
2520,42,TENNESSEE,HARDEMAN,4953,3729,8803,56.2649096898785%,42.3605589003749%,4185,4919,9273,45.1310255580718%,53.0464790251267%,4180,5760,10063,41.5383086554705%,57.2393918314618%,0.429509329647547,0.540311950790861,0.579476861167002,8682,9104,9940
2521,42,TENNESSEE,HARDIN,3735,4951,8782,42.5301753586882%,56.3766795718515%,1622,8012,9949,16.3031460448286%,80.5307066036788%,1775,9559,11538,15.383948691281%,82.8479805858901%,0.569997697444163,0.83163794893087,0.843391565202047,8686,9634,11334
2522,42,TENNESSEE,HAWKINS,6753,10071,17098,39.4958474675401%,58.9016259211604%,3507,16648,20774,16.8816790218542%,80.1386348320015%,4083,20405,24824,16.4477924589107%,82.1986786980342%,0.598609129814551,0.825998511535599,0.833265272786671,16824,20155,24488
2523,42,TENNESSEE,HAYWOOD,3887,2554,6478,60.0030873726459%,39.4257486878666%,3711,3013,6834,54.3020193151888%,44.0883816213052%,4012,3343,7439,53.9319801048528%,44.9388358650356%,0.3965222791492,0.448096371207615,0.454520734194426,6441,6724,7355
2524,42,TENNESSEE,HENDERSON,3166,5153,8399,37.6949636861531%,61.3525419692821%,1800,8138,10217,17.617695996868%,79.6515611236175%,2092,9797,12020,17.4043261231281%,81.5058236272879%,0.619425411708138,0.818877037633327,0.824039027672639,8319,9938,11889
2525,42,TENNESSEE,HENRY,6093,5944,12309,49.5003655861565%,48.2898692013974%,3063,9508,12945,23.6616454229432%,73.4492081884898%,3548,11239,15047,23.5794510533661%,74.6926297600851%,0.493810750186924,0.756343966271577,0.760059511733279,12037,12571,14787
2526,42,TENNESSEE,HICKMAN,4239,2914,7264,58.3562775330396%,40.1156387665198%,1824,5695,7813,23.345705874824%,72.8913349545629%,2130,7577,9832,21.6639544344996%,77.0646867371847%,0.407381518244093,0.757414549807155,0.780570722159266,7153,7519,9707
2527,42,TENNESSEE,HOUSTON,2081,993,3127,66.5494083786377%,31.755676367125%,866,2182,3168,27.3358585858586%,68.8762626262626%,871,2718,3686,23.6299511665762%,73.7384698860553%,0.323031880286272,0.715879265091863,0.757314015045974,3074,3048,3589
2528,42,TENNESSEE,HUMPHREYS,4205,2387,6681,62.9396796886694%,35.7281844035324%,1967,4930,7153,27.4989514888858%,68.9221305745841%,2017,6120,8236,24.4900437105391%,74.3079164643031%,0.362105582524272,0.714803537770045,0.752119945926017,6592,6897,8137
2529,42,TENNESSEE,JACKSON,3304,1384,4754,69.4993689524611%,29.1123264619268%,1129,3236,4466,25.2798925212718%,72.4585759068518%,1135,4118,5323,21.3225624647755%,77.362389629908%,0.295221843003413,0.74135166093929,0.783932990671997,4688,4365,5253
2530,42,TENNESSEE,JEFFERSON,5226,8657,14087,37.0980336480443%,61.4538226733868%,3494,14776,19072,18.3200503355705%,77.4748322147651%,4654,18651,23616,19.7069783197832%,78.9761178861789%,0.623568392998631,0.808757525998905,0.800300364728599,13883,18270,23305
2531,42,TENNESSEE,JOHNSON,1813,3740,5657,32.0487891108361%,66.1127806257734%,988,5410,6579,15.0174798601611%,82.2313421492628%,1246,6468,7801,15.9723112421484%,82.9124471221638%,0.673509814514677,0.845576742732104,0.838475499092559,5553,6398,7714
2532,42,TENNESSEE,KNOX,60969,86851,150586,40.4878275536902%,57.6753483059514%,62878,105767,180697,34.7974786521082%,58.5327924647338%,91422,124540,220556,41.4506973285696%,56.466384954388%,0.587545663644974,0.627157638827122,0.576675526249988,147820,168645,215962
2533,42,TENNESSEE,LAKE,1419,781,2224,63.8039568345324%,35.1169064748201%,577,1357,1970,29.2893401015228%,68.8832487309645%,526,1492,2034,25.8603736479843%,73.3529990167158%,0.355,0.701654601861427,0.739345887016848,2200,1934,2018
2534,42,TENNESSEE,LAUDERDALE,4224,3329,7618,55.4476240483066%,43.6991336308742%,3056,4884,8087,37.7890441449239%,60.3932236923457%,3193,5674,8965,35.6162855549359%,63.2905744562186%,0.440752019065272,0.615113350125945,0.639900755610691,7553,7940,8867
2535,42,TENNESSEE,LAWRENCE,6643,7613,14470,45.9087767795439%,52.6123013130615%,2821,12420,15666,18.0071492403932%,79.2799693603983%,3195,15334,18718,17.0691313174484%,81.9211454215194%,0.53402076318743,0.814907158322945,0.827567596740245,14256,15241,18529
2536,42,TENNESSEE,LEWIS,2281,2037,4420,51.606334841629%,46.0859728506787%,890,3585,4622,19.2557334487235%,77.5638251839031%,1072,4474,5609,19.1121412016402%,79.7646639329649%,0.471746178786475,0.801117318435754,0.806707536963577,4318,4475,5546
2537,42,TENNESSEE,LINCOLN,5060,5435,10659,47.4716202270382%,50.9897738999906%,2554,10398,13348,19.1339526520827%,77.899310758166%,2919,12281,15608,18.7019477191184%,78.6840082009226%,0.517865650309671,0.802810376775788,0.807960526315789,10495,12952,15200
2538,42,TENNESSEE,LOUDON,5905,10266,16406,35.9929294160673%,62.5746678044618%,4919,17610,23391,21.0294557735881%,75.2853661664743%,6948,21713,29347,23.6753330834498%,73.9871196374417%,0.634840145940263,0.781659194815571,0.757579986741565,16171,22529,28661
2539,42,TENNESSEE,MACON,3059,3366,6491,47.1267909413033%,51.8564165767987%,1072,6263,7504,14.2857142857143%,83.4621535181237%,1307,8096,9487,13.7767471276484%,85.3378307157163%,0.523891050583658,0.85385139740968,0.861001807933638,6425,7335,9403
2540,42,TENNESSEE,MADISON,15781,17862,33930,46.5104627173593%,52.6436781609195%,15448,21335,38120,40.5246589716684%,55.9679958027282%,18390,23943,42950,42.8172293364377%,55.7462165308498%,0.530927681835746,0.58002338036593,0.565587130607328,33643,36783,42333
2541,42,TENNESSEE,MARION,5441,4651,10250,53.0829268292683%,45.3756097560976%,2832,7696,10862,26.0725464923587%,70.8525133492911%,3177,9911,13256,23.9665057332529%,74.7661436330718%,0.46086008719778,0.731003039513678,0.757258557457213,10092,10528,13088
2542,42,TENNESSEE,MARSHALL,5107,4105,9359,54.5677957046693%,43.8615236670584%,2852,8184,11455,24.8974247053688%,71.4447839371453%,3605,11043,14878,24.2304073128109%,74.2236859792983%,0.445614415979158,0.741573033707865,0.753891316220644,9212,11036,14648
2543,42,TENNESSEE,MAURY,11127,11930,23400,47.5512820512821%,50.982905982906%,10038,23799,35369,28.3807854335718%,67.2877378495293%,14418,31464,46657,30.9021154381979%,67.4368261997128%,0.517413366873401,0.70334249490203,0.685759121224009,23057,33837,45882
2544,42,TENNESSEE,MCMINN,6142,10155,16600,37%,61.1746987951807%,3510,14691,18755,18.7150093308451%,78.3311117035457%,4361,18198,22844,19.0903519523726%,79.6620556820172%,0.623120819782782,0.807153453106972,0.806684693470455,16297,18201,22559
2545,42,TENNESSEE,MCNAIRY,4003,4897,8989,44.5322060295917%,54.4776949605073%,1848,7841,10038,18.4100418410042%,78.1131699541741%,1943,9093,11275,17.2328159645233%,80.6474501108648%,0.550224719101124,0.809268242336671,0.823939833272925,8900,9689,11036
2546,42,TENNESSEE,MEIGS,1555,1797,3390,45.8702064896755%,53.0088495575221%,856,3342,4320,19.8148148148148%,77.3611111111111%,1008,4467,5532,18.2212581344902%,80.7483731019523%,0.53609785202864,0.796093377798952,0.815890410958904,3352,4198,5475
2547,42,TENNESSEE,MONROE,5327,7514,13003,40.9674690456049%,57.7866646158579%,3186,13374,17093,18.6392090329375%,78.2425554320482%,3764,16783,20797,18.098764244843%,80.6991392989374%,0.58515691924305,0.807608695652174,0.816810239937704,12841,16560,20547
2548,42,TENNESSEE,MONTGOMERY,18818,19644,39044,48.1969060547075%,50.3124679848376%,21699,32341,57620,37.6587990281152%,56.1280805275946%,32472,42187,76758,42.3043852106621%,54.9610464055864%,0.510737871145546,0.598464100666173,0.565062484094349,38462,54040,74659
2549,42,TENNESSEE,MOORE,1107,1145,2301,48.109517601043%,49.7609734897871%,496,2325,2926,16.9514695830485%,79.46001367054%,573,2888,3539,16.1910144108505%,81.6049731562588%,0.508436944937833,0.824175824175824,0.834440913030916,2252,2821,3461
2550,42,TENNESSEE,MORGAN,2921,3144,6162,47.4034404414151%,51.0223953261928%,1054,5441,6705,15.7196122296793%,81.1483967188665%,1167,6930,8228,14.1832766164317%,84.2245989304813%,0.51838417147568,0.837721324095458,0.85587254538718,6065,6495,8097
2551,42,TENNESSEE,OBION,6056,6168,12440,48.6816720257235%,49.5819935691318%,2426,9526,12249,19.8056984243612%,77.7696138460283%,2589,10790,13521,19.1479920124251%,79.8017898084461%,0.504581151832461,0.797021419009371,0.806487779355707,12224,11952,13379
2552,42,TENNESSEE,OVERTON,4507,2875,7496,60.1254002134472%,38.3537886872999%,1945,6059,8229,23.6359217401871%,73.6298456677604%,2033,7918,10037,20.2550562917206%,78.8881139782804%,0.389460850717963,0.756996501749125,0.795698924731183,7382,8004,9951
2553,42,TENNESSEE,PERRY,1650,1165,2866,57.5715282623866%,40.648988136776%,597,2167,2855,20.9106830122592%,75.9019264448336%,615,2775,3428,17.9404900816803%,80.950991831972%,0.413854351687389,0.784008683068017,0.81858407079646,2815,2764,3390
2554,42,TENNESSEE,PICKETT,939,1281,2239,41.9383653416704%,57.2130415364002%,536,2021,2615,20.4971319311663%,77.2848948374761%,525,2381,2931,17.9119754350051%,81.2350733538042%,0.577027027027027,0.790379350801721,0.819339298004129,2220,2557,2906
2555,42,TENNESSEE,POLK,2574,2907,5594,46.0135859849839%,51.9663925634609%,1252,5097,6520,19.2024539877301%,78.1748466257669%,1492,6792,8360,17.8468899521531%,81.244019138756%,0.530377668308703,0.802803591116711,0.81989377112506,5481,6349,8284
2556,42,TENNESSEE,PUTNAM,10785,11248,22438,48.0657812639273%,50.1292450307514%,6851,19002,27212,25.1763927678965%,69.8294869910334%,9185,23759,33593,27.3420057750126%,70.7260441163338%,0.510506966822494,0.735001740610374,0.721193540553667,22033,25853,32944
2557,42,TENNESSEE,RHEA,3722,5900,9772,38.0884158821122%,60.3765861645518%,1942,8660,11062,17.5555957331405%,78.2860242270837%,2369,11050,13637,17.3718559800543%,81.0295519542421%,0.61317813344419,0.816827013770987,0.823459274163499,9622,10602,13419
2558,42,TENNESSEE,ROANE,9575,11345,21326,44.8982462721561%,53.1979743036669%,4837,15880,21669,22.3222114541511%,73.284415524482%,6043,19230,25917,23.3167419068565%,74.1984025928927%,0.542304015296367,0.766520249070811,0.760891069520832,20920,20717,25273
2559,42,TENNESSEE,ROBERTSON,10249,9675,20164,50.8282086887522%,47.981551279508%,6637,19410,27113,24.4790321985763%,71.589274517759%,8692,24536,33717,25.7792804816561%,72.7704125515319%,0.485595261995583,0.745191384804392,0.73841338630071,19924,26047,33228
2560,42,TENNESSEE,RUTHERFORD,27360,33445,62182,43.9998713454054%,53.7856614454344%,36706,64515,107436,34.1654566439555%,60.0497040098291%,59341,81480,143878,41.2439705861911%,56.6313126398755%,0.550037003535893,0.637367739895871,0.578606883916461,60805,101221,140821
2561,42,TENNESSEE,SCOTT,2967,3579,6615,44.8526077097506%,54.1043083900227%,934,6044,7123,13.1124526182788%,84.8518882493332%,986,8004,9052,10.8926204153778%,88.4224480777729%,0.546746104491292,0.866150759529951,0.890322580645161,6546,6978,8990
2562,42,TENNESSEE,SEQUATCHIE,1648,2169,3887,42.397736043221%,55.8013892462053%,1053,4441,5694,18.4931506849315%,77.9943800491746%,1298,5855,7252,17.8985107556536%,80.7363485934915%,0.568247314645009,0.808336366945759,0.818537676499371,3817,5494,7153
2563,42,TENNESSEE,SEVIER,8208,16734,25365,32.3595505617978%,65.9727971614429%,6297,28629,36312,17.3413747521481%,78.8417052214144%,8721,33783,43535,20.0321580337659%,77.5996324796141%,0.670916526341111,0.819704518124034,0.794819311123659,24942,34926,42504
2564,42,TENNESSEE,SHELBY,190404,141756,336755,56.5408085997238%,42.0946979257918%,208992,116344,337383,61.9450298325642%,34.4842508365863%,246105,129815,382055,64.4161180981796%,33.9780921595058%,0.426770231213873,0.357611822853911,0.345326133219834,332160,325336,375920
2565,42,TENNESSEE,SMITH,4884,2384,7348,66.4670658682635%,32.4442025040827%,1689,5494,7436,22.7138246369016%,73.8838084991931%,1802,7136,9051,19.9094022759916%,78.842116893161%,0.328013208585581,0.764861478490881,0.798388901320206,7268,7183,8938
2566,42,TENNESSEE,STEWART,2870,1826,4782,60.0167294019239%,38.1848598912589%,1222,3864,5299,23.0609548971504%,72.9194187582563%,1232,4950,6296,19.5679796696315%,78.6213468869123%,0.388841567291312,0.759732599292175,0.800711743772242,4696,5086,6182
2567,42,TENNESSEE,SULLIVAN,21354,33482,55727,38.3189477273135%,60.0821863728534%,12578,46979,62278,20.1965381033431%,75.4343427855744%,17272,55860,74357,23.2284788251274%,75.1240636389311%,0.610584287694215,0.788807361015498,0.763824317672154,54836,59557,73132
2568,42,TENNESSEE,SUMNER,22118,27601,50477,43.8179765041504%,54.6803494660935%,18161,50129,71505,25.3982239004265%,70.1055870218866%,27680,63454,92630,29.882327539674%,68.5026449314477%,0.55513988616022,0.734060623810221,0.696271424495797,49719,68290,91134
2569,42,TENNESSEE,TIPTON,6300,10070,16552,38.0618656355727%,60.8385693571774%,5785,16910,23481,24.6369405050892%,72.0156722456454%,6837,20070,27308,25.036619305698%,73.4949465358137%,0.615149664019548,0.745098039215686,0.745902553238934,16370,22695,26907
2570,42,TENNESSEE,TROUSDALE,1966,950,2945,66.7572156196944%,32.258064516129%,946,2103,3160,29.9367088607595%,66.5506329113924%,1012,2936,3998,25.3126563281641%,73.4367183591796%,0.325788751714678,0.689734339127583,0.743667679837893,2916,3049,3948
2571,42,TENNESSEE,UNICOI,2566,3780,6429,39.9128946959092%,58.7960802613159%,1262,5671,7195,17.539958304378%,78.8186240444753%,1615,6599,8307,19.4414349343927%,79.4390273263513%,0.595650803655846,0.817972017885475,0.803384465546628,6346,6933,8214
2572,42,TENNESSEE,UNION,2564,3199,5821,44.0474145335853%,54.9561930939701%,1012,5053,6247,16.1997758924284%,80.8868256763246%,1249,6803,8123,15.3760925766342%,83.749846115967%,0.555092833593614,0.833140972794724,0.844883258817685,5763,6065,8052
2573,42,TENNESSEE,VAN BUREN,1255,845,2131,58.8925387142187%,39.6527451900516%,539,1820,2419,22.2819346837536%,75.2377015295577%,544,2342,2921,18.6237589866484%,80.1780212256077%,0.402380952380952,0.771513353115727,0.811503811503811,2100,2359,2886
2574,42,TENNESSEE,WARREN,7378,5552,13131,56.1876475515955%,42.2816236387175%,3535,9540,13612,25.9697325888922%,70.0852189244784%,3924,11850,16009,24.5112124430008%,74.0208632644138%,0.42938901778809,0.729636711281071,0.751236211487258,12930,13075,15774
2575,42,TENNESSEE,WASHINGTON,14769,22579,37942,38.9252016235307%,59.5092509619946%,13024,34252,49750,26.1788944723618%,68.8482412060302%,18638,40444,60203,30.9585901034832%,67.1793764430344%,0.604557138267109,0.724511379981386,0.684540130665854,37348,47276,59082
2576,42,TENNESSEE,WAYNE,1859,3370,5306,35.0358085186581%,63.5130041462495%,717,5036,5857,12.241761994195%,85.9825849410961%,820,5795,6669,12.2956965062228%,86.8945868945869%,0.644482692675464,0.875369372501304,0.876039304610733,5229,5753,6615
2577,42,TENNESSEE,WEAKLEY,5570,6106,11844,47.0280310705843%,51.5535292131037%,2772,9008,12184,22.7511490479317%,73.9330269205516%,3020,10396,13735,21.9876228613032%,75.6898434655988%,0.522953066118534,0.764685908319185,0.77489564698867,11676,11780,13416
2578,42,TENNESSEE,WHITE,4135,3525,7775,53.1832797427653%,45.3376205787781%,1845,7671,9825,18.7786259541985%,78.0763358778626%,2143,9606,11895,18.0159730979403%,80.7566204287516%,0.460182767624021,0.806116015132409,0.81760149799983,7660,9516,11749
2579,42,TENNESSEE,WILLIAMSON,18745,38901,58429,32.0816717725787%,66.5782402574064%,31013,68212,106271,29.1829379604972%,64.1868430710166%,50161,86469,139016,36.0828969327272%,62.2007538700581%,0.674825660063144,0.687447719828672,0.632869794335065,57646,99225,136630
2580,42,TENNESSEE,WILSON,16561,18844,35916,46.110368637933%,52.4668671344248%,14385,39406,56734,25.3551662142631%,69.4574681848627%,22254,50296,74330,29.9394591685726%,67.6658146105206%,0.532241208868804,0.732576081500623,0.693259820813232,35405,53791,72550
2582,43,TEXAS,ANDERSON,5041,9835,15080,33.4283819628647%,65.2188328912467%,3369,13201,16977,19.8444954939035%,77.7581433704424%,3955,15110,19227,20.5700317262183%,78.5874031310137%,0.661132024737833,0.796680748340374,0.792551796485707,14876,16570,19065
2583,43,TEXAS,ANDREWS,876,3091,4024,21.7693836978131%,76.8141153081511%,836,3927,4943,16.9128059882662%,79.4456807606717%,850,4943,5863,14.4976974245267%,84.308374552277%,0.77917822031762,0.824480369515011,0.853271189366477,3967,4763,5793
2584,43,TEXAS,ANGELINA,9957,16648,26974,36.9133239415734%,61.7186920738489%,7538,21668,29911,25.2014309117047%,72.4415766774765%,9143,25076,34574,26.444727251692%,72.5284896164748%,0.62574704003007,0.741902348832432,0.732809258014553,26605,29206,34219
2585,43,TEXAS,ARANSAS,2637,5390,8247,31.9752637322663%,65.357099551352%,2465,7740,10512,23.4493911719939%,73.6301369863014%,2916,9239,12290,23.726606997559%,75.1749389747762%,0.671483742369503,0.758451739343459,0.760098724804607,8027,10205,12155
2586,43,TEXAS,ARCHER,993,2951,3997,24.8436327245434%,73.8303727795847%,394,3786,4283,9.19915946766285%,88.3959841232781%,446,4300,4796,9.29941618015013%,89.6580483736447%,0.748225152129817,0.905741626794258,0.906026127265065,3944,4180,4746
2587,43,TEXAS,ARMSTRONG,150,772,938,15.9914712153518%,82.3027718550107%,70,924,1021,6.85602350636631%,90.4995102840353%,75,1035,1112,6.74460431654676%,93.0755395683453%,0.837310195227766,0.929577464788732,0.932432432432432,922,994,1110
2588,43,TEXAS,ATASCOSA,4322,6231,10746,40.2196166015261%,57.9843662758236%,4651,8618,13673,34.0159438309076%,63.0293278724494%,5876,12039,18118,32.4318357434595%,66.4477315376973%,0.590448213778073,0.64948375913784,0.672006698297516,10553,13269,17915
2589,43,TEXAS,AUSTIN,2407,6661,9227,26.0864853148369%,72.1903110436762%,2320,9637,12274,18.9017435228939%,78.5155613491934%,2951,11447,14554,20.276212725024%,78.6519169987632%,0.734561093956771,0.805971397507736,0.795040977913599,9068,11957,14398
2590,43,TEXAS,BAILEY,488,1589,2090,23.3492822966507%,76.0287081339713%,397,1344,1793,22.1416620189626%,74.9581706636921%,409,1434,1860,21.989247311828%,77.0967741935484%,0.765045739046702,0.771970132107984,0.77807921866522,2077,1741,1843
2591,43,TEXAS,BANDERA,1426,5613,7273,19.606764746322%,77.1758559054036%,1726,8163,10218,16.8917596398512%,79.8884321785085%,2505,10057,12715,19.7011403853716%,79.0955564294141%,0.79741440545532,0.825462635251289,0.800589078172266,7039,9889,12562
2592,43,TEXAS,BASTROP,6973,10310,18308,38.0871750054621%,56.3141795936203%,10569,16328,28454,37.1441625079075%,57.3838476136923%,15474,20516,36665,42.2037365334788%,55.9552706941225%,0.596539952554533,0.607056549057516,0.570047235343151,17283,26897,35990
2593,43,TEXAS,BAYLOR,663,1285,1984,33.4173387096774%,64.7681451612903%,191,1267,1499,12.7418278852568%,84.5230153435624%,183,1494,1702,10.7520564042303%,87.7790834312573%,0.659650924024641,0.868998628257888,0.89087656529517,1948,1458,1677
2594,43,TEXAS,BEE,3795,4429,8330,45.5582232893157%,53.1692677070828%,3444,4744,8485,40.5892751915144%,55.9104301708898%,3288,6006,9420,34.9044585987261%,63.7579617834395%,0.538545719844358,0.579384465070835,0.646223369916075,8224,8188,9294
2595,43,TEXAS,BELL,21011,41208,63291,33.1974530343967%,65.1087832393231%,37801,51998,94994,39.7930395603933%,54.7381939911995%,57014,67893,127375,44.7607458292444%,53.3016683022571%,0.662305726546553,0.579048764462856,0.543548400009607,62219,89799,124907
2596,43,TEXAS,BEXAR,185158,215613,412726,44.8622088261946%,52.2411963384909%,319550,240333,589645,54.1936249777408%,40.7589312213281%,448452,308618,770818,58.1787140414469%,40.03772615585%,0.537995513647445,0.429255755220287,0.407647905741873,400771,559883,757070
2597,43,TEXAS,BLANCO,811,2777,3767,21.529068224051%,73.719139899124%,1244,4212,5685,21.882145998241%,74.089709762533%,1911,5443,7441,25.6820319849483%,73.148770326569%,0.77396878483835,0.771994134897361,0.740141419635572,3588,5456,7354
2598,43,TEXAS,BORDEN,62,283,353,17.5637393767705%,80.1699716713881%,31,330,365,8.49315068493151%,90.4109589041096%,16,397,416,3.84615384615385%,95.4326923076923%,0.820289855072464,0.914127423822715,0.961259079903148,345,361,413
2599,43,TEXAS,BOSQUE,1930,4745,6770,28.5081240768095%,70.0886262924668%,1278,6339,7838,16.3051798928298%,80.8752232712427%,1561,7469,9126,17.1049747972825%,81.8430856892395%,0.710861423220974,0.832217408428515,0.827131782945736,6675,7617,9030
2600,43,TEXAS,BOWIE,11662,18325,30320,38.4630606860158%,60.438654353562%,8838,24924,34602,25.5418761921276%,72.0305184671406%,10747,27116,38261,28.0886542432242%,70.8711220302658%,0.611098142528429,0.738226408388129,0.716160895861395,29987,33762,37863
2601,43,TEXAS,BRAZORIA,24883,53445,80019,31.0963646134043%,66.7903872830203%,43200,72791,121181,35.6491529200122%,60.0679974583474%,62228,90433,154984,40.151241418469%,58.3498941826253%,0.682323051782249,0.627557310480986,0.592377883021859,78328,115991,152661
2602,43,TEXAS,BRAZOS,12359,32864,46941,26.3287957222897%,70.0112907692635%,23121,38738,67211,34.4006189463034%,57.6363988037672%,35349,47530,85061,41.5572353957748%,55.8775467017787%,0.726709860026977,0.626230621251556,0.573486649211501,45223,61859,82879
2603,43,TEXAS,BREWSTER,1349,1867,3580,37.6815642458101%,52.1508379888268%,1873,2077,4252,44.0498588899341%,48.8476011288805%,2258,2461,4822,46.8270427208627%,51.0369141435089%,0.580534825870647,0.525822784810127,0.521508794236067,3216,3950,4719
2604,43,TEXAS,BRISCOE,224,544,772,29.0155440414508%,70.4663212435233%,91,625,736,12.3641304347826%,84.9184782608696%,78,639,725,10.7586206896552%,88.1379310344828%,0.708333333333333,0.872905027932961,0.891213389121339,768,716,717
2605,43,TEXAS,BROOKS,1854,556,2431,76.2649115590292%,22.8712464006582%,1937,613,2596,74.6147919876733%,23.613251155624%,1470,998,2484,59.1787439613527%,40.1771336553945%,0.230705394190871,0.240392156862745,0.404376012965964,2410,2550,2468
2606,43,TEXAS,BROWN,3138,9609,12920,24.2879256965944%,74.3730650154799%,1621,12017,14026,11.5571082275774%,85.6766005988878%,2107,13698,15969,13.1943139833427%,85.7786962239339%,0.753824429277477,0.881140929755096,0.866687757038912,12747,13638,15805
2607,43,TEXAS,BURLESON,2235,3542,5866,38.1009205591545%,60.381861575179%,1491,5316,6960,21.4224137931034%,76.3793103448276%,1788,6743,8609,20.7689627134394%,78.3250087118132%,0.613120997057296,0.780960775672102,0.790411440628297,5777,6807,8531
2608,43,TEXAS,BURNET,3557,9286,13232,26.8818016928658%,70.1783555018138%,3797,14638,19204,19.7719225161425%,76.223703395126%,5639,18767,24717,22.8142573936966%,75.9274992919853%,0.723039788211477,0.794033089232438,0.768950258133246,12843,18435,24406
2609,43,TEXAS,CALDWELL,3872,5216,9425,41.0822281167109%,55.342175066313%,4795,6691,12092,39.654316903738%,55.3341051935164%,6672,8031,14973,44.5602083750751%,53.6365457824083%,0.573943661971831,0.582535260316907,0.546215058151398,9088,11486,14703
2610,43,TEXAS,CALHOUN,2766,3724,6563,42.1453603534969%,56.7423434404998%,2118,4638,6965,30.4091888011486%,66.5900933237617%,2148,5641,7856,27.3421588594705%,71.8049898167006%,0.573805855161787,0.686500888099467,0.72422647323148,6490,6756,7789
2611,43,TEXAS,CALLAHAN,1174,3656,4896,23.9787581699346%,74.6732026143791%,569,4865,5579,10.1989603871662%,87.2020075282309%,734,6012,6832,10.7435597189696%,87.9976580796253%,0.756935817805383,0.895288921604711,0.891194782093092,4830,5434,6746
2612,43,TEXAS,CAMERON,33214,27800,62057,53.5217622508339%,44.7975248561806%,59402,29472,92079,64.5119951346127%,32.0072980809957%,64063,49032,114174,56.1099724981169%,42.9449787166956%,0.455633133379224,0.331615545603889,0.433547017993722,61014,88874,113095
2613,43,TEXAS,CAMP,1625,2121,3784,42.9439746300212%,56.0517970401691%,1260,3201,4542,27.7410832232497%,70.4755614266843%,1394,3626,5060,27.5494071146245%,71.6600790513834%,0.56620395088094,0.717552118359112,0.722310756972112,3746,4461,5020
2614,43,TEXAS,CARSON,480,2216,2742,17.5054704595186%,80.8169219547775%,249,2620,2964,8.40080971659919%,88.3940620782726%,297,2779,3122,9.51313260730301%,89.0134529147982%,0.821958456973294,0.913210177762286,0.903446033810143,2696,2869,3076
2615,43,TEXAS,CASS,4618,6295,11019,41.9094291678011%,57.1285960613486%,2391,9726,12344,19.3697342838626%,78.7913156189242%,2795,11033,13927,20.0689308537373%,79.2202197170963%,0.57683496746999,0.802673929190394,0.797873879085913,10913,12117,13828
2616,43,TEXAS,CASTRO,727,1607,2354,30.8836023789295%,68.2667799490229%,526,1414,1997,26.3395092638958%,70.806209313971%,466,1602,2083,22.3715794527124%,76.9083053288526%,0.688517566409597,0.728865979381443,0.774661508704062,2334,1940,2068
2617,43,TEXAS,CHAMBERS,2888,6769,9806,29.4513563124618%,69.0291658168468%,2948,13339,16786,17.562254259502%,79.4650303824616%,3997,17353,21652,18.4601884352485%,80.1450212451506%,0.700942321631977,0.81899674587094,0.812786885245902,9657,16287,21350
2618,43,TEXAS,CHEROKEE,4755,9599,14537,32.7096374767834%,66.0315058127537%,3469,12919,16790,20.6611078022633%,76.9446098868374%,4210,15101,19508,21.5808898913266%,77.4092679926184%,0.668733454089452,0.788320722479863,0.781989539640619,14354,16388,19311
2619,43,TEXAS,CHILDRESS,602,1506,2126,28.3160865475071%,70.8372530573848%,253,1802,2084,12.1401151631478%,86.468330134357%,310,1943,2279,13.6024572180781%,85.2566915313734%,0.714421252371917,0.876885644768856,0.862405681313804,2108,2055,2253
2620,43,TEXAS,CLAY,1460,3112,4637,31.4858744878154%,67.1123571274531%,536,4377,5018,10.6815464328418%,87.2259864487844%,614,5069,5744,10.6894150417827%,88.2486072423398%,0.680664916885389,0.890901689395481,0.891958472637691,4572,4913,5683
2621,43,TEXAS,COCHRAN,344,807,1171,29.3766011955593%,68.9154568744663%,190,679,901,21.0876803551609%,75.3607103218646%,177,809,1000,17.7%,80.9%,0.70112945264987,0.781357882623705,0.820486815415821,1151,869,986
2622,43,TEXAS,COKE,355,1137,1515,23.4323432343234%,75.049504950495%,140,1265,1423,9.83836964160225%,88.8966971187632%,178,1586,1779,10.0056211354694%,89.1512085441259%,0.762064343163539,0.900355871886121,0.899092970521542,1492,1405,1764
2623,43,TEXAS,COLEMAN,853,2687,3578,23.8401341531582%,75.0978200111794%,388,3177,3643,10.6505627230305%,87.2083447707933%,451,3641,4124,10.9359844810863%,88.2880698351115%,0.759039548022599,0.891164095371669,0.889784946236559,3540,3565,4092
2624,43,TEXAS,COLLIN,42884,128179,175420,24.4464713259606%,73.069775396192%,140624,201014,361419,38.9088564795985%,55.6179946267352%,230945,252318,490856,47.0494401616767%,51.4036703228646%,0.749308734209034,0.588383025307489,0.52211321785446,171063,341638,483263
2625,43,TEXAS,COLLINGSWORTH,429,974,1415,30.3180212014134%,68.8339222614841%,145,983,1156,12.5432525951557%,85.0346020761246%,155,1048,1218,12.7257799671593%,86.0426929392447%,0.694226657163222,0.87145390070922,0.871155444721529,1403,1128,1203
2626,43,TEXAS,COLORADO,2229,4913,7249,30.749068837081%,67.7748654986895%,1987,6325,8513,23.3407729355104%,74.2981322682955%,2420,7472,9975,24.2606516290727%,74.9072681704261%,0.687902548305797,0.760948026948989,0.755357864941367,7142,8312,9892
2627,43,TEXAS,COMAL,7131,24599,32748,21.7753755954562%,75.1160376206181%,14238,45136,62178,22.8987744861527%,72.5915918813728%,24826,62740,88892,27.9282725104621%,70.5800296989605%,0.775260006303183,0.760198066493751,0.716488134664139,31730,59374,87566
2628,43,TEXAS,COMANCHE,1636,3334,5022,32.5766626841896%,66.3878932696137%,789,4333,5237,15.0658774107313%,82.7382088982242%,853,5177,6086,14.0157739073283%,85.0640814985212%,0.670824949698189,0.845958609918001,0.858540630182421,4970,5122,6030
2629,43,TEXAS,CONCHO,268,818,1103,24.2973708068903%,74.1613780598368%,148,885,1068,13.8576779026217%,82.8651685393258%,197,1058,1268,15.5362776025237%,83.4384858044164%,0.753222836095764,0.856727976766699,0.843027888446215,1086,1033,1255
2630,43,TEXAS,COOKE,3153,10128,13469,23.4093102680229%,75.1948919741629%,2352,13181,15955,14.7414603572548%,82.6136007521153%,3210,15596,18996,16.8982943777637%,82.1014950515898%,0.762593178224531,0.848580441640379,0.829309794746358,13281,15533,18806
2631,43,TEXAS,CORYELL,4493,10321,15087,29.7806058195798%,68.4098893086763%,5064,12225,18253,27.7433846490988%,66.9752917328658%,7565,15438,23493,32.2010811731154%,65.7131911633253%,0.696705818820035,0.707096998091272,0.671129852627918,14814,17289,23003
2632,43,TEXAS,COTTLE,241,502,757,31.8361955085865%,66.3143989431968%,92,506,612,15.0326797385621%,82.6797385620915%,113,540,662,17.0694864048338%,81.570996978852%,0.67563930013459,0.846153846153846,0.826952526799387,743,598,653
2633,43,TEXAS,CRANE,387,1246,1654,23.3978234582829%,75.3325272067715%,299,1049,1384,21.6040462427746%,75.7947976878613%,241,1247,1503,16.0345974717232%,82.9673985362608%,0.7630128597673,0.778189910979229,0.838037634408602,1633,1348,1488
2634,43,TEXAS,CROCKETT,467,924,1398,33.4048640915594%,66.0944206008584%,372,980,1395,26.6666666666667%,70.2508960573477%,344,1220,1574,21.8551461245235%,77.5095298602287%,0.664270309130122,0.724852071005917,0.780051150895141,1391,1352,1564
2635,43,TEXAS,CROSBY,705,1270,2002,35.2147852147852%,63.4365634365634%,468,1181,1728,27.0833333333333%,68.3449074074074%,527,1396,1953,26.984126984127%,71.4797747055812%,0.643037974683544,0.716191631291692,0.725949037961518,1975,1649,1923
2636,43,TEXAS,CULBERSON,577,413,1012,57.0158102766798%,40.8102766798419%,454,280,767,59.1916558018253%,36.5058670143416%,438,415,864,50.6944444444444%,48.0324074074074%,0.417171717171717,0.381471389645777,0.48651817116061,990,734,853
2637,43,TEXAS,DALLAM,341,1385,1744,19.552752293578%,79.4151376146789%,222,1261,1544,14.3782383419689%,81.6709844559585%,197,1389,1609,12.2436295835923%,86.3269111249223%,0.802433371958285,0.850303438975051,0.87578814627995,1726,1483,1586
2638,43,TEXAS,DALLAS,275308,322345,613039,44.9087252197658%,52.5814833966518%,461080,262945,758973,60.7505141816639%,34.6448424384003%,598576,307076,919504,65.0977048495711%,33.3958307957334%,0.539351429675748,0.363171161216809,0.339066219695865,597653,724025,905652
2639,43,TEXAS,DAWSON,1463,3337,4839,30.233519322174%,68.9605290349246%,835,2636,3563,23.4353073252877%,73.982598933483%,808,2951,3789,21.3248878332014%,77.8833465294273%,0.695208333333333,0.759435321233074,0.785049215216813,4800,3471,3759
2640,43,TEXAS,DEAF SMITH,1240,3687,4984,24.8796147672552%,73.9767255216693%,1185,2911,4216,28.107210626186%,69.0464895635674%,1264,3294,4610,27.4186550976139%,71.4533622559653%,0.748325553074893,0.710693359375,0.722685388328214,4927,4096,4558
2641,43,TEXAS,DELTA,726,1143,1900,38.2105263157895%,60.1578947368421%,400,1836,2281,17.5361683472161%,80.4910127137221%,403,2162,2592,15.5478395061728%,83.4104938271605%,0.611556982343499,0.821109123434705,0.842884990253411,1869,2236,2565
2642,43,TEXAS,DENTON,40144,102171,146790,27.3479119831051%,69.6035152258328%,110890,170603,298645,37.1310418724573%,57.1256843409399%,188695,222480,417964,45.1462326898967%,53.2294647385899%,0.717921512138566,0.606064804453397,0.541083480269958,142315,281493,411175
2643,43,TEXAS,DEWITT,1570,4541,6183,25.3922044315057%,73.4433123079411%,1163,5519,6844,16.9929865575687%,80.6399766218586%,1494,6567,8118,18.4035476718404%,80.8943089430894%,0.743086237931599,0.825950314277162,0.814663193152214,6111,6682,8061
2644,43,TEXAS,DICKENS,284,589,881,32.2360953461975%,66.855845629966%,128,755,909,14.0814081408141%,83.0583058305831%,130,853,988,13.1578947368421%,86.336032388664%,0.674684994272623,0.855039637599094,0.867751780264496,873,883,983
2645,43,TEXAS,DIMMIT,2678,1032,3753,71.3562483346656%,27.498001598721%,2173,974,3225,67.3798449612403%,30.2015503875969%,2264,1384,3666,61.7566830332788%,37.7523186033824%,0.278167115902965,0.309501112170321,0.379385964912281,3710,3147,3648
2646,43,TEXAS,DONLEY,360,1333,1719,20.9424083769633%,77.5450843513671%,191,1225,1465,13.037542662116%,83.617747440273%,198,1438,1648,12.0145631067961%,87.2572815533981%,0.787359716479622,0.865112994350282,0.878973105134474,1693,1416,1636
2647,43,TEXAS,DUVAL,3990,1010,5030,79.324055666004%,20.0795228628231%,2783,1316,4168,66.7706333973129%,31.573896353167%,2575,2443,5053,50.9598258460321%,48.3475163269345%,0.202,0.321053915589168,0.48684734954165,5000,4099,5018
2648,43,TEXAS,EASTLAND,1774,4531,6414,27.6582475834113%,70.6423448705956%,776,6011,6963,11.1446215711619%,86.3277322992963%,983,7237,8293,11.8533703123116%,87.266369227059%,0.718636003172086,0.88566376897009,0.880413625304136,6305,6787,8220
2649,43,TEXAS,ECTOR,9425,22893,32901,28.6465456976992%,69.5814716877906%,10249,25020,36530,28.0563920065699%,68.4916506980564%,11367,32697,44591,25.491691148438%,73.3264560113027%,0.708366854384553,0.709404859791885,0.74203431372549,32318,35269,44064
2650,43,TEXAS,EDWARDS,261,663,937,27.854855923159%,70.7577374599787%,303,746,1073,28.2385834109972%,69.524697110904%,168,893,1066,15.7598499061914%,83.7711069418387%,0.717532467532468,0.71115347950429,0.841658812441093,924,1049,1061
2651,43,TEXAS,EL PASO,83848,57574,145042,57.8094620868438%,39.694709118738%,147843,55512,214008,69.082931479197%,25.9392172255243%,178126,84331,266729,66.7816397916987%,31.61673458829%,0.407107805009122,0.272980747953087,0.321313586606568,141422,203355,262457
2652,43,TEXAS,ELLIS,10629,26091,37307,28.4906317849197%,69.9359369555311%,16253,44941,63673,25.5257330422628%,70.5809369748559%,27565,56717,85493,32.2424058110021%,66.341103950031%,0.710539215686275,0.734402065561983,0.672943214446738,36720,61194,84282
2653,43,TEXAS,ERATH,2804,8126,11115,25.2271704903284%,73.1084120557805%,2160,11210,13893,15.5473979702008%,80.68811631757%,2916,13684,16856,17.2994779307072%,81.1817750355956%,0.743458371454712,0.838444278234854,0.82433734939759,10930,13370,16600
2654,43,TEXAS,FALLS,2417,3239,5715,42.2922134733158%,56.6754155730534%,1684,3441,5248,32.0884146341463%,65.5678353658537%,1899,4177,6133,30.9636393282244%,68.1069623349095%,0.572666195190948,0.671414634146341,0.687458854509546,5656,5125,6076
2655,43,TEXAS,FANNIN,4102,6074,10340,39.6711798839458%,58.742746615087%,2132,9548,12044,17.701760212554%,79.2759880438392%,2655,12171,15007,17.6917438528687%,81.1021523289132%,0.59689465408805,0.817465753424658,0.820922703358964,10176,11680,14826
2656,43,TEXAS,FAYETTE,2542,6658,9387,27.0800042612123%,70.9278789815703%,2144,8743,11174,19.1873993198497%,78.244138177913%,2661,10171,12941,20.5625531257244%,78.595162661309%,0.723695652173913,0.803067879121888,0.792627805486284,9200,10887,12832
2657,43,TEXAS,FISHER,884,968,1872,47.2222222222222%,51.7094017094017%,403,1265,1729,23.3082706766917%,73.1636784268363%,352,1448,1826,19.2771084337349%,79.2990142387733%,0.52267818574514,0.758393285371703,0.804444444444444,1852,1668,1800
2658,43,TEXAS,FLOYD,580,1830,2420,23.9669421487603%,75.6198347107438%,435,1474,1959,22.2052067381317%,75.2424706482899%,438,1584,2039,21.4811181951937%,77.6851397743992%,0.759336099585062,0.772132006286014,0.783382789317507,2410,1909,2022
2659,43,TEXAS,FOARD,263,286,556,47.3021582733813%,51.4388489208633%,113,383,513,22.0272904483431%,74.6588693957115%,99,445,551,17.967332123412%,80.7622504537205%,0.520947176684882,0.772177419354839,0.818014705882353,549,496,544
2660,43,TEXAS,FORT BEND,47569,73567,123509,38.5146021747403%,59.5640803504198%,134686,117291,262066,51.3939236680836%,44.7562827684629%,195552,157718,357514,54.6977181313179%,44.115195488848%,0.607309140140008,0.465482960746417,0.446451722478557,121136,251977,353270
2661,43,TEXAS,FRANKLIN,1018,2420,3472,29.3202764976958%,69.7004608294931%,665,3585,4380,15.1826484018265%,81.8493150684932%,804,4161,5009,16.0511080055899%,83.070473148333%,0.703897614892379,0.843529411764706,0.838066465256798,3438,4250,4965
2662,43,TEXAS,FREESTONE,2316,4247,6641,34.8742659238067%,63.9512121668423%,1471,6026,7684,19.1436751691827%,78.4226965122332%,1635,6991,8711,18.7693720583171%,80.2548501894157%,0.64711260094469,0.803788181939443,0.81045675863668,6563,7497,8626
2663,43,TEXAS,FRIO,2317,1774,4128,56.1288759689923%,42.9748062015504%,2444,1856,4400,55.5454545454545%,42.1818181818182%,2422,2823,5279,45.8799014964955%,53.476037128244%,0.433634808115375,0.431627906976744,0.538226882745472,4091,4300,5245
2664,43,TEXAS,GAINES,723,2691,3459,20.9019947961839%,77.7970511708586%,597,3907,4620,12.9220779220779%,84.5670995670996%,576,5355,5996,9.60640426951301%,89.3095396931287%,0.788224956063269,0.867451154529307,0.90288315629742,3414,4504,5931
2665,43,TEXAS,GALVESTON,40020,50397,92983,43.0401256143596%,54.2002301495972%,43658,73757,122903,35.5223224819573%,60.0123674767906%,58842,93911,155060,37.947891138914%,60.5642976912163%,0.557384120242875,0.628173572371503,0.61478988956027,90417,117415,152753
2666,43,TEXAS,GARZA,454,1302,1770,25.6497175141243%,73.5593220338983%,230,1225,1484,15.4986522911051%,82.5471698113208%,231,1413,1653,13.9745916515427%,85.480943738657%,0.741457858769932,0.84192439862543,0.85948905109489,1756,1455,1644
2667,43,TEXAS,GILLESPIE,1511,8096,9920,15.2318548387097%,81.6129032258064%,2288,10446,13214,17.3149689723021%,79.0525200544877%,3176,12514,15850,20.0378548895899%,78.9526813880126%,0.842718850837931,0.820323543269986,0.797578075207138,9607,12734,15690
2668,43,TEXAS,GLASSCOCK,39,528,571,6.83012259194396%,92.4693520140105%,34,553,604,5.62913907284768%,91.5562913907285%,39,611,653,5.97243491577335%,93.5681470137826%,0.931216931216931,0.942078364565588,0.94,567,587,650
2669,43,TEXAS,GOLIAD,1233,2108,3392,36.3502358490566%,62.1462264150943%,973,2620,3708,26.2405609492988%,70.6580366774542%,877,3085,3995,21.9524405506884%,77.2215269086358%,0.630948817719246,0.729195658224325,0.778647147905098,3341,3593,3962
2670,43,TEXAS,GONZALES,1877,4092,6069,30.9276651837205%,67.4246169055858%,1571,4587,6334,24.802652352384%,72.4186927691822%,1948,5627,7648,25.4707112970711%,73.5747907949791%,0.685541966828614,0.744884702825593,0.742838283828383,5969,6158,7575
2671,43,TEXAS,GRAY,1376,6732,8185,16.8112400733048%,82.2480146609652%,701,6500,7405,9.46657663740716%,87.778528021607%,829,6840,7782,10.6527884862503%,87.8951426368543%,0.830291070547607,0.902652409387585,0.891902464467336,8108,7201,7669
2672,43,TEXAS,GRAYSON,13647,25596,39940,34.1687531296945%,64.0861291937907%,10301,35325,47416,21.7247342669141%,74.5001687194196%,14506,44163,59474,24.3904899620002%,74.2559774018899%,0.652243712254415,0.774229605926445,0.752748470231298,39243,45626,58669
2673,43,TEXAS,GREGG,11244,26739,38433,29.2561080321599%,69.5730231832019%,11677,28764,41749,27.9695322043642%,68.8974586217634%,14796,32493,47982,30.8365637113918%,67.7191446792547%,0.703972829950241,0.711258376400188,0.687115396815327,37983,40441,47289
2674,43,TEXAS,GRIMES,2450,4197,6802,36.0188179947074%,61.7024404586886%,2194,7065,9533,23.0147907269485%,74.1109829015001%,2833,9432,12414,22.8210085387466%,75.9787336877719%,0.631412667368738,0.763041365158224,0.769017529555646,6647,9259,12265
2675,43,TEXAS,GUADALUPE,8311,21499,30567,27.1894526777243%,70.3340203487421%,18391,36632,57822,31.8062329217253%,63.3530490124866%,28805,47553,77619,37.1107589636558%,61.2646388126619%,0.72120093928212,0.665757955763953,0.622763823044082,29810,55023,76358
2676,43,TEXAS,HALE,2158,6868,9110,23.6882546652031%,75.3896816684962%,2101,6366,8858,23.7186723865432%,71.8672386543238%,2279,7177,9586,23.7742541205925%,74.8696015021907%,0.760912918236207,0.751860162985709,0.758989001692047,9026,8467,9456
2677,43,TEXAS,HALL,472,966,1446,32.6417704011065%,66.804979253112%,164,893,1091,15.032080659945%,81.8515123739688%,168,995,1169,14.3712574850299%,85.1154833190761%,0.671766342141864,0.84484389782403,0.85554600171969,1438,1057,1163
2678,43,TEXAS,HAMILTON,878,2447,3376,26.0071090047393%,72.4822274881517%,479,3060,3620,13.232044198895%,84.5303867403315%,641,3616,4351,14.7322454608136%,83.107331647897%,0.73593984962406,0.864651031364792,0.849424477331454,3325,3539,4257
2679,43,TEXAS,HANSFORD,198,1874,2088,9.48275862068966%,89.7509578544061%,171,1730,1947,8.78274268104777%,88.8546481766821%,166,1849,2047,8.10942843185149%,90.3273082559844%,0.904440154440155,0.910047343503419,0.917617866004963,2072,1901,2015
2680,43,TEXAS,HARDEMAN,566,976,1557,36.3519588953115%,62.684649967887%,249,1207,1513,16.4573694646398%,79.7752808988764%,241,1330,1580,15.253164556962%,84.1772151898734%,0.632944228274968,0.828983516483516,0.846594525779758,1542,1456,1571
2681,43,TEXAS,HARDIN,5595,11962,17836,31.3691410630186%,67.0666068625252%,2780,19606,22780,12.2036874451273%,86.0667251975417%,3474,23858,27635,12.5710150171883%,86.3325493034196%,0.681323688557271,0.8758152416689,0.872896238840919,17557,22386,27332
2682,43,TEXAS,HARRIS,418267,529159,974822,42.9070127674591%,54.2826280079851%,707914,545955,1312112,53.9522540758716%,41.6088718036265%,918193,700630,1640818,55.959466558753%,42.700043514881%,0.558522776449031,0.435416299469881,0.432802103750688,947426,1253869,1618823
2683,43,TEXAS,HARRISON,8878,13834,22970,38.6504135829343%,60.2263822377014%,7151,18749,26548,26.9361157149314%,70.6230224499021%,7908,21466,29717,26.6110307231551%,72.2347477874617%,0.609105318774216,0.723899613899614,0.730782324504664,22712,25900,29374
2684,43,TEXAS,HARTLEY,359,1645,2031,17.6760216642048%,80.9945839487937%,173,1730,1952,8.86270491803279%,88.6270491803279%,195,1868,2078,9.38402309913378%,89.8941289701636%,0.820858283433134,0.909090909090909,0.905477460009695,2004,1903,2063
2685,43,TEXAS,HASKELL,1401,1488,2927,47.8647078920396%,50.8370345063205%,314,1403,1770,17.7401129943503%,79.2655367231639%,353,1840,2214,15.9439927732611%,83.1074977416441%,0.515057113187954,0.817122888759464,0.839033287733698,2889,1717,2193
2686,43,TEXAS,HAYS,11387,20170,34317,33.1818049363289%,58.7755339918991%,33224,33826,72164,46.0395765201486%,46.8737874840641%,59524,47680,109395,54.4119932355227%,43.5851729969377%,0.639160883480686,0.504489187173751,0.444759523898362,31557,67050,107204
2687,43,TEXAS,HEMPHILL,251,1203,1474,17.0284938941655%,81.6146540027137%,181,1462,1695,10.6784660766962%,86.2536873156342%,206,1486,1720,11.9767441860465%,86.3953488372093%,0.827372764786795,0.889835666463786,0.878250591016549,1454,1643,1692
2688,43,TEXAS,HENDERSON,8704,16607,25627,33.9641784055879%,64.8027471026652%,5669,23650,30045,18.8683641204859%,78.7152604426693%,7060,28911,36317,19.4399317124212%,79.6073464217859%,0.656117893406029,0.806644155666974,0.803730783130855,25311,29319,35971
2689,43,TEXAS,HIDALGO,61390,38301,101050,60.7521029193469%,37.9030183077684%,118809,48642,173437,68.5026839717015%,28.0459186909368%,128199,90527,220884,58.0390612267072%,40.9839553792941%,0.384197169252992,0.290484977694967,0.413883123176943,99691,167451,218726
2690,43,TEXAS,HILL,3524,7054,10735,32.8272007452259%,65.7102934326968%,2547,10108,12970,19.6376252891288%,77.9336931380108%,2860,11926,14931,19.1547786484495%,79.8740874690242%,0.666855738324825,0.798735677597787,0.806573786013797,10578,12655,14786
2691,43,TEXAS,HOCKLEY,1419,5250,6745,21.0378057820608%,77.8354336545589%,1260,5809,7311,17.2343044727124%,79.4556148269731%,1482,6536,8100,18.2962962962963%,80.6913580246914%,0.787224471434998,0.821756967039185,0.815165876777251,6669,7069,8018
2692,43,TEXAS,HOOD,4704,12429,17505,26.8723221936589%,71.0025706940874%,4008,21382,26262,15.2615946995659%,81.4180184296702%,5648,26496,32541,17.356565563443%,81.4234350511662%,0.725442129224304,0.842142575817251,0.824290691886511,17133,25390,32144
2693,43,TEXAS,HOPKINS,3692,7076,10910,33.8405132905591%,64.8579285059578%,2510,10707,13538,18.5404047865268%,79.0884916531245%,3046,12719,15941,19.1079606047299%,79.7879681324886%,0.657132243684993,0.81009306196565,0.806787186806216,10768,13217,15765
2694,43,TEXAS,HOUSTON,2833,5308,8236,34.3977659057795%,64.4487615347256%,1978,6205,8353,23.6801149287681%,74.284688135999%,2314,7060,9438,24.5179063360882%,74.803983894893%,0.652008352782213,0.758279359648051,0.753147002346917,8141,8183,9374
2695,43,TEXAS,HOWARD,2744,6668,9548,28.7390029325513%,69.8366149979053%,1770,6637,8723,20.2911842256105%,76.0862088730941%,2069,8054,10241,20.2031051655112%,78.6446636070696%,0.708457288567786,0.789461163316284,0.795613948434259,9412,8407,10123
2696,43,TEXAS,HUDSPETH,380,514,922,41.2147505422993%,55.7483731019523%,324,503,871,37.1986222732491%,57.7497129735936%,371,779,1165,31.8454935622318%,66.8669527896996%,0.574944071588367,0.608222490931076,0.677391304347826,894,827,1150
2697,43,TEXAS,HUNT,7857,16177,24466,32.1139540586937%,66.1203302542304%,6396,23910,31554,20.2700133105153%,75.7748621410915%,8906,29163,38597,23.0743322019846%,75.557685830505%,0.673088125156029,0.788952682637102,0.766056371325751,24034,30306,38069
2698,43,TEXAS,HUTCHINSON,1796,7443,9351,19.206501978398%,79.5957651588065%,854,7042,8155,10.4721030042918%,86.3519313304721%,965,7681,8773,10.9996580417189%,87.5527185683347%,0.805606667388246,0.891843971631206,0.888387693731205,9239,7896,8646
2699,43,TEXAS,IRION,162,624,793,20.4287515762926%,78.6885245901639%,90,660,766,11.7493472584856%,86.1618798955614%,120,759,889,13.4983127109111%,85.3768278965129%,0.793893129770992,0.88,0.863481228668942,786,750,879
2700,43,TEXAS,JACK,822,2107,2974,27.6395427034297%,70.8473436449227%,314,2973,3350,9.37313432835821%,88.7462686567164%,331,3418,3782,8.75198307773665%,90.3754627181386%,0.719358142710823,0.904472163066626,0.91170978927714,2929,3287,3749
2701,43,TEXAS,JACKSON,1446,3365,4856,29.7775947281713%,69.2957166392092%,904,4266,5302,17.0501697472652%,80.4602036967182%,1033,5231,6353,16.260034629309%,82.3390524161813%,0.699438786115153,0.825145067698259,0.835089399744572,4811,5170,6264
2702,43,TEXAS,JASPER,4533,7071,11742,38.605007664793%,60.2197240674502%,2590,10609,13419,19.300991131977%,79.0595424398241%,2954,12542,15611,18.9225546089296%,80.3407853436679%,0.609358841778697,0.803773013107053,0.809370160041301,11604,13199,15496
2703,43,TEXAS,JEFF DAVIS,283,708,1060,26.6981132075472%,66.7924528301887%,422,695,1191,35.4324097397145%,58.3543240973972%,501,784,1305,38.3908045977011%,60.0766283524904%,0.714429868819374,0.622202327663384,0.61011673151751,991,1117,1285
2704,43,TEXAS,JEFFERSON,45409,40320,86909,52.2489040260502%,46.3933539679435%,42443,42862,87618,48.4409596201694%,48.9191718596635%,46073,47570,94759,48.6212391435114%,50.2010363131734%,0.470319261860047,0.502455893558408,0.507993122817509,85729,85305,93643
2705,43,TEXAS,JIM HOGG,1512,623,2157,70.0973574408901%,28.8827074640705%,1635,430,2119,77.1590372817367%,20.2925908447381%,1197,833,2036,58.7917485265226%,40.9135559921415%,0.291803278688525,0.208232445520581,0.410344827586207,2135,2065,2030
2706,43,TEXAS,JIM WELLS,7418,4498,12023,61.6984113781918%,37.411627713549%,6694,5420,12379,54.0754503594798%,43.7838274497132%,6119,7453,13669,44.7655278367108%,54.5248372229132%,0.377475662974152,0.447416212646525,0.549145299145299,11916,12114,13572
2707,43,TEXAS,JOHNSON,11778,26202,38726,30.4136755668027%,67.659970045964%,10988,44382,57606,19.0744019720168%,77.0440579106343%,16464,54628,72020,22.8603165787281%,75.8511524576507%,0.689889415481833,0.80155318764674,0.7684127609295,37980,55370,71092
2708,43,TEXAS,JONES,1899,4080,6048,31.3988095238095%,67.4603174603175%,936,4819,5960,15.7046979865772%,80.8557046979866%,999,5660,6741,14.8197596795728%,83.9638035899718%,0.682388359257401,0.837358818418766,0.84997747409521,5979,5755,6659
2709,43,TEXAS,KARNES,1617,2638,4308,37.5348189415042%,61.2349117920149%,1145,2965,4198,27.2748928060981%,70.6288708909004%,1234,3968,5252,23.4958111195735%,75.5521706016756%,0.619976498237368,0.721411192214112,0.762783544790465,4255,4110,5202
2710,43,TEXAS,KAUFMAN,7455,15290,23063,32.3245024498114%,66.2966656549452%,10278,29587,41265,24.907306434024%,71.699987883194%,18405,37624,56718,32.4500158679784%,66.3352022285694%,0.672235656188173,0.742179857017434,0.671509396919452,22745,39865,56029
2711,43,TEXAS,KENDALL,1901,8788,11073,17.1678858484602%,79.3642192721033%,3643,15700,20120,18.1063618290258%,78.0318091451292%,6020,20083,26452,22.7582035384848%,75.9224255254801%,0.822153615866779,0.811663133950266,0.769375167605256,10689,19343,26103
2712,43,TEXAS,KENEDY,119,106,228,52.1929824561404%,46.4912280701754%,99,84,186,53.2258064516129%,45.1612903225806%,65,127,194,33.5051546391753%,65.4639175257732%,0.471111111111111,0.459016393442623,0.661458333333333,225,183,192
2713,43,TEXAS,KENT,185,346,536,34.5149253731343%,64.5522388059702%,59,360,434,13.594470046083%,82.9493087557604%,47,411,462,10.1731601731602%,88.961038961039%,0.651600753295669,0.859188544152745,0.897379912663756,531,419,458
2714,43,TEXAS,KERR,4002,14637,19228,20.8133971291866%,76.123361764094%,4681,17727,23297,20.0927158003176%,76.0913422329055%,6524,20879,27745,23.5141466930979%,75.253198774554%,0.785288910349268,0.791101392359871,0.761923876947779,18639,22408,27403
2715,43,TEXAS,KIMBLE,328,1313,1666,19.68787515006%,78.8115246098439%,206,1697,1952,10.5532786885246%,86.9364754098361%,284,1987,2292,12.39092495637%,86.6928446771379%,0.800121876904327,0.891749868628481,0.874944958168208,1641,1903,2271
2716,43,TEXAS,KING,14,120,137,10.2189781021898%,87.5912408759124%,5,149,159,3.14465408805031%,93.7106918238994%,8,151,159,5.0314465408805%,94.9685534591195%,0.895522388059701,0.967532467532468,0.949685534591195,134,154,159
2717,43,TEXAS,KINNEY,486,932,1444,33.6565096952909%,64.5429362880887%,458,936,1430,32.027972027972%,65.4545454545455%,446,1144,1603,27.8228321896444%,71.3661883967561%,0.657263751763047,0.671449067431851,0.719496855345912,1418,1394,1590
2718,43,TEXAS,KLEBERG,4481,4526,9194,48.7383075919078%,49.227757232978%,4716,4367,9512,49.5794785534062%,45.9104289318755%,5314,5504,10944,48.5562865497076%,50.2923976608187%,0.502498057066726,0.480788285808653,0.50878166019597,9007,9083,10818
2719,43,TEXAS,KNOX,617,947,1576,39.1497461928934%,60.0888324873096%,247,1078,1367,18.0687637161668%,78.8588149231895%,265,1180,1456,18.2005494505494%,81.043956043956%,0.605498721227622,0.813584905660377,0.816608996539792,1564,1325,1445
2720,43,TEXAS,LA SALLE,1266,731,2014,62.8599801390268%,36.2959285004965%,1129,872,2059,54.8324429334628%,42.3506556580865%,1052,1335,2406,43.7240232751455%,55.4862842892768%,0.366049073610416,0.435782108945527,0.559279430247172,1997,2001,2387
2721,43,TEXAS,LAMAR,5553,9775,15430,35.9883344134802%,63.350615683733%,3583,14561,18611,19.2520552361507%,78.2386760517973%,4458,16760,21442,20.790970991512%,78.1643503404533%,0.637721816283925,0.802524250440917,0.789895371854086,15328,18144,21218
2722,43,TEXAS,LAMB,1114,3451,4598,24.227925184863%,75.0543714658547%,771,3111,3995,19.2991239048811%,77.8723404255319%,840,3521,4410,19.047619047619%,79.8412698412699%,0.755969331872946,0.801391035548686,0.807383627608347,4565,3882,4361
2723,43,TEXAS,LAMPASAS,1569,4526,6214,25.2494367557129%,72.8355326681687%,1483,6385,8205,18.0743449116392%,77.8184034125533%,2144,8086,10399,20.6173670545245%,77.75747668045%,0.742575881870386,0.811514997458058,0.790420332355816,6095,7868,10230
2724,43,TEXAS,LAVACA,2171,5288,7546,28.7702093824543%,70.0768619135966%,1170,7347,8661,13.5088326983027%,84.8285417388292%,1333,8804,10197,13.0724722957733%,86.3391193488281%,0.708942217455423,0.862627685804861,0.868501529051988,7459,8517,10137
2725,43,TEXAS,LEE,1733,3699,5536,31.3041907514451%,66.8171965317919%,1372,4997,6535,20.9946442234124%,76.4651874521806%,1750,6255,8087,21.6396686039322%,77.3463583529121%,0.680964653902798,0.784581566964987,0.781386633354154,5432,6369,8005
2726,43,TEXAS,LEON,1893,4362,6326,29.9241226683528%,68.9535251343661%,909,6391,7439,12.2193843258502%,85.9120849576556%,1072,7523,8674,12.3587733456306%,86.7304588425179%,0.697362110311751,0.875479452054795,0.875276323443863,6255,7300,8595
2727,43,TEXAS,LIBERTY,7311,12458,20077,36.4148030084176%,62.051103252478%,4862,18892,24267,20.0354390736391%,77.8505789755635%,5785,23302,29334,19.7211427013022%,79.4368309811141%,0.63017856239567,0.79531868316915,0.801113899680269,19769,23754,29087
2728,43,TEXAS,LIMESTONE,2768,4212,7075,39.1236749116608%,59.5335689045936%,1778,5796,7739,22.9745445147952%,74.8933970797261%,2213,6789,9095,24.3320505772402%,74.6454095656955%,0.603438395415473,0.765249537892791,0.754165740946456,6980,7574,9002
2729,43,TEXAS,LIPSCOMB,206,1072,1294,15.919629057187%,82.8438948995363%,135,1159,1332,10.1351351351351%,87.012012012012%,131,1205,1353,9.68218773096822%,89.0613451589061%,0.838810641627543,0.895672333848532,0.901946107784431,1278,1294,1336
2730,43,TEXAS,LIVE OAK,1114,2828,4004,27.8221778221778%,70.6293706293706%,742,3464,4302,17.2477917247792%,80.5206880520688%,819,4199,5054,16.2049861495845%,83.0827067669173%,0.71740233384069,0.823585354255825,0.836787564766839,3942,4206,5018
2731,43,TEXAS,LLANO,2143,6295,8627,24.8406166685986%,72.9685869943202%,1825,8299,10447,17.4691298937494%,79.4390734182062%,2465,10079,12660,19.4707740916272%,79.6129541864139%,0.746029864896895,0.819735282497037,0.803491709183673,8438,10124,12544
2732,43,TEXAS,LOVING,29,124,156,18.5897435897436%,79.4871794871795%,4,58,65,6.15384615384615%,89.2307692307692%,4,60,66,6.06060606060606%,90.9090909090909%,0.810457516339869,0.935483870967742,0.9375,153,62,64
2733,43,TEXAS,LUBBOCK,18469,56054,76008,24.298758025471%,73.7475002631302%,28023,65651,99013,28.3023441366285%,66.3054346398958%,40017,78861,120817,33.1219944213149%,65.2730989844144%,0.752170470861345,0.700845485406836,0.66337758037652,74523,93674,118878
2734,43,TEXAS,LYNN,562,1507,2084,26.9673704414587%,72.3128598848369%,403,1546,2009,20.059731209557%,76.9537083125933%,428,1853,2293,18.6655037069341%,80.8111644134322%,0.728371193813436,0.793227296049256,0.812362998684787,2069,1949,2281
2735,43,TEXAS,MADISON,1241,2333,3623,34.2533811758211%,64.3941484957218%,881,3351,4289,20.5409186290511%,78.13010025647%,1088,4169,5298,20.5360513401283%,78.6900717251793%,0.652770005595971,0.791824196597353,0.793037854289519,3574,4232,5257
2736,43,TEXAS,MARION,1852,2039,3930,47.1246819338422%,51.882951653944%,1165,2983,4238,27.4893817838603%,70.386974988202%,1339,3470,4864,27.5287828947368%,71.3404605263158%,0.524029812387561,0.719141755062681,0.721563734664171,3891,4148,4809
2737,43,TEXAS,MARTIN,415,1520,1949,21.2929707542329%,77.9887121600821%,266,1455,1762,15.0964812712826%,82.5766174801362%,288,1857,2160,13.3333333333333%,85.9722222222222%,0.785529715762274,0.845438698431145,0.865734265734266,1935,1721,2145
2738,43,TEXAS,MASON,417,1352,1801,23.1538034425319%,75.0694058856191%,354,1656,2057,17.209528439475%,80.5055906660185%,457,1991,2474,18.4721099434115%,80.4769603880356%,0.764273600904466,0.823880597014925,0.813316993464052,1769,2010,2448
2739,43,TEXAS,MATAGORDA,4696,7584,12459,37.6916285416165%,60.8716590416566%,3500,8366,12196,28.6979337487701%,68.596261069203%,3733,9845,13727,27.1945800247687%,71.7199679463831%,0.617589576547231,0.705039608966796,0.725069966121667,12280,11866,13578
2740,43,TEXAS,MAVERICK,5995,3143,9229,64.958283671037%,34.0556940080182%,10397,2816,13588,76.516043567854%,20.7241683838681%,8332,6881,15346,54.2942786393849%,44.8390460054737%,0.343948347559641,0.213123439037312,0.452310523894038,9138,13213,15213
2741,43,TEXAS,MCCULLOCH,794,2084,2920,27.1917808219178%,71.3698630136986%,482,2552,3103,15.5333548179181%,82.2429906542056%,490,2904,3436,14.2607683352736%,84.5168800931316%,0.724113968033356,0.841133816743573,0.855627578078963,2878,3034,3394
2742,43,TEXAS,MCLENNAN,23462,43955,68789,34.1071973716728%,63.8982976929451%,27063,48260,79075,34.2244704394562%,61.0306670882074%,36688,59543,97872,37.4856956024195%,60.8376246526075%,0.651986887580284,0.640707353663556,0.618750714426744,67417,75323,96231
2743,43,TEXAS,MCMULLEN,77,358,439,17.5398633257403%,81.5489749430524%,40,454,499,8.01603206412826%,90.9819639278557%,53,460,516,10.2713178294574%,89.1472868217054%,0.822988505747126,0.919028340080972,0.896686159844055,435,494,513
2744,43,TEXAS,MEDINA,4025,8590,12873,31.2669929309407%,66.7288122426785%,4634,12085,17246,26.8699988403108%,70.0742201090108%,6773,15642,22657,29.893631107384%,69.0382663194598%,0.68093539437178,0.722830312817752,0.697836270354673,12615,16719,22415
2745,43,TEXAS,MENARD,334,642,990,33.7373737373737%,64.8484848484848%,154,682,864,17.8240740740741%,78.9351851851852%,197,823,1028,19.1634241245136%,80.0583657587549%,0.657786885245902,0.81578947368421,0.806862745098039,976,836,1020
2746,43,TEXAS,MIDLAND,7534,31514,39740,18.9582284851535%,79.3004529441369%,10025,36973,49212,20.3710477119402%,75.1300495814029%,12329,45624,58859,20.9466691584974%,77.5140590224095%,0.807057979922147,0.786693050768118,0.787258640622573,39048,46998,57953
2747,43,TEXAS,MILAM,3429,4706,8269,41.4681339944371%,56.9113556657395%,2051,6364,8664,23.6726685133887%,73.4533702677747%,2496,7984,10578,23.5961429381736%,75.4774059368501%,0.578488014751076,0.756268568033274,0.761832061068702,8135,8415,10480
2748,43,TEXAS,MILLS,548,1738,2314,23.6819360414866%,75.1080380293864%,243,1951,2245,10.8240534521158%,86.9042316258352%,271,2217,2505,10.8183632734531%,88.502994011976%,0.760279965004374,0.889243391066545,0.891077170418006,2286,2194,2488
2749,43,TEXAS,MITCHELL,837,1708,2574,32.5174825174825%,66.3558663558664%,354,1780,2196,16.120218579235%,81.0564663023679%,397,2170,2579,15.3935633966654%,84.1411399767352%,0.671119842829077,0.834114339268978,0.845344760420725,2545,2134,2567
2750,43,TEXAS,MONTAGUE,2256,4951,7330,30.7776261937244%,67.5443383356071%,885,7526,8604,10.2859135285914%,87.4709437470944%,1097,8615,9819,11.172217130054%,87.7380588654649%,0.686971000416262,0.894780644394246,0.887046952224053,7207,8411,9712
2751,43,TEXAS,MONTGOMERY,23286,80600,106213,21.9238699594212%,75.8852494515737%,45835,150314,204632,22.3987450643106%,73.4557644943117%,74377,193382,271543,27.3905053711567%,71.2159768434465%,0.775850451456404,0.76632559941677,0.722224089573086,103886,196149,267759
2752,43,TEXAS,MOORE,1040,4201,5290,19.6597353497164%,79.413988657845%,1098,3977,5284,20.779712339137%,75.2649507948524%,1062,4359,5508,19.281045751634%,79.1394335511983%,0.801564586910895,0.783645320197044,0.804095185390149,5241,5075,5421
2753,43,TEXAS,MORRIS,2455,2381,4889,50.2147678461853%,48.7011658825936%,1425,3446,4973,28.6547355720893%,69.2941886185401%,1669,3872,5587,29.8729192768928%,69.3037408269196%,0.492349048800662,0.707452268528023,0.698790831979787,4836,4871,5541
2754,43,TEXAS,MOTLEY,118,514,642,18.380062305296%,80.0623052959502%,40,566,615,6.50406504065041%,92.0325203252033%,46,604,652,7.05521472392638%,92.6380368098159%,0.813291139240506,0.933993399339934,0.929230769230769,632,606,650
2755,43,TEXAS,NACOGDOCHES,6204,13145,19799,31.3349159048437%,66.3922420324259%,6846,14771,22622,30.2625762532048%,65.2948457254001%,9000,17378,26785,33.600896023894%,64.8795967892477%,0.679363274587834,0.683304806402368,0.658806581241944,19349,21617,26378
2756,43,TEXAS,NAVARRO,5366,8358,13890,38.6321094312455%,60.1727861771058%,4002,11994,16433,24.3534351609566%,72.9872816892838%,5101,13800,19123,26.6746849343722%,72.1644093499974%,0.609006120664529,0.749812453113278,0.730120099465637,13724,15996,18901
2757,43,TEXAS,NEWTON,2503,2423,4990,50.1603206412826%,48.5571142284569%,1156,4288,5534,20.889049512107%,77.4846404047705%,1173,4882,6094,19.2484410895963%,80.1115851657368%,0.49187982135607,0.78765613519471,0.806275805119736,4926,5444,6055
2758,43,TEXAS,NOLAN,1874,3337,5312,35.2786144578313%,62.8200301204819%,1029,3552,4857,21.1859172328598%,73.1315626930204%,1162,4131,5357,21.6912450998693%,77.1140563748367%,0.640376127422759,0.775376555337263,0.780464764783677,5211,4581,5293
2759,43,TEXAS,NUECES,45349,49906,97326,46.5949489345088%,51.2771510182274%,49198,50766,104405,47.1222642593746%,48.6241080408026%,60925,64617,127322,47.8511176387427%,50.7508521700884%,0.523920004199255,0.50784282341643,0.514704242404932,95255,99964,125542
2760,43,TEXAS,OCHILTREE,251,2687,2962,8.47400405131668%,90.7157326130993%,274,2628,3002,9.12724850099933%,87.5416389073951%,302,2812,3156,9.56907477820025%,89.1001267427123%,0.914567733151804,0.905582356995176,0.903018625561978,2938,2902,3114
2761,43,TEXAS,OLDHAM,108,659,774,13.953488372093%,85.1421188630491%,78,850,948,8.22784810126582%,89.662447257384%,81,917,1009,8.02775024777007%,90.8820614469772%,0.859191655801825,0.915948275862069,0.918837675350701,767,928,998
2762,43,TEXAS,ORANGE,11887,17325,29654,40.0856545491333%,58.4238214068928%,5735,25513,32000,17.921875%,79.728125%,6357,29186,35994,17.6612768794799%,81.0857365116408%,0.593078187046419,0.816468253968254,0.821146217257969,29212,31248,35543
2763,43,TEXAS,PALO PINTO,3263,5690,9118,35.7863566571617%,62.4040359728011%,1708,8284,10270,16.6309639727361%,80.6621226874391%,2178,10179,12489,17.43934662503%,81.5037232764833%,0.635541159387915,0.82906325060048,0.823743627093955,8953,9992,12357
2764,43,TEXAS,PANOLA,3011,5975,9074,33.1827198589376%,65.847476305929%,1835,8445,10416,17.6171274961598%,81.0771889400922%,2057,9326,11451,17.9634966378482%,81.4426687625535%,0.664923213888271,0.821498054474708,0.819291926557147,8986,10280,11383
2765,43,TEXAS,PARKER,8878,23651,33225,26.7208427389014%,71.1843491346877%,8344,46473,56817,14.6857454635056%,81.7941813189714%,13017,62045,76128,17.0988335435057%,81.5008932324506%,0.727074302929694,0.847784446430852,0.826583357757587,32529,54817,75062
2766,43,TEXAS,PARMER,447,2274,2744,16.2900874635569%,82.8717201166181%,485,1915,2466,19.6674776966748%,77.6561232765612%,488,2135,2650,18.4150943396226%,80.5660377358491%,0.835722160970231,0.797916666666667,0.813953488372093,2721,2400,2623
2767,43,TEXAS,PECOS,1539,2700,4303,35.7657448291889%,62.7469207529631%,1554,2468,4185,37.1326164874552%,58.9725209080048%,1382,3215,4668,29.6058269065981%,68.8731790916881%,0.636942675159236,0.61362506215813,0.699369153795954,4239,4022,4597
2768,43,TEXAS,POLK,6877,11746,18994,36.2061703695904%,61.8405812361799%,4187,15176,19852,21.0910739472093%,76.4456981664316%,5387,18573,24186,22.2732159100306%,76.7923592160754%,0.630725447027869,0.783762846666322,0.77516694490818,18623,19363,23960
2769,43,TEXAS,POTTER,7242,17629,25376,28.5387767969735%,69.4711538461538%,7657,19630,28651,26.7250706781613%,68.5141879864577%,9921,22820,33337,29.7597264300927%,68.4524702282749%,0.708817498291182,0.719390185802763,0.69698543111084,24871,27287,32741
2770,43,TEXAS,PRESIDIO,1064,618,1757,60.5577689243028%,35.1735913488902%,1458,652,2208,66.0326086956522%,29.5289855072464%,1463,721,2217,65.9900766801985%,32.5214253495715%,0.367419738406659,0.309004739336493,0.330128205128205,1682,2110,2184
2771,43,TEXAS,RAINS,1225,2049,3333,36.7536753675367%,61.4761476147615%,628,3968,4701,13.3588598170602%,84.407572856839%,842,5155,6053,13.9104576243185%,85.1643812985297%,0.625839951130116,0.863359442993908,0.859596464899116,3274,4596,5997
2772,43,TEXAS,RANDALL,7209,33921,41790,17.2505384063173%,81.170136396267%,8367,43462,54305,15.4074210477857%,80.0331461191419%,12802,50796,64674,19.794662460958%,78.5416086835514%,0.82472647702407,0.838565281984989,0.798704361772383,41130,51829,63598
2773,43,TEXAS,REAGAN,282,959,1255,22.4701195219124%,76.4143426294821%,167,709,904,18.4734513274336%,78.429203539823%,172,942,1124,15.3024911032028%,83.8078291814947%,0.77276390008058,0.809360730593607,0.845601436265709,1241,876,1114
2774,43,TEXAS,REAL,316,1146,1490,21.2080536912752%,76.9127516778524%,262,1382,1681,15.5859607376562%,82.2129684711481%,320,1643,1982,16.1453077699294%,82.8960645812311%,0.783857729138167,0.840632603406326,0.836984207845135,1462,1644,1963
2775,43,TEXAS,RED RIVER,2219,2941,5202,42.6566705113418%,56.5359477124183%,1149,3926,5161,22.2631273009107%,76.0705289672544%,1246,4517,5806,21.4605580434034%,77.7988287977954%,0.569961240310078,0.773596059113301,0.783793163283012,5160,5075,5763
2776,43,TEXAS,REEVES,1872,1273,3176,58.9420654911839%,40.0818639798489%,1659,1417,3184,52.1042713567839%,44.5037688442211%,1395,2254,3689,37.8151260504202%,61.100569259962%,0.404769475357711,0.460663198959688,0.617703480405591,3145,3076,3649
2777,43,TEXAS,REFUGIO,1172,1721,2921,40.1232454638822%,58.9181787059226%,1034,1830,2948,35.0746268656716%,62.0759837177748%,1108,2210,3366,32.9174093879976%,65.6565656565657%,0.594884203249222,0.638966480446927,0.666063893911995,2893,2864,3318
2778,43,TEXAS,ROBERTS,72,472,549,13.1147540983607%,85.9744990892532%,20,524,554,3.6101083032491%,94.5848375451264%,17,529,550,3.09090909090909%,96.1818181818182%,0.867647058823529,0.963235294117647,0.968864468864469,544,544,546
2779,43,TEXAS,ROBERTSON,3283,3007,6369,51.5465536190925%,47.2130632752394%,2203,4668,7035,31.3148542999289%,66.3539445628998%,2374,5646,8099,29.3122607729349%,69.7123101617484%,0.478060413354531,0.679377092126328,0.703990024937656,6290,6871,8020
2780,43,TEXAS,ROCKWALL,3642,13666,17652,20.6322229775663%,77.4189893496488%,9655,28451,39948,24.1689195954741%,71.2200861119455%,16412,36726,53891,30.4540646861257%,68.148670464456%,0.789577074185348,0.746627827638692,0.691143814219579,17308,38106,53138
2781,43,TEXAS,RUNNELS,969,3020,4046,23.9495798319328%,74.6416213544241%,453,3250,3782,11.9777895293496%,85.9333685880486%,552,3807,4409,12.5198457700159%,86.3461102290769%,0.757081975432439,0.87766675668377,0.873365450791466,3989,3703,4359
2782,43,TEXAS,RUSK,4841,11611,16633,29.104791679192%,69.8070101605243%,3935,14675,18994,20.7170685479625%,77.2612403917026%,4629,16534,21377,21.6541142349254%,77.3448098423539%,0.705750060782883,0.788554540569586,0.781269196238718,16452,18610,21163
2783,43,TEXAS,SABINE,1753,2764,4591,38.1834023088652%,60.2047484208233%,614,3998,4651,13.2014620511718%,85.960008600301%,669,4784,5491,12.1835731196503%,87.1243853578583%,0.611910560106265,0.866869037294016,0.877315239317807,4517,4612,5453
2784,43,TEXAS,SAN AUGUSTINE,1636,2116,3805,42.9960578186597%,55.611038107753%,910,2622,3569,25.4973381899692%,73.4659568506585%,980,3007,4002,24.487756121939%,75.1374312843578%,0.563965884861407,0.742355605889015,0.754201153749686,3752,3532,3987
2785,43,TEXAS,SAN JACINTO,2946,4623,7714,38.1903033445683%,59.9299974073114%,2038,8059,10343,19.7041477327661%,77.9174320796674%,2337,10161,12640,18.4889240506329%,80.3876582278481%,0.610780816488308,0.798157868673864,0.813010081613058,7569,10097,12498
2786,43,TEXAS,SAN PATRICIO,7840,10599,18699,41.9273757954971%,56.6821755174074%,7871,13030,21656,36.3455855190247%,60.16808274843%,8988,16516,25891,34.7147657487158%,63.7905063535592%,0.574814252399805,0.623415147600593,0.64758469259724,18439,20901,25504
2787,43,TEXAS,SAN SABA,618,1691,2333,26.4894984997857%,72.4817831118731%,293,2025,2357,12.4310564276623%,85.9142978362325%,287,2308,2602,11.0299769408148%,88.7009992313605%,0.73235166738848,0.873597929249353,0.889402697495183,2309,2318,2595
2788,43,TEXAS,SCHLEICHER,338,826,1173,28.8150042625746%,70.4177323103154%,208,821,1059,19.6411709159585%,77.5259678942398%,211,940,1159,18.2053494391717%,81.1044003451251%,0.709621993127148,0.797862001943635,0.816681146828845,1164,1029,1151
2789,43,TEXAS,SCURRY,1193,4060,5326,22.399549380398%,76.2298159969959%,733,4410,5289,13.8589525430138%,83.3806012478729%,818,4983,5870,13.9352640545145%,84.8892674616695%,0.772891680944222,0.857476181217188,0.858989829339769,5253,5143,5801
2790,43,TEXAS,SHACKELFORD,264,1066,1347,19.5991091314031%,79.1388270230141%,103,1378,1504,6.84840425531915%,91.6223404255319%,130,1484,1628,7.98525798525798%,91.1547911547912%,0.801503759398496,0.930452397029034,0.919454770755886,1330,1481,1614
2791,43,TEXAS,SHELBY,3227,5692,9005,35.835646862854%,63.2093281510272%,1758,7179,9086,19.3484481620075%,79.0116662998019%,2068,7975,10087,20.5016357688113%,79.062159214831%,0.638188137683597,0.803289694528365,0.794085432639649,8919,8937,10043
2792,43,TEXAS,SHERMAN,144,998,1163,12.3817712811694%,85.8125537403267%,96,807,935,10.2673796791444%,86.3101604278075%,91,886,992,9.17338709677419%,89.3145161290323%,0.873905429071804,0.893687707641196,0.906857727737973,1142,903,977
2793,43,TEXAS,SMITH,16470,43320,60624,27.167458432304%,71.4568487727633%,22300,58930,84768,26.3070970177425%,69.5191581728954%,29615,69080,100089,29.5886660871824%,69.0185734696121%,0.724535875564476,0.725470885140958,0.699934140533968,59790,81230,98695
2794,43,TEXAS,SOMERVELL,752,2120,2918,25.7710760795065%,72.6525017135024%,541,3206,3897,13.8824736977162%,82.2684115986656%,768,4105,4947,15.5245603395998%,82.9795835860117%,0.738161559888579,0.85561782759541,0.842396880771599,2872,3747,4873
2795,43,TEXAS,STARR,6505,1911,8464,76.8549149338374%,22.57797731569%,9289,2224,11740,79.1226575809199%,18.9437819420784%,9123,8247,17525,52.0570613409415%,47.0584878744651%,0.227067490494297,0.193172934943108,0.474784110535406,8416,11513,17370
2796,43,TEXAS,STEPHENS,811,2425,3291,24.6429656639319%,73.6858097842601%,348,3034,3461,10.0548974284889%,87.6625252817105%,397,3385,3800,10.4473684210526%,89.0789473684211%,0.74938195302843,0.897102306327617,0.895029085140137,3236,3382,3782
2797,43,TEXAS,STERLING,132,520,659,20.0303490136571%,78.907435508346%,70,549,633,11.0584518167457%,86.7298578199052%,51,584,639,7.981220657277%,91.3928012519562%,0.797546012269939,0.886914378029079,0.919685039370079,652,619,635
2798,43,TEXAS,STONEWALL,294,496,799,36.7959949937422%,62.0775969962453%,135,555,701,19.2582025677603%,79.1726105563481%,116,615,736,15.7608695652174%,83.5597826086957%,0.627848101265823,0.804347826086956,0.841313269493844,790,690,731
2799,43,TEXAS,SUTTON,468,1063,1540,30.3896103896104%,69.025974025974%,313,1075,1416,22.1045197740113%,75.9180790960452%,322,1222,1557,20.6807964033398%,78.4842646114322%,0.694317439581973,0.774495677233429,0.791450777202073,1531,1388,1544
2800,43,TEXAS,SWISHER,856,1612,2501,34.2263094762095%,64.4542183126749%,462,1671,2204,20.961887477314%,75.8166969147005%,478,1845,2355,20.2972399150743%,78.343949044586%,0.653160453808752,0.783403656821378,0.794231597072751,2468,2133,2323
2801,43,TEXAS,TARRANT,173758,286921,472389,36.7828209378288%,60.7382898416348%,288392,345921,668514,43.1392611074712%,51.7447652554771%,411567,409741,834697,49.3073534468196%,49.0885914289856%,0.6228219649691,0.545347486177959,0.498888358569501,460679,634313,821308
2802,43,TEXAS,TAYLOR,10504,31701,43020,24.416550441655%,73.6889818688982%,10085,33250,45759,22.0393802312113%,72.6633012085054%,14588,39547,55135,26.4586923007164%,71.727577763671%,0.751119535600047,0.7672781816084,0.730525538006835,42205,43335,54135
2803,43,TEXAS,TERRELL,219,243,477,45.9119496855346%,50.9433962264151%,140,288,438,31.9634703196347%,65.7534246575342%,119,334,458,25.9825327510917%,72.9257641921397%,0.525974025974026,0.672897196261682,0.737306843267108,462,428,453
2804,43,TEXAS,TERRY,1108,2910,4054,27.3310310804144%,71.7809570794277%,753,2459,3355,22.4441132637854%,73.2935916542474%,757,2812,3612,20.9579180509413%,77.8516057585825%,0.724240915878547,0.765566625155666,0.787895769123004,4018,3212,3569
2805,43,TEXAS,THROCKMORTON,228,608,842,27.0783847980998%,72.209026128266%,84,715,808,10.3960396039604%,88.490099009901%,82,806,894,9.17225950782998%,90.1565995525727%,0.727272727272727,0.894868585732165,0.907657657657658,836,799,888
2806,43,TEXAS,TITUS,3008,4995,8103,37.1220535604097%,61.6438356164384%,2597,6511,9419,27.5719290795201%,69.126234207453%,2856,7570,10541,27.0942035859975%,71.8148183284318%,0.624140947144821,0.714866051822574,0.726069441780165,8003,9108,10426
2807,43,TEXAS,TOM GREEN,9288,24733,34626,26.8237740426269%,71.4289840004621%,9173,27494,38479,23.8389771043946%,71.4519608097924%,12239,32313,45210,27.0714443707144%,71.4731254147313%,0.726992151906176,0.749829547004118,0.725287304722571,34021,36667,44552
2808,43,TEXAS,TRAVIS,125526,141235,301263,41.6665836826959%,46.8809644729024%,308260,127209,468720,65.7663423792456%,27.139656938044%,435860,161337,608575,71.6197674896274%,26.5106190691369%,0.529443959199433,0.292119530896574,0.270157083843355,266761,435469,597197
2809,43,TEXAS,TRINITY,2142,3093,5297,40.4379837643949%,58.3915423824807%,1154,4737,5985,19.281537176274%,79.1478696741855%,1323,5579,6938,19.0688959354281%,80.4122225425195%,0.590830945558739,0.804107961296893,0.808316430020284,5235,5891,6902
2810,43,TEXAS,TYLER,2775,4236,7116,38.9966273187184%,59.5278246205734%,1248,6624,8016,15.5688622754491%,82.6347305389222%,1403,8194,9660,14.5238095238095%,84.824016563147%,0.604193410355156,0.841463414634146,0.853808481817235,7011,7872,9597
2811,43,TEXAS,UPSHUR,4180,8448,12808,32.6358525921299%,65.9587757651468%,2380,13209,16013,14.8629238743521%,82.4892275026541%,2877,15809,18892,15.2286682193521%,83.6809231420707%,0.668989547038328,0.847328244274809,0.846034464304827,12628,15589,18686
2812,43,TEXAS,UPTON,266,982,1273,20.8955223880597%,77.1406127258445%,286,1007,1347,21.2323682256867%,74.7587230883445%,170,1178,1368,12.4269005847953%,86.1111111111111%,0.786858974358974,0.778808971384377,0.873887240356083,1248,1293,1348
2813,43,TEXAS,UVALDE,3436,4855,8420,40.8076009501188%,57.6603325415677%,3867,4835,8964,43.1392235609103%,53.937974118697%,4073,6174,10344,39.3754833720031%,59.6867749419954%,0.585574719575443,0.555619397839577,0.602517810090758,8291,8702,10247
2814,43,TEXAS,VAL VERDE,5056,6223,11474,44.0648422520481%,54.2356632386265%,6964,5890,13617,51.1419549093045%,43.2547550855548%,6771,8284,15280,44.3128272251309%,54.2146596858639%,0.551733309690575,0.458223121207406,0.550249086682165,11279,12854,15055
2815,43,TEXAS,VAN ZANDT,5245,12383,17891,29.3164160751216%,69.2135710692527%,2799,18473,21890,12.7866605756053%,84.3901324805847%,3516,22270,26029,13.5080102962081%,85.5584156133543%,0.702461992285001,0.868418578412937,0.863646940200109,17628,21272,25786
2816,43,TEXAS,VICTORIA,8176,18787,27408,29.8307063631057%,68.5456800934034%,8866,21275,31123,28.4869710503486%,68.3578061240883%,10380,23358,34188,30.3615303615304%,68.3222183222183%,0.696769647294441,0.705849175541621,0.692335052463098,26963,30141,33738
2817,43,TEXAS,WALKER,4943,9076,14374,34.3884791985529%,63.1417837762627%,6091,12884,19796,30.7688421903415%,65.0838553243079%,7884,15375,23612,33.3898017956971%,65.1151956632221%,0.647407090377345,0.678998682476943,0.661034438281955,14019,18975,23259
2818,43,TEXAS,WALLER,5046,5686,10858,46.4726468962977%,52.3669184011789%,5748,10531,16784,34.2469018112488%,62.7442802669209%,8191,14260,22734,36.0297351983813%,62.7254332717516%,0.52981736861722,0.646907058173106,0.635161017326622,10732,16279,22451
2819,43,TEXAS,WARD,1256,2534,3874,32.4212700051626%,65.4104284976768%,783,2547,3445,22.7285921625544%,73.933236574746%,764,3241,4060,18.8177339901478%,79.8275862068966%,0.668601583113456,0.764864864864865,0.809238451935081,3790,3330,4005
2820,43,TEXAS,WASHINGTON,2996,8645,11809,25.3704801422644%,73.2068761114404%,3382,10945,14828,22.8082007013758%,73.813056379822%,4261,12959,17427,24.4505652148964%,74.3616227692661%,0.742633794347565,0.763942207021707,0.752555168408827,11641,14327,17220
2821,43,TEXAS,WEBB,18120,13076,31571,57.3944442684742%,41.4177568021285%,42307,12947,56905,74.3467182145681%,22.7519550127405%,41820,25898,68397,61.1430325891486%,37.8642338114245%,0.419156302090012,0.234317877438737,0.382438937948551,31196,55254,67718
2822,43,TEXAS,WHARTON,4838,8455,13426,36.0345598093252%,62.9748249664829%,4238,10149,14732,28.7673092587564%,68.8908498506652%,4694,11926,16761,28.0054889326412%,71.1532724777758%,0.636049048371323,0.705428511850977,0.717569193742479,13293,14387,16620
2823,43,TEXAS,WHEELER,579,1787,2389,24.2360820426957%,74.8011720385098%,194,2087,2306,8.41283607979185%,90.5030355594102%,168,2159,2337,7.18870346598203%,92.3833975181857%,0.755283178360101,0.914949583516002,0.927804039535883,2366,2281,2327
2824,43,TEXAS,WICHITA,14108,27802,42713,33.0297567485309%,65.0902535527825%,8770,27631,38119,23.0068994464703%,72.4861617566043%,13161,32069,46040,28.5860121633362%,69.6546481320591%,0.663373896444763,0.759072552951842,0.709020561574176,41910,36401,45230
2825,43,TEXAS,WILBARGER,1356,3138,4577,29.6263928337339%,68.5601922656762%,809,3166,4105,19.7076735688185%,77.1254567600487%,956,3524,4524,21.131741821397%,77.89566755084%,0.69826435246996,0.796477987421384,0.786607142857143,4494,3975,4480
2826,43,TEXAS,WILLACY,3218,1789,5062,63.5717107862505%,35.3417621493481%,3422,1547,5095,67.1638861629048%,30.3631010794897%,3108,2441,5549,56.010091908452%,43.989908091548%,0.357299780307569,0.311330247534715,0.43989908091548,5007,4969,5549
2827,43,TEXAS,WILLIAMSON,26591,65041,95935,27.7177255433366%,67.7969458487518%,84468,104175,203081,41.5932558929688%,51.2972656230765%,143795,139729,289555,49.6606862254149%,48.256462502806%,0.70980661777545,0.5522335840715,0.492829531186072,91632,188643,283524
2828,43,TEXAS,WILSON,3997,7509,11698,34.1682338861344%,64.1904599076765%,4790,13998,19432,24.6500617538081%,72.0358172087279%,6350,18463,25013,25.3867988645904%,73.813616919202%,0.652616026420998,0.745050031935278,0.74408576149599,11506,18788,24813
2829,43,TEXAS,WINKLER,556,1468,2043,27.2148800783162%,71.8551150269212%,420,1403,1876,22.3880597014925%,74.7867803837953%,358,1753,2126,16.8391345249294%,82.4553151458137%,0.725296442687747,0.769610532089962,0.83041212695405,2024,1823,2111
2830,43,TEXAS,WISE,4830,11234,16368,29.5087976539589%,68.6339198435973%,3412,20670,24776,13.7713916693574%,83.4275104940265%,4973,27032,32365,15.3653638189402%,83.5223234976054%,0.699327689243028,0.858317415497052,0.844618028433057,16064,24082,32005
2831,43,TEXAS,WOOD,3893,9810,13884,28.0394698934025%,70.656871218669%,2630,15700,18727,14.0438938431142%,83.8361723714423%,3509,19049,22779,15.4045392686246%,83.6252688880109%,0.715901627380865,0.856519367157665,0.844445429559358,13703,18330,22558
2832,43,TEXAS,YOAKUM,531,1911,2465,21.5415821501014%,77.525354969574%,426,1797,2303,18.4976118106817%,78.0286582718194%,420,2174,2631,15.963511972634%,82.6301786393006%,0.782555282555282,0.808367071524966,0.838087895142637,2442,2223,2594
2833,43,TEXAS,YOUNG,1843,5022,6954,26.5027322404372%,72.2174288179465%,876,6601,7707,11.366290385364%,85.6494096276113%,1034,7110,8239,12.5500667556742%,86.2968806894041%,0.731536780772032,0.882840711515314,0.87303536345776,6865,7477,8144
2834,43,TEXAS,ZAPATA,1638,953,2616,62.6146788990826%,36.4296636085627%,2063,1029,3142,65.6588160407384%,32.7498408656906%,1826,2033,3874,47.1347444501807%,52.4780588538978%,0.367811655731378,0.332794307891332,0.526820419797875,2591,3092,3859
2835,43,TEXAS,ZAVALA,2616,751,3391,77.1453848422294%,22.1468593335299%,2636,694,3396,77.620730270907%,20.4358068315665%,2864,1490,4379,65.4030600593743%,34.0260333409454%,0.223047223047223,0.208408408408408,0.342214056040423,3367,3330,4354
2837,44,UTAH,BEAVER,541,1653,2252,24.0230905861456%,73.4014209591474%,264,1838,2491,10.5981533520674%,73.7856282617423%,357,2695,3100,11.5161290322581%,86.9354838709677%,0.753418413855971,0.874405328258801,0.88302752293578,2194,2102,3052
2838,44,UTAH,BOX ELDER,2555,12288,15483,16.5019699024737%,79.3644642511141%,2282,12230,19735,11.5632125665062%,61.9711173042817%,4473,21548,27023,16.5525663323835%,79.7394811826962%,0.827864986862494,0.842750826901874,0.828100380461935,14843,14512,26021
2839,44,UTAH,CACHE,5170,25920,33142,15.5995413674492%,78.2089191961861%,8563,21139,46157,18.5518989535715%,45.7980371341292%,16650,38032,58358,28.5307926933754%,65.1701566194866%,0.833708587970408,0.711702915628577,0.695512234373286,31090,29702,54682
2840,44,UTAH,CARBON,3298,3758,7384,44.6641386782232%,50.8938244853738%,1717,5275,7952,21.5920523138833%,66.3355130784708%,2392,6693,9369,25.5310065108336%,71.4377201408902%,0.532596371882086,0.754433638443936,0.736708860759494,7056,6992,9085
2841,44,UTAH,DAGGETT,104,317,435,23.9080459770115%,72.8735632183908%,77,331,474,16.2447257383966%,69.831223628692%,111,496,619,17.9321486268174%,80.1292407108239%,0.752969121140142,0.811274509803921,0.817133443163097,421,408,607
2842,44,UTAH,DAVIS,18845,64375,87855,21.4501166695123%,73.2741448978431%,28776,62219,138411,20.7902551097817%,44.9523520529438%,57411,104135,169814,33.8081665822606%,61.3229769041422%,0.773552030761836,0.683762844112314,0.644615156054622,83220,90995,161546
2843,44,UTAH,DUCHESNE,779,3622,4546,17.1359436867576%,79.6744390673119%,500,5508,6942,7.20253529242293%,79.343128781331%,843,7512,8561,9.84698049293307%,87.7467585562434%,0.822994773915019,0.916777629826897,0.899102333931777,4401,6008,8355
2844,44,UTAH,EMERY,958,3243,4398,21.7826284674852%,73.7380627557981%,380,3425,4289,8.859874096526%,79.8554441594777%,572,4207,4898,11.6782360146999%,85.8922008983258%,0.771959057367294,0.900131406044678,0.880309688219293,4201,3805,4779
2845,44,UTAH,GARFIELD,178,1719,1968,9.04471544715447%,87.3475609756098%,358,1606,2344,15.2730375426621%,68.5153583617747%,514,2158,2732,18.814055636896%,78.9897510980966%,0.906167633104902,0.817718940936864,0.807634730538922,1897,1964,2672
2846,44,UTAH,GRAND,1158,1822,3614,32.0420586607637%,50.415052573326%,1960,1975,4533,43.238473417163%,43.5693801014781%,2806,2248,5185,54.1176470588235%,43.3558341369335%,0.611409395973154,0.501905972045743,0.444796201028888,2980,3935,5054
2847,44,UTAH,IRON,1789,10106,12594,14.2051770684453%,80.2445609020169%,2450,11561,17654,13.877874702617%,65.4865752803897%,4892,18989,25104,19.4869343530911%,75.6413320586361%,0.849600672551492,0.825137392049104,0.795150956827604,11895,14011,23881
2848,44,UTAH,JUAB,619,2023,2785,22.2262118491921%,72.6391382405745%,442,2827,4177,10.5817572420397%,67.6801532200144%,645,5087,5865,10.997442455243%,86.7348678601875%,0.765707797123391,0.86479045579688,0.887473831123517,2642,3269,5732
2849,44,UTAH,KANE,387,2254,2802,13.8115631691649%,80.4425410421128%,741,2265,3505,21.1412268188302%,64.6219686162625%,1083,2998,4180,25.9090909090909%,71.7224880382775%,0.853464596743658,0.753493013972056,0.734623866699338,2641,3006,4081
2850,44,UTAH,MILLARD,696,3850,4775,14.5759162303665%,80.6282722513089%,431,3860,5242,8.22205265165967%,73.6360167874857%,624,5404,6190,10.0807754442649%,87.3021001615509%,0.846898372195337,0.899557212770916,0.896483078964831,4546,4291,6028
2851,44,UTAH,MORGAN,553,2464,3171,17.439293598234%,77.7041942604857%,577,3188,5192,11.113251155624%,61.402157164869%,1086,5181,6606,16.4396003633061%,78.4287011807448%,0.816705336426914,0.846746347941567,0.826711345141216,3017,3765,6267
2852,44,UTAH,PIUTE,133,626,781,17.0294494238156%,80.1536491677337%,47,626,729,6.44718792866941%,85.8710562414266%,86,773,871,9.87370838117107%,88.7485648679678%,0.824769433465086,0.930163447251114,0.89988358556461,759,673,859
2853,44,UTAH,RICH,152,736,903,16.8327796234773%,81.5060908084164%,104,797,1109,9.37781785392245%,71.8665464382326%,180,1157,1369,13.1482834185537%,84.5142439737034%,0.828828828828829,0.88457269700333,0.865370231862378,888,901,1337
2854,44,UTAH,SALT LAKE,107576,171585,307258,35.0116189000775%,55.8439487336375%,175863,138043,418868,41.9853032458913%,32.9562057736566%,289906,230174,546581,53.039897105827%,42.1115991957276%,0.614645312203352,0.439759036144578,0.442574219350869,279161,313906,520080
2855,44,UTAH,SAN JUAN,1838,2721,4744,38.743676222597%,57.3566610455312%,2042,2645,5447,37.4885257940151%,48.5588397282908%,3113,3535,6877,45.2668314672095%,51.4032281518104%,0.59684141259048,0.564326861531897,0.531738868832732,4559,4687,6648
2856,44,UTAH,SANPETE,1211,5781,7430,16.2987886944818%,77.8061911170929%,1061,6673,10164,10.4388036206218%,65.6532861078316%,1794,10459,12625,14.209900990099%,82.8435643564356%,0.826802059496568,0.862813550555986,0.853586876683261,6992,7734,12253
2857,44,UTAH,SEVIER,1046,5763,7077,14.7802741274551%,81.4328105129292%,695,6740,8654,8.03096833834065%,77.8830598567137%,1084,9052,10362,10.4613009071608%,87.3576529627485%,0.846379791452489,0.906523201075992,0.893054459352802,6809,7435,10136
2858,44,UTAH,SUMMIT,4601,6168,12121,37.9589142809999%,50.8868905205841%,10503,7333,20641,50.8841625890219%,35.5263795358752%,15244,10252,26086,58.4374760407882%,39.3007743617266%,0.572755130467082,0.411134783583763,0.402102290555381,10769,17836,25496
2859,44,UTAH,TOOELE,4001,7807,12480,32.0592948717949%,62.5560897435898%,4573,11169,21829,20.9491960236383%,51.1658802510422%,8943,21014,31506,28.3850695105694%,66.6984066527011%,0.661161924119241,0.709503239740821,0.701472110024368,11808,15742,29957
2860,44,UTAH,UINTAH,1387,6733,8397,16.5178039776111%,80.1833988329165%,995,9810,12797,7.77525982652184%,76.6585918574666%,1663,13261,15303,10.8671502319807%,86.6562112004182%,0.829187192118227,0.907913003239241,0.888568748324846,8120,10805,14924
2861,44,UTAH,UTAH,16445,98255,120256,13.6749933475253%,81.7048629590208%,28522,102182,201551,14.1512570019499%,50.6978382642607%,76033,192812,284286,26.7452495022618%,67.8232484188458%,0.856625980819529,0.781781735830579,0.717186482917666,114700,130704,268845
2862,44,UTAH,WASATCH,1476,3819,5675,26.0088105726872%,67.295154185022%,3063,6115,12120,25.2722772277228%,50.453795379538%,6187,10795,17790,34.7779651489601%,60.6801573917931%,0.721246458923513,0.666267160601438,0.635673065598869,5295,9178,16982
2863,44,UTAH,WASHINGTON,5465,25481,32461,16.8355873201688%,78.4972736514587%,10288,42650,61963,16.6034569016994%,68.8313993835031%,20530,67294,91070,22.543098715274%,73.8926100801581%,0.823402055192917,0.805659450678152,0.766237019493533,30946,52938,87824
2864,44,UTAH,WAYNE,202,953,1225,16.4897959183674%,77.7959183673469%,271,966,1421,19.0710767065447%,67.9802955665025%,365,1229,1621,22.5169648365207%,75.817396668723%,0.825108225108225,0.780921584478577,0.771016311166876,1155,1237,1594
2865,44,UTAH,WEBER,19890,39254,62742,31.7012527493545%,62.5641516049855%,23131,40235,85039,27.200460964969%,47.3135855313444%,40695,65949,111403,36.5295369065465%,59.1985853163739%,0.663702150683079,0.63496196698545,0.618403285698211,59144,63366,106644
2867,45,VERMONT,ADDISON,8936,6953,17427,51.2767544614678%,39.8978596430826%,11219,5297,19031,58.951184908833%,27.8335347590773%,15089,6567,22611,66.7330060589978%,29.0433859625846%,0.437598338473158,0.320719302494551,0.303241595862578,15889,16516,21656
2868,45,VERMONT,BENNINGTON,9021,7284,17677,51.0324150025457%,41.2060870057136%,9539,5925,17381,54.8817674472125%,34.0889477015131%,11858,6724,19357,61.259492689983%,34.7367877253707%,0.446734130634775,0.383147956544232,0.361855559143257,16305,15464,18582
2869,45,VERMONT,CALEDONIA,5859,6746,13641,42.9513965251814%,49.4538523568653%,6445,5534,14075,45.7904085257549%,39.3179396092362%,8529,5924,15158,56.2673175880723%,39.0816730439372%,0.535184450614835,0.461975123132148,0.409880301667474,12605,11979,14453
2870,45,VERMONT,CHITTENDEN,39156,26105,72017,54.3704958551453%,36.2483857977977%,54814,18601,83418,65.7100386007816%,22.2985446786065%,72938,20104,96755,75.3842178698775%,20.7782543537802%,0.400009193852377,0.253367840359599,0.216074460996109,65261,73415,93042
2871,45,VERMONT,ESSEX,1129,1564,2892,39.0387275242047%,54.0802213001383%,1019,1506,2925,34.8376068376068%,51.4871794871795%,1890,2164,4237,44.6070332782629%,51.0738730233656%,0.580764946156703,0.596435643564356,0.533793783917119,2693,2525,4054
2872,45,VERMONT,FRANKLIN,9514,8395,19194,49.5675731999583%,43.7376263415651%,9351,8752,21411,43.6738125262716%,40.8761851384802%,13612,11274,26072,52.2092666462105%,43.2417919607241%,0.468758724663577,0.483455780809811,0.453025797637226,17909,18103,24886
2873,45,VERMONT,GRAND ISLE,1835,1550,3638,50.4398020890599%,42.60582737768%,2094,1487,4110,50.9489051094891%,36.1800486618005%,3346,2194,5782,57.8692493946731%,37.9453476305776%,0.457902511078287,0.415247137671042,0.396028880866426,3385,3581,5540
2874,45,VERMONT,LAMOILLE,5676,4456,11246,50.4712786768629%,39.6229770585097%,7241,3570,12762,56.7387556809278%,27.9736718382699%,10773,4171,15679,68.7097391415269%,26.6024618917023%,0.439794709830241,0.33021922116363,0.279108672376874,10132,10811,14944
2875,45,VERMONT,ORANGE,6694,6858,14695,45.5529091527731%,46.6689350119088%,7541,5007,14649,51.4779165813366%,34.1798074953922%,8351,5782,14876,56.1374025275612%,38.8679752621672%,0.506050767414404,0.399027733503347,0.409113422486379,13552,12548,14133
2876,45,VERMONT,ORLEANS,5472,5799,12132,45.1038575667656%,47.7992087042532%,5185,5159,12047,43.0397609363327%,42.8239395700174%,7757,7086,15442,50.2331304235203%,45.8878383629064%,0.514506254990684,0.498743232791957,0.47739675267803,11271,10344,14843
2877,45,VERMONT,RUTLAND,13990,13546,29362,47.6466180777876%,46.1344595054833%,13635,12479,29619,46.0346399270738%,42.1317397616395%,18746,14625,34772,53.9111929138387%,42.0597032094789%,0.491937826844858,0.477866278624493,0.438254772107519,27536,26114,33371
2878,45,VERMONT,WASHINGTON,15281,11448,29749,51.3664324851255%,38.4819657803624%,18594,7993,31086,59.8147075854082%,25.7125394068069%,25101,8707,35325,71.0573248407643%,24.6482661004954%,0.428298851434771,0.300635649001392,0.257542593469001,26729,26587,33808
2879,45,VERMONT,WINDHAM,11319,7358,21491,52.6685589316458%,34.2375878274627%,14340,5454,22635,63.3532140490391%,24.0954274353877%,20057,7251,28452,70.4941656122592%,25.485027414593%,0.393960486159447,0.275538041830858,0.265526585615937,18677,19794,27308
2880,45,VERMONT,WINDSOR,15140,11713,29147,51.9435962534738%,40.1859539575256%,17556,8605,29928,58.6607858861267%,28.7523389468057%,24779,10135,36308,68.2466674011237%,27.9139583562851%,0.436189624995345,0.328924735292993,0.290284699547459,26853,26161,34914
2882,46,VIRGINIA,ACCOMACK,5092,6352,11925,42.7002096436059%,53.2662473794549%,6740,8583,15818,42.609685168795%,54.2609685168795%,7578,9172,16962,44.6763353378139%,54.0738120504657%,0.555050681579867,0.560138354108203,0.547582089552239,11444,15323,16750
2883,46,VIRGINIA,ALBEMARLE,16255,18291,36846,44.1160505889377%,49.6417521576291%,33345,19259,56726,58.7825688396855%,33.9509219758136%,42466,20804,64657,65.6788901433719%,32.1759438266545%,0.529467955769119,0.3661128431298,0.328813023549866,34546,52604,63270
2884,46,VIRGINIA,ALEXANDRIA,33633,19043,55199,60.9304516386167%,34.4988133843004%,57242,13285,75770,75.5470502837535%,17.5333245347763%,66240,14544,82521,80.2704766059548%,17.6246046460901%,0.361511883969929,0.188367575538446,0.180035650623886,52676,70527,80784
2885,46,VIRGINIA,ALLEGHANY,2214,2808,5123,43.2168651180949%,54.8116338083154%,2166,4874,7325,29.5699658703072%,66.5392491467577%,2243,5859,8203,27.3436547604535%,71.4250883822992%,0.559139784946237,0.692329545454546,0.723154776598371,5022,7040,8102
2886,46,VIRGINIA,AMELIA,1754,2947,4788,36.6332497911445%,61.5497076023392%,2128,4708,7040,30.2272727272727%,66.875%,2411,5390,7894,30.5421839371675%,68.2797061059032%,0.6268878961923,0.688706846108836,0.690937059351365,4701,6836,7801
2887,46,VIRGINIA,AMHERST,4812,6660,11712,41.0860655737705%,56.8647540983607%,5057,9719,15396,32.8461938165757%,63.1267861782281%,5672,11041,17005,33.3548956189356%,64.9279623640106%,0.580543933054393,0.657755820249053,0.660623466762401,11472,14776,16713
2888,46,VIRGINIA,APPOMATTOX,2132,3654,5927,35.9709802598279%,61.6500759237388%,2023,5715,8011,25.2527774310323%,71.3394083135688%,2418,6702,9268,26.0897712559344%,72.3133362106172%,0.631524369166955,0.738562936159214,0.734868421052632,5786,7738,9120
2889,46,VIRGINIA,ARLINGTON,50260,28555,83559,60.1491161933484%,34.1734582749913%,92016,20186,121356,75.8231978641353%,16.6337057912258%,105344,22318,130739,80.5758037005025%,17.0706522154828%,0.362304129924507,0.179907666530008,0.17482101173411,78815,112202,127662
2890,46,VIRGINIA,AUGUSTA,6643,17744,25271,26.2870483953939%,70.2148708005223%,8177,26163,36343,22.4995184767355%,71.9891038164158%,10840,30714,42278,25.6398126685274%,72.6477127584086%,0.72760077090253,0.761881188118812,0.739134620012514,24387,34340,41554
2891,46,VIRGINIA,BATH,822,1311,2210,37.1945701357466%,59.3212669683258%,603,1548,2253,26.7643142476698%,68.7083888149135%,646,1834,2501,25.8296681327469%,73.3306677329068%,0.614627285513361,0.719665271966527,0.739516129032258,2133,2151,2480
2892,46,VIRGINIA,BEDFORD,9238,18493,28590,32.3119972018188%,64.6834557537601%,9768,30659,42525,22.9700176366843%,72.0964138741917%,12176,35600,48669,25.0179785900676%,73.1471778750334%,0.666871010782157,0.758379300962228,0.745144005358339,27731,40427,47776
2893,46,VIRGINIA,BLAND,851,1759,2688,31.6592261904762%,65.4389880952381%,453,2573,3139,14.4313475629181%,81.9687798661994%,532,2903,3479,15.2917505030181%,83.4435182523714%,0.673946360153257,0.850297422339722,0.845123726346434,2610,3026,3435
2894,46,VIRGINIA,BOTETOURT,4627,8867,13840,33.4320809248555%,64.0679190751445%,4494,13375,18739,23.982069480762%,71.3752067879823%,5700,15099,21123,26.9848032949865%,71.4813236756143%,0.657106862309175,0.748502994011976,0.725948362902063,13494,17869,20799
2895,46,VIRGINIA,BRISTOL,2646,3495,6279,42.1404682274248%,55.6617295747731%,1835,4892,7032,26.0949943117179%,69.5676905574516%,2313,5347,7814,29.6007166624008%,68.4284617353468%,0.569125549584758,0.727218671027204,0.698041775456919,6141,6727,7660
2896,46,VIRGINIA,BRUNSWICK,3387,2561,5997,56.4782391195598%,42.7046856761714%,4481,3046,7669,58.4300430303821%,39.7183465901682%,4552,3357,7948,57.2722697533971%,42.2370407649723%,0.430564895763282,0.404676497940747,0.424453154633961,5948,7527,7909
2897,46,VIRGINIA,BUCHANAN,5745,3867,9856,58.2893668831169%,39.2349837662338%,1721,7296,9247,18.6114415486104%,78.9012652752244%,1587,8311,9957,15.9385357035252%,83.4689163402631%,0.40230961298377,0.809138294332927,0.839664578702768,9612,9017,9898
2898,46,VIRGINIA,BUCKINGHAM,2561,2738,5454,46.956362302897%,50.2016868353502%,3128,3950,7295,42.8786840301576%,54.1466758053461%,3471,4544,8129,42.6989789642022%,55.8986345183909%,0.516701264389508,0.558067250635773,0.566936993137866,5299,7078,8015
2899,46,VIRGINIA,BUENA VISTA,941,980,1975,47.6455696202532%,49.620253164557%,693,1430,2407,28.7910261736602%,59.41005400914%,825,1863,2776,29.7190201729107%,67.1109510086455%,0.510150963040083,0.673575129533679,0.693080357142857,1921,2123,2688
2900,46,VIRGINIA,CAMPBELL,6659,13162,20327,32.7593840704482%,64.751315983667%,6664,19551,27535,24.2019248229526%,71.004176502633%,8070,21245,29901,26.989063910906%,71.0511354135313%,0.664043186519348,0.745794392523364,0.724714310080164,19821,26215,29315
2901,46,VIRGINIA,CAROLINE,4314,3873,8351,51.6584840138906%,46.3776793198419%,6432,7147,14863,43.2752472582924%,48.0858507703694%,7657,8336,16288,47.010068762279%,51.1787819253438%,0.473067057530231,0.526327417335592,0.521228037266304,8187,13579,15993
2902,46,VIRGINIA,CARROLL,3638,7142,11001,33.0697209344605%,64.9213707844741%,2559,10663,13668,18.7225636523266%,78.014340064384%,2842,12659,15657,18.1516254710353%,80.8520150731302%,0.66252319109462,0.806458932082892,0.816656989871621,10780,13222,15501
2903,46,VIRGINIA,CHARLES CITY,1981,1023,3066,64.6118721461187%,33.3659491193738%,2496,1476,4107,60.7742878013148%,35.9386413440467%,2624,1761,4441,59.0857914884035%,39.653231254222%,0.340545938748336,0.371601208459214,0.401596351197263,3004,3972,4385
2904,46,VIRGINIA,CHARLOTTE,2017,2855,4994,40.3884661593913%,57.1686023227873%,2155,3479,5808,37.1039944903581%,59.9001377410468%,2317,3815,6191,37.4252947827492%,61.6217089323211%,0.586001642036125,0.617500887468939,0.622146118721461,4872,5634,6132
2905,46,VIRGINIA,CHARLOTTESVILLE,7762,4034,13224,58.6963097398669%,30.5051421657592%,17901,2960,22472,79.6591313634746%,13.1719473122108%,20696,3094,24213,85.4747449717094%,12.7782596126048%,0.341980332316039,0.141891567997699,0.130054644808743,11796,20861,23790
2906,46,VIRGINIA,CHESAPEAKE,33578,39684,74585,45.019776094389%,53.2064087953342%,52627,54047,112705,46.6944678585688%,47.954394214986%,66377,58180,127246,52.1643116483033%,45.7224588592176%,0.541672354017089,0.506655792414272,0.467095386048155,73262,106674,124557
2907,46,VIRGINIA,CHESTERFIELD,38638,69924,110951,34.8243819343674%,63.0224153004479%,81074,85045,176461,45.9444296473442%,48.1947852499986%,106935,93326,203955,52.4306832389498%,45.7581329214778%,0.644092776477957,0.511952275176229,0.466021841496847,108562,166119,200261
2908,46,VIRGINIA,CLARKE,2166,2883,5284,40.9916729750189%,54.5609386828161%,3051,4661,8213,37.1484232314623%,56.7514915378059%,3920,5192,9337,41.9835064795973%,55.6067259290993%,0.571004159239453,0.604382780082988,0.569798068481124,5049,7712,9112
2909,46,VIRGINIA,COLONIAL HEIGHTS,2100,5519,7782,26.9853508095605%,70.9200719609355%,2367,5681,8457,27.9886484568996%,67.1751212013717%,2972,6007,9160,32.4454148471616%,65.5786026200873%,0.724373277332983,0.705889662027833,0.669005457177859,7619,8048,8979
2910,46,VIRGINIA,COVINGTON,1168,966,2214,52.7551942186089%,43.6314363143631%,914,1349,2382,38.3711167086482%,56.6330814441646%,964,1580,2603,37.0341913177103%,60.6991932385709%,0.452671040299906,0.596111356606275,0.621069182389937,2134,2263,2544
2911,46,VIRGINIA,CRAIG,851,1580,2493,34.1355796229442%,63.3774568792619%,541,2140,2794,19.3629205440229%,76.5926986399427%,587,2536,3170,18.5173501577287%,80%,0.649938296997121,0.798209623274897,0.812039705411463,2431,2681,3123
2912,46,VIRGINIA,CULPEPER,4364,7440,12244,35.6419470761189%,60.7644560601111%,7759,13349,22218,34.9221352056891%,60.0819155639572%,10617,16012,27116,39.154005015489%,59.0500073757191%,0.630294815316842,0.632414250521129,0.601299335311127,11804,21108,26629
2913,46,VIRGINIA,CUMBERLAND,1405,1974,3507,40.0627316794982%,56.2874251497006%,2036,2697,4906,41.5002038320424%,54.9735018344884%,2227,3019,5313,41.9160549595332%,56.8228872576699%,0.584196507842557,0.569828861187408,0.575486084635913,3379,4733,5246
2914,46,VIRGINIA,DANVILLE,8221,9427,18307,44.9063199868903%,51.4939640574644%,11059,7303,18952,58.3526804558886%,38.5341916420431%,11710,7428,19456,60.1870888157895%,38.1784539473684%,0.534168177697189,0.397723559525106,0.388128331069077,17648,18362,19138
2915,46,VIRGINIA,DICKENSON,3951,3122,7226,54.6775532798229%,43.2050927207307%,1335,4932,6440,20.7298136645963%,76.583850931677%,1503,5748,7307,20.5693170931983%,78.6642945121117%,0.441396861303549,0.786979415988511,0.792718245759206,7073,6267,7251
2916,46,VIRGINIA,DINWIDDIE,4001,4959,9136,43.7937828371279%,54.2797723292469%,5765,7447,13575,42.4677716390424%,54.8581952117864%,6224,8695,15092,41.2403922608004%,57.6133050622847%,0.553459821428571,0.56365425370875,0.582813861518869,8960,13212,14919
2917,46,VIRGINIA,EMPORIA,1116,938,2080,53.6538461538462%,45.0961538461539%,1530,789,2367,64.638783269962%,33.3333333333333%,1612,754,2384,67.6174496644295%,31.6275167785235%,0.456669912366115,0.340232858990944,0.318681318681319,2054,2319,2366
2918,46,VIRGINIA,ESSEX,1750,1995,3831,45.6799791177238%,52.0751761942052%,2542,2657,5408,47.0044378698225%,49.1309171597633%,3038,3075,6178,49.1744901262545%,49.7733894464228%,0.532710280373832,0.511059819195999,0.503026337313921,3745,5199,6113
2919,46,VIRGINIA,FAIRFAX,200862,206943,423331,47.4479780597216%,48.8844426701565%,362500,161412,563213,64.3628609424853%,28.6591396150302%,9174,4007,13487,68.021057314451%,29.7100911989323%,0.507455769301504,0.308089908228863,0.303998179197329,407805,523912,13181
2920,46,VIRGINIA,FALLS CHURCH,3109,2131,5593,55.5873413195065%,38.1011979259789%,5819,1324,7757,75.0161144772464%,17.0684542993425%,7146,1490,8819,81.0295951921987%,16.8953396076653%,0.406679389312977,0.185356292874143,0.172533580361278,5240,7143,8636
2921,46,VIRGINIA,FAUQUIER,8296,14456,23481,35.3306929006431%,61.5646693070994%,12971,22127,37467,34.6197987562388%,59.0573037606427%,17565,25106,43671,40.221199422958%,57.4889514780976%,0.635372714486639,0.630434782608696,0.588362119472241,22752,35098,42671
2922,46,VIRGINIA,FLOYD,1957,3423,5739,34.1000174246384%,59.6445373758495%,2300,5293,8051,28.5678797664886%,65.7433859147932%,3004,6225,9412,31.9167020824479%,66.1389715257119%,0.636245353159851,0.697089424469907,0.674504279986997,5380,7593,9229
2923,46,VIRGINIA,FLUVANNA,3431,4962,8706,39.4096025729382%,56.9951757408684%,5760,7025,13597,42.3622857983379%,51.6658086342576%,7414,8155,15846,46.7878328915815%,51.4640918843872%,0.591206958179435,0.549472037543997,0.523797289485516,8393,12785,15569
2924,46,VIRGINIA,FRANKLIN,8908,12618,22020,40.4541326067212%,57.3024523160763%,9776,19990,31041,31.493830739989%,64.3986984955382%,8381,20895,29704,28.2150552114193%,70.3440614058713%,0.58617485831088,0.671571591748975,0.713724552534499,21526,29766,29276
2925,46,VIRGINIA,FREDERICK,7158,14574,22392,31.9667738478028%,65.085744908896%,11932,26083,40440,29.5054401582591%,64.498021760633%,2525,1487,4064,62.130905511811%,36.5895669291339%,0.670623964660409,0.686123898461134,0.370638085742772,21732,38015,4012
2926,46,VIRGINIA,FREDERICKSBURG,3360,2935,6681,50.2918724741805%,43.9305493189642%,6707,3744,11264,59.5436789772727%,33.2386363636364%,8517,4037,12877,66.1411819523181%,31.3504698299293%,0.466243050039714,0.358243230312889,0.321570814083161,6295,10451,12554
2927,46,VIRGINIA,GALAX,996,1160,2213,45.0067781292363%,52.417532760958%,681,1603,2376,28.6616161616162%,67.46632996633%,777,1838,2639,29.4429708222812%,69.6475937855248%,0.538033395176252,0.701838879159369,0.702868068833652,2156,2284,2615
2928,46,VIRGINIA,GILES,3004,3574,6820,44.0469208211144%,52.4046920821114%,1950,5910,8212,23.7457379444715%,71.9678519240136%,2156,6876,9178,23.4909566354326%,74.9182828502942%,0.543326238978413,0.751908396946565,0.761293179805137,6578,7860,9032
2929,46,VIRGINIA,GLOUCESTER,4553,8718,13699,33.236002627929%,63.6396817285933%,5404,13096,19619,27.5447270503084%,66.7516183291707%,6964,14875,22284,31.2511218811703%,66.751929635613%,0.656921106171351,0.707891891891892,0.681120930445533,13271,18500,21839
2930,46,VIRGINIA,GOOCHLAND,3197,5378,8777,36.424746496525%,61.2737837529908%,4889,8384,14037,34.8293794970435%,59.7278620787918%,6685,9966,16952,39.4348749410099%,58.7895233600755%,0.627172011661808,0.631658253597529,0.598522611254579,8575,13273,16651
2931,46,VIRGINIA,GRAYSON,2467,4236,6852,36.0040863981319%,61.8213660245184%,1407,5592,7285,19.3136582017845%,76.7604667124228%,1535,6529,8131,18.8783667445579%,80.2976263682204%,0.631955840668357,0.798971281611659,0.809647817460317,6703,6999,8064
2932,46,VIRGINIA,GREENE,1774,3375,5412,32.7790096082779%,62.3614190687361%,2924,5945,9608,30.4329725228976%,61.8755203996669%,4163,6866,11313,36.7983735525502%,60.6912401661805%,0.655467080986599,0.670312323824557,0.622540574848128,5149,8869,11029
2933,46,VIRGINIA,GREENSVILLE,2314,1565,3906,59.242191500256%,40.0665642601127%,2558,1737,4363,58.6293834517534%,39.8120559248224%,2627,1914,4574,57.4333187581985%,41.8452120682116%,0.403454498582109,0.40442374854482,0.421493063201938,3879,4295,4541
2934,46,VIRGINIA,HALIFAX,5963,7732,14072,42.374928936896%,54.9459920409324%,6897,9704,17001,40.5682018704782%,57.0789953532145%,7666,10418,18248,42.0100832967997%,57.0911880754055%,0.564585615188025,0.584543099813264,0.576089360760894,13695,16601,18084
2935,46,VIRGINIA,HAMPTON,27490,19561,47887,57.4059765698415%,40.8482469146115%,41312,17902,62356,66.25184424915%,28.7093463339534%,46220,18430,65957,70.0759585790743%,27.9424473520627%,0.415740366835987,0.302327152362617,0.28507347254447,47051,59214,64650
2936,46,VIRGINIA,HANOVER,12044,28614,41585,28.9623662378261%,68.8084645905976%,19382,39630,62753,30.8861727726164%,63.152359249757%,25307,44318,70988,35.6496872710881%,62.4302699047726%,0.703772935215702,0.671558327119908,0.636524236983842,40658,59012,69625
2937,46,VIRGINIA,HARRISONBURG,3482,5741,9958,34.9668608154248%,57.6521389837317%,10212,6262,17993,56.7554048796754%,34.802423164564%,11022,5591,17093,64.4825367109343%,32.7092962031241%,0.622465575192454,0.380114119218162,0.336543670619394,9223,16474,16613
2938,46,VIRGINIA,HENRICO,48645,62887,114252,42.5769351958828%,55.0423624969366%,93935,59857,163654,57.3985359355714%,36.5753357693671%,116572,63440,183299,63.5966371884189%,34.6101178948058%,0.563847147007137,0.389207501040366,0.352420949714463,111532,153792,180012
2939,46,VIRGINIA,HENRY,8898,11870,21463,41.4573917905232%,55.3044774728603%,8198,15208,24106,34.0081307558284%,63.0880278768771%,9127,16725,26105,34.9626508331737%,64.0681861712316%,0.571552388289677,0.64974792788174,0.64695187993192,20768,23406,25852
2940,46,VIRGINIA,HIGHLAND,453,942,1437,31.5240083507307%,65.553235908142%,371,958,1391,26.6714593817398%,68.8713156002876%,417,1092,1533,27.2015655577299%,71.2328767123288%,0.675268817204301,0.72084273890143,0.723658051689861,1395,1329,1509
2941,46,VIRGINIA,HOPEWELL,3024,3749,6978,43.3361994840929%,53.7259959873889%,4724,3885,9008,52.4422735346359%,43.1283303730018%,5430,4020,9628,56.3980058163689%,41.7532197756543%,0.553521334711354,0.451271924729934,0.425396825396825,6773,8609,9450
2942,46,VIRGINIA,ISLE OF WIGHT,5162,7587,12950,39.8610038610039%,58.5868725868726%,7881,12204,21075,37.3950177935943%,57.9074733096085%,9399,13707,23456,40.0707708049113%,58.4370736698499%,0.595105498470468,0.607617625093353,0.593222539600104,12749,20085,23106
2943,46,VIRGINIA,JAMES CITY,9090,14628,24492,37.1141597256247%,59.7256246937776%,19105,21306,43173,44.2521946586987%,49.3502883746786%,25553,23153,49639,51.4776687685086%,46.6427607324886%,0.616746774601568,0.527232684170152,0.475362378351743,23718,40411,48706
2944,46,VIRGINIA,KING AND QUEEN,1387,1423,2859,48.5134662469395%,49.7726477789437%,1468,2099,3697,39.707871246957%,56.7757641330809%,1590,2450,4115,38.6391251518834%,59.5382746051033%,0.506405693950178,0.588449677600224,0.606435643564356,2810,3567,4040
2945,46,VIRGINIA,KING GEORGE,2070,3590,5852,35.3725222146275%,61.3465481886535%,4007,7341,12059,33.2282942200846%,60.8756945020317%,5404,8446,14227,37.9841147114641%,59.3659942363112%,0.634275618374558,0.646898131829397,0.609819494584838,5660,11348,13850
2946,46,VIRGINIA,KING WILLIAM,2125,3547,5769,36.8348067256024%,61.4837926850407%,2760,5975,9161,30.1277153149219%,65.2221373212531%,3260,7320,10737,30.3622985936481%,68.1754680078234%,0.625352609308886,0.684029765311963,0.69187145557656,5672,8735,10580
2947,46,VIRGINIA,LANCASTER,1937,3411,5455,35.5087076076994%,62.5297891842347%,2869,3523,6645,43.1753197893153%,53.0173062452972%,3368,3697,7152,47.0917225950783%,51.6918344519016%,0.637808526551982,0.551157697121402,0.523283793347488,5348,6392,7065
2948,46,VIRGINIA,LEE,4031,4551,8748,46.0791037951532%,52.0233196159122%,1627,7543,9399,17.3103521651239%,80.2532184274923%,1489,8365,9947,14.9693374886901%,84.0957072484166%,0.530295968305756,0.82257360959651,0.848893850213111,8582,9170,9854
2949,46,VIRGINIA,LEXINGTON,1048,957,2140,48.9719626168224%,44.7196261682243%,1514,766,2465,61.4198782961461%,31.0750507099392%,1791,906,2764,64.7973950795948%,32.7785817655572%,0.477306733167082,0.335964912280702,0.335928809788654,2005,2280,2697
2950,46,VIRGINIA,LOUDOUN,30938,42453,75653,40.8946109209152%,56.1154217281536%,100795,69949,183097,55.0500554350972%,38.2032474589971%,138372,82088,224976,61.5052272242373%,36.4874475499609%,0.578449673665708,0.409671789345453,0.372348725392361,73391,170744,220460
2951,46,VIRGINIA,LOUISA,4309,5461,10096,42.6802694136292%,54.0907290015848%,6212,10528,17631,35.2333957234417%,59.7130055016732%,8269,13294,21916,37.730425260084%,60.658879357547%,0.558955987717503,0.628912783751493,0.616519037239716,9770,16740,21563
2952,46,VIRGINIA,LUNENBURG,2026,2510,4591,44.1298192115008%,54.6721847092137%,2227,3204,5586,39.8675259577515%,57.3576799140709%,2418,3537,6002,40.2865711429523%,58.9303565478174%,0.553350970017637,0.589946602835574,0.593954659949622,4536,5431,5955
2953,46,VIRGINIA,LYNCHBURG,10374,12518,23506,44.133412745682%,53.2544882157747%,14792,17982,35671,41.4678590451627%,50.410697765692%,18048,17097,36364,49.6315036849632%,47.0162798372016%,0.546828586405731,0.548666625984012,0.486470337174563,22892,32774,35145
2954,46,VIRGINIA,MADISON,1844,2940,5027,36.6819176447185%,58.4841853988462%,2203,4419,6979,31.5661269522854%,63.3185270096002%,2698,5300,8133,33.1734907168327%,65.1666051887373%,0.614548494983278,0.667321051041981,0.662665666416604,4784,6622,7998
2955,46,VIRGINIA,MANASSAS,5262,6752,12410,42.4012892828364%,54.4077356970185%,8423,5953,15411,54.6557653624035%,38.6282525468821%,10356,6256,16978,60.996583814348%,36.847685239722%,0.562010987181621,0.414092932665554,0.376595232362148,12014,14376,16612
2956,46,VIRGINIA,MANASSAS PARK,1048,1460,2580,40.6201550387597%,56.5891472868217%,3204,1733,5232,61.2385321100918%,33.1230886850153%,3992,1979,6088,65.5716162943495%,32.5065703022339%,0.582137161084529,0.351022888393761,0.331435270473957,2508,4937,5971
2957,46,VIRGINIA,MARTINSVILLE,3048,2560,5694,53.5300316122234%,44.9596066034422%,3533,2149,5907,59.810394447266%,36.3805654308448%,3766,2165,6024,62.5166002656042%,35.9395750332005%,0.456490727532097,0.378211897219289,0.365031192041814,5608,5682,5931
2958,46,VIRGINIA,MATHEWS,1499,2951,4609,32.5233239314385%,64.0269038837058%,1563,3517,5311,29.4294859725099%,66.2210506495952%,1825,3901,5829,31.3089723794819%,66.9240006862241%,0.66314606741573,0.692322834645669,0.681278379322389,4450,5080,5726
2959,46,VIRGINIA,MECKLENBURG,4797,6600,11654,41.1618328470911%,56.632915737086%,6285,8288,14945,42.0541987286718%,55.4566744730679%,6803,9266,16207,41.9756895168754%,57.1728265564262%,0.579099763095551,0.568722980855006,0.576638247557409,11397,14573,16069
2960,46,VIRGINIA,MIDDLESEX,1671,2844,4689,35.6365962891875%,60.6525911708253%,2108,3670,6017,35.0340701346186%,60.9938507561908%,2491,4196,6785,36.7133382461312%,61.8422991893884%,0.629900332225914,0.635167878158532,0.62748616719007,4515,5778,6687
2961,46,VIRGINIA,MONTGOMERY,11720,13991,27160,43.1516936671576%,51.5132547864507%,20021,19459,43031,46.5269224512561%,45.2208872673189%,23218,20629,45037,51.5531673956969%,45.8045606945401%,0.544163976508109,0.492882472137791,0.470476885533788,25711,39480,43847
2962,46,VIRGINIA,NELSON,2907,2913,6145,47.306753458096%,47.4043938161107%,3689,4154,8318,44.3496032700168%,49.9398893964895%,4327,4812,9318,46.4370036488517%,51.6419832582099%,0.500515463917526,0.529644268774704,0.52653463179779,5820,7843,9139
2963,46,VIRGINIA,NEW KENT,2055,3934,6114,33.6113837095191%,64.3441282302911%,3546,8118,12242,28.9658552524097%,66.3126940042477%,4621,9631,14471,31.9328311796006%,66.5537972496718%,0.656870930038404,0.695987654320988,0.675764804939658,5989,11664,14252
2964,46,VIRGINIA,NEWPORT NEWS,29779,27006,57825,51.4984868136619%,46.7029831387808%,45618,25468,75715,60.2496202866011%,33.6366638050584%,53099,26377,81270,65.3365325458349%,32.4560108281039%,0.475583340670952,0.358270264187041,0.331886355629372,56785,71086,79476
2965,46,VIRGINIA,NORFOLK,38221,21920,61946,61.7005133503374%,35.3856584767378%,57023,21552,83388,68.3827409219552%,25.8454453878256%,64440,23443,89988,71.6095479397253%,26.0512512779482%,0.364476812823199,0.274285714285714,0.266752386695948,60141,78575,87883
2966,46,VIRGINIA,NORTHAMPTON,2340,2299,4892,47.8331970564186%,46.9950940310711%,3255,2686,6172,52.7381723914452%,43.5191186001296%,3667,2955,6732,54.4711824123589%,43.8948306595365%,0.495580944169002,0.452112438983336,0.446239806704923,4639,5941,6622
2967,46,VIRGINIA,NORTHUMBERLAND,2118,3362,5605,37.7876895628903%,59.9821587867975%,2852,4302,7398,38.5509597188429%,58.1508515815085%,3252,4485,7815,41.6122840690979%,57.3896353166987%,0.613503649635036,0.601341906625664,0.579682047305157,5480,7154,7737
2968,46,VIRGINIA,NORTON,867,639,1530,56.6666666666667%,41.7647058823529%,383,1021,1460,26.2328767123288%,69.9315068493151%,464,1109,1601,28.9818863210493%,69.2692067457839%,0.424302788844622,0.727207977207977,0.705022250476796,1506,1404,1573
2969,46,VIRGINIA,NOTTOWAY,2460,2870,5492,44.7924253459578%,52.2578295702841%,2829,3712,6744,41.9483985765125%,55.0415183867141%,2971,4027,7078,41.9751342187059%,56.8946029951964%,0.538461538461538,0.567497324568109,0.575450128608174,5330,6541,6998
2970,46,VIRGINIA,ORANGE,4126,5991,10483,39.3589621291615%,57.149670895736%,5957,10521,17270,34.4933410538506%,60.9206716850029%,7995,12426,20754,38.5226944203527%,59.8727956056664%,0.592171592369279,0.638487680543755,0.60849125899809,10117,16478,20421
2971,46,VIRGINIA,PAGE,2726,5089,7996,34.0920460230115%,63.6443221610805%,2514,7831,10740,23.4078212290503%,72.9143389199255%,3007,9345,12514,24.0290874220873%,74.6763624740291%,0.651183621241203,0.756984050265829,0.756557642487047,7815,10345,12352
2972,46,VIRGINIA,PATRICK,2254,4901,7385,30.521327014218%,66.3642518618822%,1768,6454,8525,20.7390029325513%,75.7067448680352%,1954,7485,9535,20.4929208180388%,78.5002621919245%,0.684975541579315,0.784967161274629,0.792986545184871,7155,8222,9439
2973,46,VIRGINIA,PETERSBURG,8751,2109,11062,79.1086602784307%,19.0652684867113%,12021,1451,13786,87.1971565356158%,10.5251704627883%,12389,1584,14133,87.6600863227906%,11.2078115049883%,0.194198895027624,0.10770486935867,0.113361482859801,10860,13472,13973
2974,46,VIRGINIA,PITTSYLVANIA,7834,15760,24255,32.298495155638%,64.9762935477221%,9199,21554,31598,29.1126020634217%,68.2131780492436%,10115,23751,34227,29.5526923189295%,69.3925848014725%,0.667966432143765,0.700874711410269,0.701322860686234,23594,30753,33866
2975,46,VIRGINIA,POQUOSON,1448,4271,5861,24.7056816242962%,72.8715236307797%,1601,5092,7177,22.3073707677303%,70.948864428034%,2054,5605,7857,26.1422934962454%,71.3376606847397%,0.746808882671796,0.760794860301808,0.731818775297036,5719,6693,7659
2976,46,VIRGINIA,PORTSMOUTH,22286,12628,35455,62.8571428571429%,35.6169792694965%,28497,12795,43265,65.8661735814169%,29.5735583034786%,30948,12755,44601,69.3885787314186%,28.5980134974552%,0.361688720856963,0.309866317930834,0.291856394297874,34914,41292,43703
2977,46,VIRGINIA,POWHATAN,2708,6820,9711,27.8859025846978%,70.2296364946967%,4060,11885,16900,24.0236686390533%,70.3254437869822%,5320,14055,19733,26.9599148634267%,71.2258653017787%,0.715785054575987,0.745374725619316,0.72541935483871,9528,15945,19375
2978,46,VIRGINIA,PRINCE EDWARD,2922,3214,6363,45.9217350306459%,50.5107653622505%,4591,4101,9143,50.2132779175325%,44.8539866564585%,4973,4434,9575,51.9373368146214%,46.3080939947781%,0.523794002607562,0.471813161527842,0.471351121505262,6136,8692,9407
2979,46,VIRGINIA,PRINCE GEORGE,4182,6579,10900,38.3669724770642%,60.3577981651376%,6419,9157,16184,39.6626297577855%,56.5805734058329%,7103,10103,17439,40.7305464762888%,57.9333677389759%,0.611374407582938,0.587891628145866,0.587178891084505,10761,15576,17206
2980,46,VIRGINIA,PRINCE WILLIAM,44745,52788,100511,44.5175154958164%,52.5196247176926%,113144,71721,196538,57.5685109240961%,36.4921796293846%,142863,81222,228267,62.5859191210293%,35.58201579729%,0.541232198332872,0.387964190084656,0.362460673405181,97533,184865,224085
2981,46,VIRGINIA,PULASKI,5255,7089,12697,41.3877293848941%,55.8320863196031%,4172,10322,15167,27.507087756313%,68.0556471286345%,4925,12127,17386,28.3273898539054%,69.7515242148855%,0.574287103046014,0.712156754519111,0.711177574478067,12344,14494,17052
2982,46,VIRGINIA,RADFORD,2063,2190,4448,46.3803956834532%,49.2356115107914%,2925,2638,6085,48.0690221857026%,43.3525061626952%,3358,2786,6320,53.1329113924051%,44.0822784810127%,0.514930637197273,0.474204565881719,0.453450520833333,4253,5563,6144
2983,46,VIRGINIA,RAPPAHANNOCK,1462,1850,3513,41.6168516937091%,52.6615428408767%,1747,2539,4483,38.9694401070712%,56.6361811287085%,2096,2812,4979,42.0968065876682%,56.4772042578831%,0.558574879227053,0.592393840410639,0.572942135289324,3312,4286,4908
2984,46,VIRGINIA,RICHMOND,43793,22049,68875,63.5833030852995%,32.0130671506352%,82606,17794,107145,77.0973913855056%,16.6074011853096%,1513,2547,4102,36.8844466114091%,62.091662603608%,0.334877433856809,0.177231075697211,0.627339901477833,65842,100400,4060
2985,46,VIRGINIA,ROANOKE,34061,40370,76259,44.664892012746%,52.9380138737723%,39486,46197,90955,43.4126765983179%,50.7910505194877%,21801,34268,57226,38.0963198546115%,59.8818718764198%,0.542381534575647,0.53916179405483,0.611175515882217,74431,85683,56069
2986,46,VIRGINIA,ROCKBRIDGE,2953,4522,7827,37.7283761338955%,57.7743707678549%,3508,6680,10795,32.4965261695229%,61.8805002315887%,4086,8088,12377,33.0128464086612%,65.3470146238992%,0.60494983277592,0.655673341185709,0.664366683095121,7475,10188,12174
2987,46,VIRGINIA,ROCKINGHAM,5834,17482,23994,24.3144119363174%,72.859881637076%,9366,25990,37487,24.9846613492677%,69.3307013097874%,12644,30349,43821,28.8537459209055%,69.2567490472604%,0.749785554983702,0.735094467699966,0.705905612541577,23316,35356,42993
2988,46,VIRGINIA,RUSSELL,5442,5065,10792,50.4262416604893%,46.9329132690882%,2330,9521,12246,19.026620937449%,77.7478360280908%,2373,10879,13386,17.7274764679516%,81.2714776632302%,0.482059579328067,0.803392118808539,0.820932689405373,10507,11851,13252
2989,46,VIRGINIA,SALEM,4348,6188,10770,40.3714020427112%,57.455896007428%,4202,7226,12225,34.3721881390593%,59.1083844580777%,5148,7683,13051,39.4452532372998%,58.8690521799096%,0.587319665907365,0.632306615330766,0.598784194528875,10536,11428,12831
2990,46,VIRGINIA,SCOTT,3552,5535,9335,38.0503481521157%,59.2929833958222%,1581,8247,10100,15.6534653465347%,81.6534653465346%,1692,9063,10869,15.5672094948937%,83.3839359646702%,0.609111918124794,0.839133089133089,0.842677824267782,9087,9828,10755
2991,46,VIRGINIA,SHENANDOAH,4420,9636,14452,30.5840022142264%,66.6758926100194%,5273,14094,20513,25.7056500755618%,68.7076488080729%,6836,16463,23684,28.8633676743793%,69.511062320554%,0.685543540125213,0.727732741260908,0.7065968496502,14056,19367,23299
2992,46,VIRGINIA,SMYTH,4836,6580,11740,41.1925042589438%,56.0477001703578%,2665,9750,12890,20.6749418153607%,75.6400310318076%,3008,10963,14136,21.2790039615167%,77.5537634408602%,0.576384022424667,0.785340314136126,0.784696872092191,11416,12415,13971
2993,46,VIRGINIA,SOUTHAMPTON,3359,3293,6714,50.0297885016384%,49.0467679475722%,3595,5035,8878,40.4933543590899%,56.7132236990313%,3969,5730,9786,40.5579399141631%,58.5530349478847%,0.495039085989176,0.58342989571263,0.590782554902567,6652,8630,9699
2994,46,VIRGINIA,SPOTSYLVANIA,13455,20739,35021,38.4198052597013%,59.2187544616087%,24207,34623,62562,38.692816725808%,55.3419008343723%,34307,39411,75317,45.5501414023394%,52.3268319237357%,0.606509914020004,0.588526262111168,0.534618410700236,34194,58830,73718
2995,46,VIRGINIA,STAFFORD,12596,20731,34246,36.780937919757%,60.5355369970216%,27908,33868,65934,42.327175660509%,51.3665180331847%,40245,37636,79629,50.5406321817428%,47.2641876703211%,0.62204818915594,0.548238798238798,0.48325008667069,33327,61776,77881
2996,46,VIRGINIA,STAUNTON,3324,4878,8514,39.0415785764623%,57.2938689217759%,5333,5133,11255,47.3833851621502%,45.6063971568192%,6981,5695,12992,53.7330665024631%,43.8346674876847%,0.594732991953182,0.490445251289891,0.449274218996529,8202,10466,12676
2997,46,VIRGINIA,SUFFOLK,12471,11836,24661,50.5697254774746%,47.9948096184259%,23280,18006,43240,53.8390379278446%,41.6419981498612%,28676,20082,49642,57.7656017082309%,40.4536481205431%,0.48693791911795,0.436128469699172,0.41187087247221,24307,41286,48758
2998,46,VIRGINIA,SURRY,1845,1313,3230,57.1207430340557%,40.6501547987616%,2272,1819,4228,53.7369914853359%,43.0227057710501%,2397,2025,4471,53.6121673003802%,45.2918810109595%,0.415769474350855,0.444634563676363,0.457937584803257,3158,4091,4422
2999,46,VIRGINIA,SUSSEX,2006,1745,3906,51.3568868407578%,44.6748591909882%,2879,2055,5044,57.0777160983347%,40.7414750198255%,2827,2219,5088,55.562106918239%,43.6124213836478%,0.465209277525993,0.416497770571544,0.439754260800634,3751,4934,5046
3000,46,VIRGINIA,TAZEWELL,7227,8655,16344,44.2180616740088%,52.9552129221733%,2895,15168,18566,15.5930194980071%,81.6977270279005%,3205,16731,20152,15.9041286224692%,83.0240174672489%,0.544956554590102,0.839727619996678,0.839235553772071,15882,18063,19936
3001,46,VIRGINIA,VIRGINIA BEACH,62268,83674,149771,41.5754718870809%,55.8679584165159%,91032,98224,203262,44.78554771674%,48.3238381989747%,117393,105087,227717,51.5521458652626%,46.1480697532464%,0.573337353195105,0.519000718603373,0.472343581445523,145942,189256,222480
3002,46,VIRGINIA,WARREN,4313,6335,11166,38.6261866380082%,56.7347304316676%,5169,11773,17960,28.7806236080178%,65.5512249443207%,6603,14069,21147,31.2242871329267%,66.5295313756088%,0.594947407963937,0.694900247904616,0.680582430340557,10648,16942,20672
3003,46,VIRGINIA,WASHINGTON,7549,12064,20222,37.3306300069231%,59.6577984373455%,5553,19320,25847,21.4841180794676%,74.7475529074941%,6617,21679,28693,23.0613738542502%,75.5550134179068%,0.615102228114006,0.776745869014594,0.76615069267741,19613,24873,28296
3004,46,VIRGINIA,WAYNESBORO,2737,4084,7102,38.5384398760912%,57.5049281892425%,3764,4801,9204,40.8952629291612%,52.1621034332899%,4961,5507,10717,46.2909396286274%,51.3856489689279%,0.598739187802375,0.560537069468768,0.526079480320978,6821,8565,10468
3005,46,VIRGINIA,WESTMORELAND,2922,2932,6026,48.4898771988052%,48.655824759376%,3836,4448,8574,44.7399113599254%,51.8777700023326%,4501,5318,9948,45.2452754322477%,53.4579815038199%,0.500854116843184,0.536938676967649,0.541603014563601,5854,8284,9819
3006,46,VIRGINIA,WILLIAMSBURG,1724,1777,3725,46.2818791946309%,47.7046979865772%,5206,1925,7626,68.266456858117%,25.2425911355888%,4790,1963,6890,69.5210449927431%,28.4905660377358%,0.507569265924022,0.269948113869023,0.29068562120539,3501,7131,6753
3007,46,VIRGINIA,WINCHESTER,3318,4314,7886,42.0745625158509%,54.7045396905909%,5164,4790,10667,48.4109871566514%,44.9048467235399%,6610,5221,12113,54.5694708164782%,43.1024519111698%,0.565251572327044,0.481213582479405,0.441298284168709,7632,9954,11831
3008,46,VIRGINIA,WISE,6412,6504,13310,48.1743050338092%,48.8655146506386%,2701,12086,15163,17.8130976719647%,79.7071819560773%,3110,13366,16615,18.7180258802287%,80.4453806801083%,0.503561474140601,0.81733955501454,0.81124059237679,12916,14787,16476
3009,46,VIRGINIA,WYTHE,3462,6539,10225,33.8581907090465%,63.9511002444988%,2770,10046,13343,20.7599490369482%,75.2904144495241%,3143,11733,15073,20.8518543090294%,77.8411729582698%,0.653834616538346,0.783863920099875,0.788720086044636,10001,12816,14876
3010,46,VIRGINIA,YORK,8622,15312,24583,35.0730179392263%,62.2869462636782%,12999,18837,34118,38.1001231021748%,55.2113254000821%,17683,20241,38791,45.5853161815885%,52.1796292954551%,0.639759338179995,0.591688654353562,0.533725345427697,23934,31836,37924
3012,47,WASHINGTON,ADAMS,1406,3440,4974,28.2669883393647%,69.1596300763973%,1299,3083,4644,27.9715762273902%,66.3867355727821%,1814,3907,5862,30.9450699419993%,66.6496076424429%,0.709863805200165,0.703560018256504,0.682922565984968,4846,4382,5721
3013,47,WASHINGTON,ASOTIN,2736,4909,7985,34.2642454602379%,61.477770820288%,3134,5741,9736,32.189811010682%,58.9667214461791%,4250,7319,11951,35.5618776671408%,61.2417370931303%,0.64211903204709,0.64687323943662,0.632638948915204,7645,8875,11569
3014,47,WASHINGTON,BENTON,19512,38367,59775,32.642409033877%,64.1856963613551%,26360,47194,80027,32.9388831269447%,58.9725967485973%,38706,60365,103033,37.5666048741665%,58.5880251958111%,0.662882910900327,0.641623840987574,0.609310494493848,57879,73554,99071
3015,47,WASHINGTON,CHELAN,8412,16980,26569,31.6609582596259%,63.9090669577327%,13032,18114,33380,39.0413421210306%,54.266027561414%,19349,22746,43306,44.6797210548192%,52.5238996905741%,0.668714555765595,0.581583509921017,0.540349210119967,25392,31146,42095
3016,47,WASHINGTON,CLALLAM,13779,16251,32230,42.7520943220602%,50.4219671113869%,17677,18794,39457,44.800669082799%,47.6315989558253%,24721,23062,49264,50.1806593049692%,46.813088665151%,0.541158841158841,0.515313536782649,0.482640269551933,30030,36471,47783
3017,47,WASHINGTON,CLARK,61767,67219,135530,45.5744115693942%,49.5971371652033%,92757,92441,200160,46.3414268585132%,46.183553157474%,140324,126303,275403,50.9522408978842%,45.8611561965556%,0.521134076566449,0.499146859037355,0.473706713873689,128986,185198,266627
3018,47,WASHINGTON,COLUMBIA,515,1523,2106,24.4539411206078%,72.3171889838557%,526,1497,2182,24.1063244729606%,68.6067827681027%,668,1754,2495,26.7735470941884%,70.3006012024048%,0.74730127576055,0.739990113692536,0.724194880264244,2038,2023,2422
3019,47,WASHINGTON,COWLITZ,18233,16873,36957,49.3357144789891%,45.6557621019022%,17908,24185,45692,39.1928565175523%,52.9304911144183%,23938,34424,60280,39.7113470471135%,57.1068347710684%,0.480630091722213,0.57456109091773,0.589835852095542,35106,42093,58362
3020,47,WASHINGTON,DOUGLAS,3822,8512,12851,29.7408761964049%,66.2360905766088%,4918,9603,15543,31.6412532973042%,61.7834394904459%,7811,12955,21308,36.6575933921532%,60.7987610287216%,0.690124858115778,0.661318091040562,0.623856303573148,12334,14521,20766
3021,47,WASHINGTON,FERRY,932,1896,3037,30.6881791241357%,62.4300296345077%,1098,2202,3601,30.4915301305193%,61.1496806442655%,1486,2771,4367,34.0279367987177%,63.4531715136249%,0.67043847241867,0.667272727272727,0.650927883486023,2828,3300,4257
3022,47,WASHINGTON,FRANKLIN,4653,8594,13612,34.1830737584484%,63.1354687040846%,8886,13206,23720,37.4620573355818%,55.6745362563238%,13340,18039,32404,41.1677570670288%,55.6690532033082%,0.648750660526912,0.597772949483976,0.574874916345326,13247,22092,31379
3023,47,WASHINGTON,GARFIELD,300,982,1329,22.5733634311512%,73.8901429646351%,279,851,1246,22.3916532905297%,68.2985553772071%,366,1069,1489,24.5802552048355%,71.7931497649429%,0.765990639625585,0.753097345132743,0.744947735191638,1282,1130,1435
3024,47,WASHINGTON,GRANT,7073,15830,23795,29.7247320865728%,66.5265812145409%,7810,18518,28346,27.5523883440344%,65.3284414026671%,11819,24764,37680,31.3667728237792%,65.7218683651805%,0.691175828494084,0.703357642054087,0.6769264412432,22903,26328,36583
3025,47,WASHINGTON,GRAYS HARBOR,13304,11225,25970,51.2283403927609%,43.2229495571814%,12020,14067,28367,42.3731801036416%,49.5893115239539%,17354,19877,38441,45.1445071668271%,51.7078119715928%,0.457621590770109,0.539234101276498,0.533883054443877,24529,26087,37231
3026,47,WASHINGTON,ISLAND,14778,16408,33003,44.7777474775021%,49.716692421901%,20960,18465,42876,48.8851571974998%,43.0660509375875%,29213,22746,53925,54.1733889661567%,42.1808066759388%,0.526133521451934,0.468357641090678,0.437768240343348,31186,39425,51959
3027,47,WASHINGTON,JEFFERSON,8281,6095,15832,52.3054573016675%,38.4979787771602%,12656,6037,20276,62.4186230025646%,29.7741171828763%,17204,6931,24792,69.3933526944176%,27.9565989028719%,0.423970506399555,0.322955116888675,0.287176299979283,14376,18693,24135
3028,47,WASHINGTON,KING,476700,273171,794078,60.0318860363843%,34.4010286143175%,718322,216339,998499,71.9401822135025%,21.6664212983689%,907310,269167,1210507,74.9528916396188%,22.2358895900643%,0.364290657993175,0.231462530264984,0.228790703090668,749871,934661,1176477
3029,47,WASHINGTON,KITSAP,50302,46427,102857,48.9047901455419%,45.1374238019775%,63156,49018,124317,50.8023842274186%,39.4298446712839%,90277,61563,158672,56.8953564586064%,38.7989059191288%,0.479969812569136,0.43698183179703,0.405446522655427,96729,112174,151840
3030,47,WASHINGTON,KITTITAS,5516,7727,14086,39.1594490983956%,54.8558852761607%,7489,10100,18955,39.5093642838301%,53.2840939066209%,11421,14105,26364,43.3204369594902%,53.5009861932939%,0.583478063882806,0.574222525442038,0.552573846274387,13243,17589,25526
3031,47,WASHINGTON,KLICKITAT,3062,4557,8180,37.4327628361858%,55.7090464547677%,4194,5789,10769,38.9451202525768%,53.7561519175411%,5959,7237,13560,43.9454277286136%,53.3702064896755%,0.598109988187426,0.579885805869979,0.548423764777205,7619,9983,13196
3032,47,WASHINGTON,LEWIS,9891,18565,29983,32.9886935930361%,61.9184204382484%,9654,21992,34149,28.270227532285%,64.4001288471112%,14520,29391,45309,32.0466132556446%,64.8679070383368%,0.652410739387124,0.694937748846616,0.669331147092984,28456,31646,43911
3033,47,WASHINGTON,LINCOLN,1417,3546,5196,27.2709776751347%,68.2448036951501%,1244,4108,5713,21.7748993523543%,71.9061788902503%,1713,5150,7033,24.356604578416%,73.2262192520973%,0.714487205319363,0.767563527653214,0.750400699402594,4963,5352,6863
3034,47,WASHINGTON,MASON,10876,10257,22479,48.3829351839495%,45.6292539703724%,11993,13677,28073,42.7207637231504%,48.7194101093577%,17269,18710,37303,46.2938637643085%,50.1568238479479%,0.48535465859083,0.532800934943514,0.520025570471664,21133,25670,35979
3035,47,WASHINGTON,OKANOGAN,4335,9384,14796,29.2984590429846%,63.4225466342255%,6298,9610,17091,36.8498039904043%,56.2284243168919%,8900,11840,21282,41.819377878019%,55.6338689972747%,0.684014869888476,0.604098566758863,0.570877531340405,13719,15908,20740
3036,47,WASHINGTON,PACIFIC,4895,4042,9518,51.4288716116831%,42.4669048119353%,4620,5360,10716,43.1131019036954%,50.0186636804778%,6794,6953,14064,48.3077360637088%,49.4382821387941%,0.452277050464362,0.537074148296593,0.505783079944715,8937,9980,13747
3037,47,WASHINGTON,PEND OREILLE,1973,3076,5437,36.2883943351113%,56.5753172705536%,1934,4373,6802,28.4328138782711%,64.2899147309615%,2593,5728,8553,30.3168478896294%,66.9706535718461%,0.609229550406021,0.693356587918186,0.688378800624925,5049,6307,8321
3038,47,WASHINGTON,PIERCE,138249,118431,268894,51.4139400656021%,44.0437495816195%,172538,146824,348485,49.5108828213553%,42.1320860295278%,249506,197730,464081,53.7634593960968%,42.60678631532%,0.461395511921459,0.459741609834608,0.442115572091692,256680,319362,447236
3039,47,WASHINGTON,SAN JUAN,4426,3005,8424,52.5403608736942%,35.6718898385565%,7172,2688,10774,66.5676628921478%,24.9489511787637%,9725,3057,13197,73.6909903766007%,23.1643555353489%,0.404387027317992,0.272616632860041,0.239164450007823,7431,9860,12782
3040,47,WASHINGTON,SKAGIT,20432,22163,45220,45.1835471030517%,49.0114993365767%,26690,24736,55968,47.6879645511721%,44.1966838193253%,38252,32762,73423,52.0981163940455%,44.6208953597647%,0.520319286301209,0.481001827869171,0.461345650153491,42595,51426,71014
3041,47,WASHINGTON,SKAMANIA,1753,2151,4248,41.2664783427495%,50.635593220339%,2232,2928,5639,39.581486079092%,51.9241000177336%,3192,3885,7312,43.6542669584245%,53.1318380743983%,0.550973360655738,0.567441860465116,0.548961424332344,3904,5160,7077
3042,47,WASHINGTON,SNOHOMISH,129612,109615,251305,51.5755754959113%,43.6183124092239%,185227,128255,342173,54.132558676459%,37.4825015416178%,256728,166428,438796,58.5073701674582%,37.9283311607216%,0.458204968502719,0.409130348791956,0.393301761052661,239227,313482,423156
3043,47,WASHINGTON,SPOKANE,74604,89299,172089,43.3519864721162%,51.8911725909268%,93767,113435,227246,41.2623324502962%,49.9172702709839%,135765,148576,295430,45.9550485732661%,50.2914395965203%,0.544828343593467,0.547460931844287,0.522527528566053,163903,207202,284341
3044,47,WASHINGTON,STEVENS,5560,11299,17995,30.8974715198666%,62.7896637954988%,5767,15161,22677,25.4310534903206%,66.856286104864%,7839,19808,28430,27.5729862820964%,69.6728807597608%,0.670205824782016,0.724436162079511,0.716461098853402,16859,20928,27647
3045,47,WASHINGTON,THURSTON,50467,39924,97407,51.8104448345602%,40.9867873972097%,68798,48624,129410,53.1628158565799%,37.5736032764083%,96608,65277,168134,57.4589315664886%,38.8243900698253%,0.441681140821542,0.414096165965492,0.403230688451679,90391,117422,161885
3046,47,WASHINGTON,WAHKIAKUM,803,1033,1971,40.7407407407407%,52.4099441907661%,832,1344,2358,35.284139100933%,56.9974554707379%,1165,1741,2981,39.0808453539081%,58.4032203958403%,0.562636165577342,0.617647058823529,0.599105299380592,1836,2176,2906
3047,47,WASHINGTON,WALLA WALLA,7188,13304,21362,33.6485347813875%,62.2788128452392%,9694,13651,25419,38.136826783115%,53.7039222628742%,13690,16400,31261,43.7925850100765%,52.4615335401939%,0.649228967401913,0.584750481901906,0.545031571950814,20492,23345,30090
3048,47,WASHINGTON,WHATCOM,34033,34287,73752,46.1451892830025%,46.4895867230719%,60340,40599,109673,55.0180992587054%,37.0182269109079%,83660,50489,138620,60.3520415524455%,36.4225941422594%,0.501858899297424,0.402213217884069,0.376365086582829,68320,100939,134149
3049,47,WASHINGTON,WHITMAN,6509,9003,16234,40.0948626339781%,55.4576814093877%,8146,7403,17305,47.0731002600405%,42.779543484542%,11184,9067,21126,52.9395058222096%,42.9186784057559%,0.580389375966993,0.476107788282205,0.447730976248087,15512,15549,20251
3050,47,WASHINGTON,YAKIMA,25546,39494,67375,37.9161410018553%,58.6181818181818%,31291,41735,77750,40.2456591639871%,53.6784565916399%,43179,50555,96193,44.8878816545903%,52.5557992785338%,0.607226322263223,0.571508777695615,0.539345381611795,65040,73026,93734
3052,48,WEST VIRGINIA,BARBOUR,2503,3411,6051,41.365063625847%,56.3708477937531%,1222,4527,6054,20.1850016518005%,74.7770069375619%,1457,5116,6677,21.8211771753782%,76.6212370825221%,0.576766993574569,0.787441294138111,0.778335615396318,5914,5749,6573
3053,48,WEST VIRGINIA,BERKELEY,8797,13619,23010,38.2312038244242%,59.187309865276%,12321,28244,42850,28.7537922987164%,65.9136522753792%,17186,33279,51535,33.3482099543999%,64.5755311923935%,0.60755710206995,0.696265253297177,0.659447141583276,22416,40565,50465
3054,48,WEST VIRGINIA,BOONE,5656,3353,9141,61.8750683732633%,36.680888305437%,1790,6504,8683,20.6149948174594%,74.9049867557296%,2041,6816,9012,22.647581003107%,75.6324900133156%,0.372183372183372,0.784181335905474,0.769560799367732,9009,8294,8857
3055,48,WEST VIRGINIA,BRAXTON,2719,2529,5328,51.0322822822823%,47.4662162162162%,1321,3537,5090,25.9528487229862%,69.4891944990177%,1457,4120,5664,25.7238700564972%,72.7401129943503%,0.481897865853659,0.728077398106217,0.738748431056123,5248,4858,5577
3056,48,WEST VIRGINIA,BROOKE,4678,4195,9405,49.7395002658161%,44.6039340776183%,2568,6625,9613,26.7138250286071%,68.9170914386768%,2947,7545,10656,27.6557807807808%,70.8051801801802%,0.472782598895526,0.720657021646905,0.719119329012581,8873,9193,10492
3057,48,WEST VIRGINIA,CABELL,14896,16440,32216,46.2378942140551%,51.0305438291532%,11447,19850,33085,34.5987607677195%,59.9969774822427%,14994,21721,37360,40.1338329764454%,58.139721627409%,0.524636201174368,0.634246093874812,0.59161105815062,31336,31297,36715
3058,48,WEST VIRGINIA,CALHOUN,1112,1425,2615,42.5239005736138%,54.4933078393882%,456,2035,2617,17.4245319067635%,77.7607948032098%,568,2364,2971,19.1181420397173%,79.5691686300909%,0.561687031927473,0.816940987555199,0.806275579809004,2537,2491,2932
3059,48,WEST VIRGINIA,CLAY,1617,1887,3582,45.142378559464%,52.6800670016751%,568,2300,2972,19.1117092866756%,77.3889636608345%,641,2679,3365,19.0490341753343%,79.6136701337296%,0.538527397260274,0.801952580195258,0.806927710843373,3504,2868,3320
3060,48,WEST VIRGINIA,DODDRIDGE,773,1955,2816,27.4502840909091%,69.4247159090909%,362,2358,2840,12.7464788732394%,83.0281690140845%,435,2619,3101,14.0277329893583%,84.4566268945501%,0.716642228739003,0.866911764705882,0.857563850687623,2728,2720,3054
3061,48,WEST VIRGINIA,FAYETTE,8371,5897,14619,57.2610985703537%,40.3379164101512%,4290,10357,15337,27.9715720153876%,67.5295038143053%,5063,11580,16862,30.0260941762543%,68.675127505634%,0.413302495093916,0.707107257458865,0.695788018986961,14268,14647,16643
3062,48,WEST VIRGINIA,GILMER,1092,1560,2740,39.8540145985401%,56.9343065693431%,545,1896,2543,21.431380259536%,74.557609123083%,599,2012,2662,22.5018782870023%,75.5822689706987%,0.588235294117647,0.776730848013109,0.770585982382229,2652,2441,2611
3063,48,WEST VIRGINIA,GRANT,891,3571,4534,19.6515218350243%,78.7604764005293%,512,4346,4956,10.3309120258273%,87.6916868442292%,607,4871,5509,11.0183336358686%,88.4189508077691%,0.80031376064545,0.894606834088102,0.889193136181088,4462,4858,5478
3064,48,WEST VIRGINIA,GREENBRIER,5627,6866,12808,43.9334790755778%,53.6071205496565%,3765,9556,14066,26.7666714062278%,67.9368690459264%,4655,10925,15850,29.3690851735016%,68.9274447949527%,0.549587769150724,0.717363561294197,0.701219512195122,12493,13321,15580
3065,48,WEST VIRGINIA,HAMPSHIRE,2069,3879,6097,33.9347219944235%,63.621453173692%,1580,6692,8608,18.3550185873606%,77.7416356877323%,1939,8033,10086,19.2246678564347%,79.6450525480865%,0.652151983860121,0.80899419729207,0.805555555555556,5948,8272,9972
3066,48,WEST VIRGINIA,HANCOCK,6249,6458,13472,46.3850950118765%,47.936460807601%,3262,8909,12702,25.6809951188789%,70.138560856558%,3790,9806,13800,27.463768115942%,71.0579710144928%,0.508223813646022,0.731985868046997,0.721241541629891,12707,12171,13596
3067,48,WEST VIRGINIA,HARDY,1621,2816,4514,35.910500664599%,62.3836951705804%,1155,4274,5643,20.4678362573099%,75.7398546872231%,1381,4859,6331,21.8132996367083%,76.7493287000474%,0.634663060626549,0.787253637870694,0.778685897435897,4437,5429,6240
3068,48,WEST VIRGINIA,HARRISON,13009,12948,26578,48.946497102867%,48.7169839717059%,7694,18750,27960,27.5178826895565%,67.0600858369099%,9215,20683,30465,30.2478253733793%,67.8910224848187%,0.498824979774242,0.709045530176978,0.691785403705934,25957,26444,29898
3069,48,WEST VIRGINIA,JACKSON,4937,6341,11518,42.863344330613%,55.0529605834346%,2663,9020,12187,21.85115286781%,74.0132928530401%,3207,10093,13508,23.7414865265028%,74.7186852235712%,0.562245078914701,0.772061970384319,0.758872180451128,11278,11683,13300
3070,48,WEST VIRGINIA,JEFFERSON,6860,7045,14378,47.7117818889971%,48.9984698845458%,9518,13204,24147,39.4169047914855%,54.6817410030232%,12127,15033,27703,43.775042414179%,54.264881059813%,0.506652283351313,0.581110817709709,0.553497790868925,13905,22722,27160
3071,48,WEST VIRGINIA,KANAWHA,38524,36809,76670,50.2465110212599%,48.0096517542716%,28263,43850,75690,37.3404676971859%,57.9336768397411%,34344,46398,82244,41.7586693254219%,56.4150576333836%,0.488617206270824,0.608073440295093,0.574645166084566,75333,72113,80742
3072,48,WEST VIRGINIA,LEWIS,2355,3606,6134,38.392566025432%,58.7870883599609%,1347,5274,6928,19.4428406466513%,76.1258660508083%,1538,5782,7457,20.6249161861338%,77.537883867507%,0.604932058379467,0.796556411418215,0.789890710382514,5961,6621,7320
3073,48,WEST VIRGINIA,LINCOLN,3939,3389,7464,52.7733118971061%,45.4046087888532%,1459,5307,7066,20.6481743560713%,75.1061420888763%,1711,6012,7830,21.8518518518519%,76.7816091954023%,0.462472707423581,0.784362991427727,0.778453968665027,7328,6766,7723
3074,48,WEST VIRGINIA,LOGAN,8927,5334,14439,61.8256111919108%,36.9416164554332%,2092,9897,12359,16.9269358362327%,80.0792944412978%,2333,10534,13026,17.9103331797943%,80.8690311684324%,0.374027066825608,0.825506714488281,0.818683453796534,14261,11989,12867
3075,48,WEST VIRGINIA,MARION,12315,9972,22873,53.8407729637564%,43.5972544047567%,6964,14668,23029,30.2401320074688%,63.6936037170524%,8901,16300,25794,34.5080251221214%,63.1929906179732%,0.447435724862027,0.678069526627219,0.646799730169438,22287,21632,25201
3076,48,WEST VIRGINIA,MARSHALL,6000,6859,13498,44.45102978219%,50.8149355460068%,2918,9666,13216,22.0792978208232%,73.1386198547216%,3455,10435,14080,24.5383522727273%,74.1122159090909%,0.533400731005521,0.768118245390973,0.751259899208063,12859,12584,13890
3077,48,WEST VIRGINIA,MASON,4963,5972,11223,44.2216876058095%,53.2121536131159%,2081,7654,10186,20.4300019634793%,75.1423522481838%,2526,8491,11203,22.5475319110952%,75.792198518254%,0.546136259716507,0.786235233692861,0.770717981301625,10935,9735,11017
3078,48,WEST VIRGINIA,MCDOWELL,4845,2348,7303,66.3425989319458%,32.1511707517459%,1438,4629,6203,23.1823311300983%,74.6251813638562%,1333,5148,6527,20.4228588938256%,78.8723762831316%,0.326428472125678,0.762980056040877,0.79432186390989,7193,6067,6481
3079,48,WEST VIRGINIA,MERCER,8347,10206,18875,44.2225165562914%,54.0715231788079%,4704,17404,22982,20.4681924984771%,75.7288312592464%,5556,19237,25134,22.1055144425877%,76.5377576191613%,0.550099714331914,0.787226343405102,0.77590448917033,18553,22108,24793
3080,48,WEST VIRGINIA,MINERAL,3341,6180,9782,34.1545696176651%,63.1772643631159%,2050,9070,11564,17.7274299550329%,78.4330681425112%,2660,10040,12872,20.6650093225606%,77.9987569919205%,0.649091481987186,0.815647482014388,0.790551181102362,9521,11120,12700
3081,48,WEST VIRGINIA,MINGO,6049,3866,10043,60.2310066713133%,38.4944737628199%,1370,7911,9510,14.4058885383807%,83.186119873817%,1397,8544,10022,13.939333466374%,85.252444621832%,0.389914271306102,0.852386596271953,0.859470878181269,9915,9281,9941
3082,48,WEST VIRGINIA,MONONGALIA,12603,13595,27367,46.0518142288157%,49.676617824387%,14699,18432,36048,40.7761873058145%,51.1318242343542%,20282,20803,42072,48.2078341890093%,49.4461874881156%,0.518932742957478,0.556336965379856,0.506340513569429,26198,33131,41085
3083,48,WEST VIRGINIA,MONROE,2094,2940,5139,40.7472270869819%,57.209573847052%,1111,4443,5805,19.1386735572782%,76.5374677002584%,1345,5068,6490,20.7241910631741%,78.0893682588598%,0.584028605482717,0.799963989917177,0.790269764540777,5034,5554,6413
3084,48,WEST VIRGINIA,MORGAN,1939,3639,5772,33.5932085932086%,63.045738045738%,1573,5732,7654,20.5513457015939%,74.8889469558401%,1998,6537,8695,22.9787234042553%,75.1811385853939%,0.652384367156687,0.78466803559206,0.765905096660808,5578,7305,8535
3085,48,WEST VIRGINIA,NICHOLAS,4059,4359,8579,47.3132066674438%,50.8101177293391%,1840,7251,9491,19.3867874828785%,76.3986934991044%,2226,8279,10630,20.9407337723424%,77.8833490122296%,0.517818959372773,0.79760202397976,0.788100904331271,8418,9091,10505
3086,48,WEST VIRGINIA,OHIO,7653,9607,17964,42.6018704074816%,53.479180583389%,5493,11139,17938,30.6221429367822%,62.097223770766%,7223,12354,19898,36.3001306663986%,62.0866418735551%,0.556604866743917,0.669733044733045,0.631046636358993,17260,16632,19577
3087,48,WEST VIRGINIA,PENDLETON,1172,1996,3221,36.3862154610369%,61.9683328158957%,729,2398,3225,22.6046511627907%,74.3565891472868%,820,2782,3659,22.410494670675%,76.0317026509975%,0.630050505050505,0.766869203709626,0.77234869516935,3168,3127,3602
3088,48,WEST VIRGINIA,PLEASANTS,1267,1884,3208,39.4950124688279%,58.7281795511222%,621,2358,3150,19.7142857142857%,74.8571428571429%,699,2742,3491,20.022916069894%,78.5448295617302%,0.59790542684862,0.791540785498489,0.796861377506539,3151,2979,3441
3089,48,WEST VIRGINIA,POCAHONTAS,1392,1970,3467,40.1499855783098%,56.8214594750505%,928,2496,3646,25.4525507405376%,68.4585847504114%,1047,2895,4008,26.122754491018%,72.2305389221557%,0.585960737656157,0.728971962616822,0.734398782343988,3362,3424,3942
3090,48,WEST VIRGINIA,PRESTON,3515,6607,10439,33.6718076444104%,63.2915030175304%,2470,9538,12659,19.5118097796034%,75.345603918161%,3163,11190,14572,21.7060115289596%,76.7911062311282%,0.652736613317526,0.794303797468354,0.779627952344458,10122,12008,14353
3091,48,WEST VIRGINIA,PUTNAM,7891,12173,20426,38.6321355135612%,59.5956134338588%,5884,17788,24893,23.6371670750813%,71.4578395532881%,7878,20034,28501,27.6411353987579%,70.292270446651%,0.606708532695375,0.751436296045962,0.717755803955288,20064,23672,27912
3092,48,WEST VIRGINIA,RALEIGH,11047,12587,24061,45.9124724658161%,52.3128714517269%,6443,22048,29618,21.7536633128503%,74.4412181781349%,7982,24673,33106,24.110433154111%,74.5272760224733%,0.532580181095033,0.77385841142817,0.755565763282805,23634,28491,32655
3093,48,WEST VIRGINIA,RANDOLPH,4028,5248,9542,42.2133724586041%,54.9989520016768%,2735,7629,10876,25.1471129091578%,70.1452739977933%,3362,8673,12200,27.5573770491803%,71.0901639344262%,0.565761103924105,0.736105750675415,0.7206481096801,9276,10364,12035
3094,48,WEST VIRGINIA,RITCHIE,1024,2717,3812,26.8625393494229%,71.2749213011543%,496,3405,4075,12.1717791411043%,83.5582822085889%,586,3649,4283,13.6819985991128%,85.1972916180248%,0.726276396685378,0.872853114586004,0.861629279811098,3741,3901,4235
3095,48,WEST VIRGINIA,ROANE,2332,3172,5625,41.4577777777778%,56.3911111111111%,1222,3781,5247,23.2894987611969%,72.0602248904136%,1455,4213,5763,25.2472670484123%,73.1042859621725%,0.576308139534884,0.755746552068759,0.743295695130557,5504,5003,5668
3096,48,WEST VIRGINIA,SUMMERS,2299,2304,4713,48.7799702949289%,48.8860598345003%,1190,3455,4862,24.4755244755245%,71.061291649527%,1448,4074,5585,25.9265890778872%,72.9453894359893%,0.500543124049533,0.743810548977395,0.737776168055053,4603,4645,5522
3097,48,WEST VIRGINIA,TAYLOR,2473,3124,5712,43.2948179271709%,54.6918767507003%,1491,4733,6538,22.8051391862955%,72.3921688589783%,1796,5477,7383,24.3261546796695%,74.1839360693485%,0.55815615508308,0.760443444730077,0.75305926027774,5597,6224,7273
3098,48,WEST VIRGINIA,TUCKER,1319,1935,3346,39.4202032277346%,57.8302450687388%,751,2565,3475,21.6115107913669%,73.8129496402878%,938,2841,3844,24.4016649323621%,73.9073881373569%,0.594652735095267,0.773522316043426,0.751786186821911,3254,3316,3779
3099,48,WEST VIRGINIA,TYLER,1214,2582,3928,30.9063136456212%,65.7331975560082%,507,2996,3654,13.8752052545156%,81.992337164751%,631,3226,3922,16.0887302396736%,82.2539520652728%,0.680189673340358,0.855266914073651,0.836401348198081,3796,3503,3857
3100,48,WEST VIRGINIA,UPSHUR,2770,5165,8123,34.1007017111904%,63.5848824325988%,1766,7005,9218,19.1581688001736%,75.9926231286613%,2256,7771,10221,22.072204285295%,76.0297426866256%,0.650913673597984,0.798654657393684,0.775007479804528,7935,8771,10027
3101,48,WEST VIRGINIA,WAYNE,7940,7993,16241,48.8886152330521%,49.2149498183609%,3357,11152,15182,22.1117112369912%,73.455407719668%,4088,12585,16947,24.122263527468%,74.2609311382546%,0.501663214711605,0.76862636983941,0.754813170995022,15933,14509,16673
3102,48,WEST VIRGINIA,WEBSTER,1764,1484,3308,53.3252720677146%,44.8609431680774%,556,2302,2978,18.6702484889187%,77.3002014775017%,610,2759,3402,17.9306290417402%,81.0993533215755%,0.456896551724138,0.805458362491252,0.818937370139507,3248,2858,3369
3103,48,WEST VIRGINIA,WETZEL,2849,3239,6288,45.308524173028%,51.5108142493639%,1359,4519,6265,21.6919393455706%,72.1308858739026%,1539,4993,6667,23.0838458077096%,74.8912554372281%,0.532030223390276,0.768798911194284,0.764390691977955,6088,5878,6532
3104,48,WEST VIRGINIA,WIRT,818,1518,2382,34.3408900083963%,63.727959697733%,386,1911,2422,15.9372419488026%,78.9017341040462%,466,2134,2653,17.5650207312476%,80.4372408594044%,0.649828767123288,0.83195472355246,0.820769230769231,2336,2297,2600
3105,48,WEST VIRGINIA,WOOD,12664,20428,33857,37.4043772336592%,60.3361195616859%,8400,25434,35615,23.5855678787028%,71.4137301698723%,10926,27202,38762,28.1874000309582%,70.1769774521438%,0.617309319472984,0.751729029969853,0.713438942509442,33092,33834,38128
3106,48,WEST VIRGINIA,WYOMING,4289,3473,7878,54.4427519675044%,44.0847930946941%,1062,6547,7831,13.5614864002043%,83.6036266121824%,1157,7353,8592,13.4660148975791%,85.5796089385475%,0.447436227776346,0.860428440005257,0.864042303172738,7762,7609,8510
3108,49,WISCONSIN,ADAMS,4826,3920,9116,52.9398859148749%,43.0013163668276%,3770,5983,10164,37.0916961826053%,58.8646202282566%,4329,7362,11818,36.6305635471315%,62.2948045354544%,0.448204893665676,0.613452271096073,0.629715165511932,8746,9753,11691
3109,49,WISCONSIN,ASHLAND,4356,3038,7890,55.2091254752852%,38.5044359949303%,4228,3302,8029,52.6591107236269%,41.1259185452734%,4801,3841,8757,54.824711659244%,43.8620532145712%,0.410873681363267,0.438512616201859,0.444457301550567,7394,7530,8642
3110,49,WISCONSIN,BARRON,8928,9848,19904,44.8553054662379%,49.4774919614148%,7879,13606,22643,34.7966258887957%,60.0892107936228%,9194,15803,25346,36.2739682790184%,62.349088613588%,0.524499360886238,0.633279031882709,0.63219586350362,18776,21485,24997
3111,49,WISCONSIN,BAYFIELD,4427,3266,8259,53.6021310085967%,39.5447390725269%,4954,4125,9529,51.9886661769336%,43.2889075453878%,6147,4617,10880,56.4981617647059%,42.4356617647059%,0.424541791238789,0.454345192201784,0.428929765886288,7693,9079,10764
3112,49,WISCONSIN,BROWN,49096,54258,107769,45.5566999786581%,50.3465746179328%,53364,67199,128979,41.3741771916359%,52.1007295761326%,65511,75871,144017,45.4883798440462%,52.6819750446128%,0.524972424869865,0.557376641258097,0.536638327368406,103354,120563,141382
3113,49,WISCONSIN,BUFFALO,3237,3038,6641,48.7426592380666%,45.7461225719018%,2531,4049,6988,36.2192329708071%,57.9421866056096%,2860,4834,7816,36.5916069600819%,61.8474923234391%,0.484143426294821,0.615349544072948,0.628281778008838,6275,6580,7694
3114,49,WISCONSIN,BURNETT,3626,3967,8151,44.4853392221813%,48.6688749846645%,2948,5412,8743,33.7184032940638%,61.9009493308933%,3569,6462,10141,35.1937678729908%,63.7215264766788%,0.522454892664296,0.647368421052632,0.644202970790549,7593,8360,10031
3115,49,WISCONSIN,CALUMET,8202,10837,19947,41.1189652579335%,54.3289717752043%,9646,15348,26650,36.1951219512195%,57.5909943714822%,12116,18156,30774,39.3708975108858%,58.9978553324235%,0.56920006302852,0.614067376170281,0.599762156448203,19039,24994,30272
3116,49,WISCONSIN,CHIPPEWA,12102,12835,26173,46.238490046995%,49.0390860810759%,11886,17909,31561,37.6604036627483%,56.7440828871075%,13983,21317,35938,38.9086760532027%,59.3160442985141%,0.514697036532061,0.601074005705655,0.603881019830028,24937,29795,35300
3117,49,WISCONSIN,CLARK,5931,7461,14149,41.9181567601951%,52.7316418121422%,4227,8646,13596,31.090026478376%,63.5922330097087%,4524,10002,14898,30.3664921465969%,67.1365283930729%,0.557123655913979,0.671638312747611,0.688558446922759,13392,12873,14526
3118,49,WISCONSIN,COLUMBIA,12636,11987,25587,49.3844530425607%,46.8480087544456%,13526,14160,29771,45.4334755298781%,47.5630647274193%,16410,16927,33869,48.4513862233901%,49.9778558563879%,0.486821264671242,0.51144983023911,0.507754147043825,24623,27686,33337
3119,49,WISCONSIN,CRAWFORD,4005,3024,7394,54.1655396267244%,40.8980254260211%,3425,3844,7744,44.2277892561984%,49.6384297520661%,3953,4620,8695,45.4629097182289%,53.1339850488787%,0.430217669654289,0.528821020773146,0.538901201446402,7029,7269,8573
3120,49,WISCONSIN,DANE,142317,75790,232739,61.1487546135371%,32.5643746858068%,217526,71279,310017,70.1658296157953%,22.9919649567604%,260185,78800,344791,75.4616564817527%,22.8544248544771%,0.347489993443585,0.246806668859611,0.232458663362686,218107,288805,338985
3121,49,WISCONSIN,DODGE,14580,21684,37701,38.6727142516114%,57.5157157635076%,13968,26643,43065,32.4346917450366%,61.8669453152212%,16356,31355,48436,33.7682715335701%,64.7349079197291%,0.597948378557247,0.65605377853291,0.657185973884429,36264,40611,47711
3122,49,WISCONSIN,DOOR,6560,7810,15220,43.1011826544021%,51.3140604467806%,8026,8584,17608,45.581553839164%,48.7505679236711%,10044,9752,20117,49.927921658299%,48.4764129840434%,0.543493389004871,0.516797110174594,0.49262477268135,14370,16610,19796
3123,49,WISCONSIN,DOUGLAS,13593,6930,21706,62.6232378144292%,31.9266562240855%,11345,9659,22511,50.3975834036693%,42.9079116876194%,13218,10923,24677,53.5640474936175%,44.2638894517162%,0.337669931296594,0.459864787659493,0.452466757797937,20523,21004,24141
3124,49,WISCONSIN,DUNN,9172,8911,19330,47.4495602690119%,46.0993274702535%,9026,11488,22091,40.8582680729709%,52.003078176633%,9897,13173,23524,42.0719265431049%,55.9981295698011%,0.492783277111099,0.560007799551526,0.571001300390117,18083,20514,23070
3125,49,WISCONSIN,EAU CLAIRE,24078,20921,47875,50.2934725848564%,43.6992167101828%,27294,23311,54885,49.7294342716589%,42.4724423795208%,31620,25341,58275,54.2599742599743%,43.4851994851995%,0.464921442698727,0.460646181207391,0.444883341233476,44999,50605,56961
3126,49,WISCONSIN,FLORENCE,816,1528,2405,33.9293139293139%,63.5343035343035%,666,1897,2657,25.0658637561159%,71.3963116296575%,781,2133,2940,26.5646258503401%,72.5510204081633%,0.651877133105802,0.740148263753414,0.731983527796843,2344,2563,2914
3127,49,WISCONSIN,FOND DU LAC,18181,26548,46589,39.0242331880916%,56.9834081006246%,17391,31044,51327,33.8827517680753%,60.4827868373371%,20588,35754,57251,35.9609439136434%,62.4513108941329%,0.593529924657381,0.640941467946733,0.634588761492315,44729,48435,56342
3128,49,WISCONSIN,FOREST,2158,2404,4716,45.7591178965225%,50.9754028837998%,1584,2788,4540,34.8898678414097%,61.4096916299559%,1721,3285,5053,34.058974866416%,65.0108846229962%,0.526961858833845,0.637694419030192,0.656212544946065,4562,4372,5006
3129,49,WISCONSIN,GRANT,10691,10240,21956,48.6928402259064%,46.6387320094735%,10046,12349,24321,41.3058673574277%,50.7750503679947%,10998,14142,25608,42.9475164011246%,55.2249297094658%,0.489226506139219,0.551417727171244,0.562529832935561,20931,22395,25140
3130,49,WISCONSIN,GREEN,7863,6790,15276,51.4728986645719%,44.4488085886358%,9122,8693,18985,48.0484593099816%,45.788780616276%,10851,10169,21406,50.6913949359993%,47.5053723255162%,0.463386337268819,0.487959584619702,0.483777354900095,14653,17815,21020
3131,49,WISCONSIN,GREEN LAKE,3301,5451,9107,36.2468430877347%,59.8550565499067%,2701,6213,9388,28.7707711972731%,66.1802300809544%,3344,7168,10671,31.3372692343735%,67.1727110861213%,0.622829067641682,0.696993493381198,0.681887366818874,8752,8914,10512
3132,49,WISCONSIN,IOWA,5842,4221,10541,55.421686746988%,40.0436391234228%,6669,4809,12260,54.3964110929853%,39.2251223491028%,7828,5909,13992,55.9462550028588%,42.2312750142939%,0.419457418264931,0.418975431259801,0.43015214384509,10063,11478,13737
3133,49,WISCONSIN,IRON,1620,1734,3507,46.1933276304534%,49.4439692044482%,1273,2090,3497,36.4026308264226%,59.7655132971118%,1533,2438,4010,38.2294264339152%,60.7980049875312%,0.516994633273703,0.621468926553672,0.613951145807101,3354,3363,3971
3134,49,WISCONSIN,JACKSON,4380,3670,8417,52.0375430676013%,43.6022335749079%,3821,4907,9272,41.2100949094047%,52.9227782571182%,4256,5791,10184,41.7910447761194%,56.8637077769049%,0.455900621118012,0.562213565536205,0.576390962476361,8050,8728,10047
3135,49,WISCONSIN,JEFFERSON,15203,19204,36099,42.1147400204992%,53.1981495332281%,16561,23410,43146,38.3836276827516%,54.2576368608909%,19904,27208,47979,41.4848162737864%,56.7081431459597%,0.55814223849798,0.585674614095219,0.577517405331975,34407,39971,47112
3136,49,WISCONSIN,JUNEAU,4813,4910,10218,47.1031513016246%,48.052456449403%,4073,7123,11732,34.7170132969656%,60.7142857142857%,4746,8749,13709,34.6195929681231%,63.8193887227369%,0.504988172374781,0.636209360485888,0.648314190440904,9723,11196,13495
3137,49,WISCONSIN,KENOSHA,32429,28891,63709,50.9017564237392%,45.3483809194933%,35771,36025,77076,46.4100368467487%,46.7395817115574%,42193,44972,88738,47.5478374540783%,50.6795284996281%,0.471151337247228,0.501768900774416,0.515941031377273,61320,71796,87165
3138,49,WISCONSIN,KEWAUNEE,4670,4883,10084,46.3109877032924%,48.4232447441491%,3623,6616,10758,33.6772634318647%,61.4984197806284%,3976,7927,12095,32.8730880529144%,65.5394791236048%,0.511148330367424,0.646156851255005,0.665966563051332,9553,10239,11903
3139,49,WISCONSIN,LA CROSSE,28455,24327,55559,51.2158246188736%,43.785885275113%,32406,26389,62968,51.4642358023123%,41.9085884893914%,37846,28684,67884,55.7509869777856%,42.2544340345295%,0.460895759918154,0.448830682881197,0.431143844882008,52782,58795,66530
3140,49,WISCONSIN,LAFAYETTE,3710,3336,7263,51.0808205975492%,45.9314332920281%,3288,3977,7662,42.9130775254503%,51.9055077003393%,3647,4821,8555,42.6300409117475%,56.3530099357101%,0.473460119216577,0.54741913282863,0.569319792158715,7046,7265,8468
3141,49,WISCONSIN,LANGLADE,4199,5125,9721,43.1951445324555%,52.7209134862668%,3260,6436,10132,32.1752862218713%,63.5215159889459%,3704,7330,11165,33.1751007613077%,65.6515897895208%,0.5496567996568,0.663778877887789,0.664310313576219,9324,9696,11034
3142,49,WISCONSIN,LINCOLN,6664,6727,14239,46.8010393988342%,47.2434861998736%,5370,8400,14706,36.515707874337%,57.1195430436557%,6261,10017,16497,37.9523549736316%,60.7201309328969%,0.502352326189232,0.610021786492375,0.615370438628824,13391,13770,16278
3143,49,WISCONSIN,MANITOWOC,17667,19358,38824,45.5053575108181%,49.8609107768391%,14506,23193,40346,35.9539979180092%,57.4852525653101%,16818,27218,44829,37.5158937295055%,60.7151620602735%,0.522835921674544,0.615215257699143,0.618085203015714,37025,37699,44036
3144,49,WISCONSIN,MARATHON,26546,28883,58374,45.4757254942269%,49.4792202007743%,26477,39013,69515,38.0881824066748%,56.1217003524419%,30808,44624,76751,40.1401936131125%,58.1412620031009%,0.521081022569413,0.595709268590625,0.591579170643759,55429,65490,75432
3145,49,WISCONSIN,MARINETTE,8676,10535,19921,43.5520305205562%,52.8838913709151%,6243,12995,20046,31.1433702484286%,64.8259004290133%,7366,15304,22979,32.0553548892467%,66.5999390748074%,0.548383738483161,0.675486017257511,0.675077194530216,19211,19238,22670
3146,49,WISCONSIN,MARQUETTE,3437,3522,7194,47.775924381429%,48.9574645537948%,2809,4714,7893,35.5884961358165%,59.7238059039655%,3239,5719,9065,35.73083287369%,63.0888030888031%,0.506107199310246,0.626611724046258,0.638423755302523,6959,7523,8958
3147,49,WISCONSIN,MENOMINEE,949,225,1233,76.9667477696675%,18.2481751824818%,1003,269,1279,78.4206411258796%,21.0320562939797%,1303,278,1590,81.9496855345912%,17.4842767295598%,0.191652470187394,0.211477987421384,0.17583807716635,1174,1272,1581
3148,49,WISCONSIN,MILWAUKEE,252329,163491,433537,58.202414096144%,37.7109681526606%,288797,125846,440247,65.598857005272%,28.5853168789339%,317270,134357,458971,69.1263718186988%,29.2735270855893%,0.393177336347458,0.30350446046358,0.297495499604762,415820,414643,451627
3149,49,WISCONSIN,MONROE,7460,8217,16335,45.6688093051729%,50.3030303030303%,7048,11352,19670,35.8312150482969%,57.7122521606507%,8433,13775,22611,37.2960063685817%,60.9216752907877%,0.524143649933023,0.61695652173913,0.620271974063401,15677,18400,22208
3150,49,WISCONSIN,OCONTO,7260,8706,16596,43.7454808387563%,52.4584237165582%,5884,13253,19978,29.4523976374011%,66.3379717689458%,6715,16226,23215,28.9252638380358%,69.8944647856989%,0.545283727921834,0.692532789883472,0.707292620199643,15966,19137,22941
3151,49,WISCONSIN,ONEIDA,8339,9512,18891,44.1427134614367%,50.3520194801757%,8104,12117,21473,37.7404181995995%,56.4290038653192%,10105,13671,24159,41.8270623784097%,56.587607102943%,0.532855302223965,0.599228524800949,0.574991588156124,17851,20221,23776
3152,49,WISCONSIN,OUTAGAMIE,32735,39460,75742,43.2190858440495%,52.0979113305696%,38087,49884,93868,40.5750628542208%,53.1427110410364%,47667,58385,108022,44.1271222528744%,54.0491751680213%,0.546575247593324,0.567050505280149,0.550531814581526,72195,87971,106052
3153,49,WISCONSIN,OZAUKEE,15030,31155,47751,31.4757806119244%,65.2447069171326%,20168,30430,54523,36.9898941731013%,55.8113089888671%,26517,33912,61486,43.1268906742998%,55.1540188010279%,0.674569665475804,0.601407170243883,0.561187509308445,46185,50598,60429
3154,49,WISCONSIN,PEPIN,1854,1631,3664,50.6004366812227%,44.514192139738%,1345,2206,3739,35.9721850762236%,58.9997325488099%,1489,2584,4144,35.9314671814672%,62.3552123552124%,0.468005738880918,0.621233455364686,0.634421802111466,3485,3551,4073
3155,49,WISCONSIN,PIERCE,8559,8169,17962,47.6505957020376%,45.4793452844895%,8382,11258,21189,39.5582613620275%,53.1313417339185%,9796,12815,23317,42.0122657288673%,54.9599005017798%,0.488342898134864,0.573217922606925,0.56675954181593,16728,19640,22611
3156,49,WISCONSIN,POLK,8961,9557,19762,45.3446007489121%,48.3604898289647%,7570,13815,22749,33.2761879643061%,60.7279440854543%,9370,16611,26371,35.5314550073945%,62.9896477190854%,0.516092450588616,0.646013560907178,0.639351834032562,18518,21385,25981
3157,49,WISCONSIN,PORTAGE,17942,13214,33760,53.1457345971564%,39.1409952606635%,18521,17306,38496,48.1114921030756%,44.9553200332502%,20428,19299,40603,50.3115533334975%,47.5309706179346%,0.424123764282963,0.483043514667709,0.485790520301055,31156,35827,39727
3158,49,WISCONSIN,PRICE,3413,4136,7930,43.0390920554855%,52.156368221942%,2669,4562,7577,35.2250230962122%,60.2085258017685%,3032,5394,8546,35.4785864732038%,63.1172478352446%,0.547887137369188,0.630894758677915,0.64016140517446,7549,7231,8426
3159,49,WISCONSIN,RACINE,41563,44014,88865,46.7709446913858%,49.5290609351263%,42512,46611,94133,45.1616330086155%,49.5161101845262%,50159,54479,106451,47.1193318991837%,51.1775370827893%,0.5143204365659,0.52299630847256,0.5206425963799,85577,89123,104638
3160,49,WISCONSIN,RICHLAND,3837,3994,8293,46.2679368141806%,48.1610997226577%,3577,4023,8055,44.407200496586%,49.9441340782123%,3995,4871,9014,44.3199467495008%,54.0381628577768%,0.51002426254629,0.529342105263158,0.549402210692533,7831,7600,8866
3161,49,WISCONSIN,ROCK,40472,27467,70404,57.4853701494233%,39.0134083290722%,39343,31488,76068,51.720828732187%,41.3945417258243%,46658,37138,85360,54.6602624179944%,43.5074976569822%,0.404289141730081,0.444551114624952,0.44319537925438,67939,70831,83796
3162,49,WISCONSIN,RUSK,3161,3758,7366,42.9133858267717%,51.0181916915558%,2171,4564,7087,30.6335543953718%,64.3996049103993%,2517,5257,7886,31.9173218361654%,66.6624397666751%,0.543142072553837,0.677654046028211,0.676228453820427,6919,6735,7774
3163,49,WISCONSIN,SAUK,13035,11586,25653,50.8127704362063%,45.1643082680388%,14692,14791,31318,46.9123187943036%,47.228430934287%,18108,17493,36203,50.0179543131785%,48.3192000662929%,0.470573900328987,0.501678933622766,0.491362602174096,24621,29483,35601
3164,49,WISCONSIN,SAWYER,3333,3972,7767,42.9123213595983%,51.1394360757049%,3504,5185,9121,38.4168402587436%,56.8468369696305%,4498,5909,10510,42.7973358705994%,56.2226450999049%,0.543737166324435,0.596731499597192,0.567790909964447,7305,8689,10407
3165,49,WISCONSIN,SHAWANO,7335,9548,17603,41.6690336874396%,54.2407544168608%,6056,12742,19751,30.6617386461445%,64.5131892056098%,7131,15173,22615,31.5321689144373%,67.0926376298917%,0.565539299887461,0.677838067879562,0.68028156384505,16883,18798,22304
3166,49,WISCONSIN,SHEBOYGAN,23569,29648,55201,42.69669027735%,53.709171935291%,22956,32458,59655,38.4812672868997%,54.4095214148018%,27101,37609,66011,41.0552786656769%,56.9738376937177%,0.557115207546461,0.585736456491139,0.581193014989955,53217,55414,64710
3167,49,WISCONSIN,ST. CROIX,13077,15240,29954,43.6569406423182%,50.8780129531949%,17486,26220,47508,36.8064326008251%,55.190704723415%,23190,32199,56707,40.8944222053715%,56.7813497451814%,0.53819260514885,0.599917631446483,0.581324811785734,28317,43706,55389
3168,49,WISCONSIN,TAYLOR,3254,5278,8992,36.1877224199288%,58.6966192170818%,2398,6589,9484,25.2846900042176%,69.4749051033319%,2693,7657,10686,25.2011978289351%,71.654501216545%,0.618612283169245,0.733170134638923,0.739806763285024,8532,8987,10350
3169,49,WISCONSIN,TREMPEALEAU,6678,5002,12168,54.8816568047337%,41.1078238001315%,5636,7364,13675,41.2138939670932%,53.8500914076783%,6285,8833,15380,40.8647594278284%,57.4317295188557%,0.428253424657534,0.566461538461538,0.584270406138378,11680,13000,15118
3170,49,WISCONSIN,VERNON,6577,5684,13044,50.4216498006746%,43.5755903097209%,6352,6996,14213,44.6914796313234%,49.2225427425596%,7457,8218,15923,46.8316272059285%,51.6108773472336%,0.463583720740559,0.524123464189392,0.524274322169059,12261,13348,15675
3171,49,WISCONSIN,VILAS,4706,6958,12322,38.1918519720825%,56.4681058269761%,4770,8169,13612,35.0426094622392%,60.0132236262122%,5903,9261,15369,38.4084846118811%,60.2576615264494%,0.596536351165981,0.631347090192442,0.6107227644421,11664,12939,15164
3172,49,WISCONSIN,WALWORTH,15492,22982,40458,38.2915616194572%,56.8045874734292%,18706,28851,51324,36.4468864468864%,56.2134673836802%,22789,33851,57600,39.5642361111111%,58.7690972222222%,0.597338462338202,0.606661479908321,0.597651836158192,38474,47557,56640
3173,49,WISCONSIN,WASHBURN,3695,3912,8045,45.9291485394655%,48.6264760720945%,3284,5404,9148,35.8985570616528%,59.0730214254482%,3867,6334,10378,37.261514742725%,61.0329543264598%,0.514263178651242,0.622007366482505,0.620919517694344,7607,8688,10201
3174,49,WISCONSIN,WASHINGTON,18115,41162,61412,29.4974923467726%,67.0259884061747%,20855,51729,78003,26.7361511736728%,66.3166801276874%,26650,60237,88070,30.2600204382877%,68.3967298739639%,0.694400863741417,0.712677725118483,0.693279777181857,59277,72584,86887
3175,49,WISCONSIN,WAUKESHA,64319,133105,203734,31.5700864853191%,65.3327377855439%,79200,142521,239042,33.1322529095305%,59.6217401126162%,103906,159649,267996,38.7714742011075%,59.5714115136047%,0.674208809465921,0.642794322594612,0.605752120050843,197424,221721,263555
3176,49,WISCONSIN,WAUPACA,8787,12980,22804,38.5327135590247%,56.9198386248027%,8440,16189,26024,32.4316015985244%,62.2079618813403%,9703,18952,29130,33.3093031239272%,65.0600755235153%,0.596315523498874,0.657314547890698,0.66138544756587,21767,24629,28655
3177,49,WISCONSIN,WAUSHARA,4239,5571,10248,41.364168618267%,54.3618266978923%,3792,7669,11999,31.6026335527961%,63.9136594716226%,4388,9016,13568,32.3408018867925%,66.4504716981132%,0.567889908256881,0.669138818602216,0.672635034318114,9810,11461,13404
3178,49,WISCONSIN,WINNEBAGO,33983,38330,76080,44.6674553101998%,50.3811777076761%,37054,43448,87144,42.5204259616267%,49.8577067841733%,44060,47796,94032,46.856389314276%,50.829504849413%,0.530056836253509,0.539713299048471,0.520336178366138,72313,80502,91856
3179,49,WISCONSIN,WOOD,15936,17803,35761,44.5625122339979%,49.7832834652275%,14232,21503,37800,37.6507936507936%,56.8862433862434%,16365,24308,41298,39.6266163010315%,58.8599932200107%,0.527668277068081,0.601734993703652,0.597644629115138,33739,35735,40673
3181,50,WYOMING,ALBANY,5069,7814,14151,35.8207900501731%,55.2187124584835%,6890,7602,17060,40.3868698710434%,44.5603751465416%,9092,8579,18744,48.5061886470337%,45.7693128467776%,0.606535744779943,0.524565277394424,0.485484692433931,12883,14492,17671
3182,50,WYOMING,BIG HORN,1004,3720,4918,20.4148027653518%,75.6405042700285%,604,4067,5317,11.3597893548994%,76.4905021628738%,788,4806,5784,13.6237897648686%,83.091286307054%,0.787468247248095,0.870691500749304,0.859134787272077,4724,4671,5594
3183,50,WYOMING,CAMPBELL,1967,10203,12540,15.6858054226475%,81.3636363636364%,1324,15778,18199,7.27512500686851%,86.6970712676521%,1935,16975,19735,9.80491512541171%,86.0146947048391%,0.838373048479868,0.922582154134019,0.897673188789,12170,17102,18910
3184,50,WYOMING,CARBON,2206,4498,6968,31.6590126291619%,64.5522388059702%,1279,4409,6374,20.0658926890493%,69.1716347662378%,1427,5014,6706,21.2794512376976%,74.7688637041455%,0.670942720763723,0.77514064697609,0.778450551156653,6704,5688,6441
3185,50,WYOMING,CONVERSE,1076,3919,5175,20.792270531401%,75.7294685990338%,668,5520,6654,10.039074241058%,82.9576194770063%,861,5917,7010,12.2824536376605%,84.4079885877318%,0.784584584584585,0.892049127343245,0.872971377987607,4995,6188,6778
3186,50,WYOMING,CROOK,361,2289,2738,13.1848064280497%,83.6011687363039%,273,3348,3826,7.13538944066911%,87.5065342394145%,378,3651,4143,9.12382331643737%,88.124547429399%,0.86377358490566,0.924606462303231,0.906180193596426,2650,3621,4029
3187,50,WYOMING,FREMONT,4172,10560,15444,27.013727013727%,68.3760683760684%,4200,11167,17023,24.6725019091817%,65.5994830523409%,5519,12007,18234,30.2676318964572%,65.8495119008446%,0.716806950855281,0.726687056679898,0.685096428163871,14732,15367,17526
3188,50,WYOMING,GOSHEN,1439,3922,5520,26.0688405797101%,71.0507246376812%,924,4418,5796,15.9420289855072%,76.2249827467219%,1203,4878,6272,19.1804846938775%,77.7742346938776%,0.731579929117702,0.827031074503931,0.802170695609275,5361,5342,6081
3189,50,WYOMING,HOT SPRINGS,544,1733,2352,23.1292517006803%,73.6819727891156%,400,1939,2586,15.4679040989946%,74.9806651198763%,482,1999,2588,18.6244204018547%,77.241112828439%,0.7610891523935,0.828986746472852,0.805723498589278,2277,2339,2481
3190,50,WYOMING,JOHNSON,555,2886,3550,15.6338028169014%,81.2957746478873%,638,3477,4417,14.4441928911026%,78.718587276432%,897,3881,4952,18.1138933764136%,78.3723747980614%,0.838709677419355,0.844957472660996,0.812264545835077,3441,4115,4778
3191,50,WYOMING,LARAMIE,12162,21797,35323,34.4308241089375%,61.7076692240183%,11573,24847,40969,28.2481876540799%,60.6482950523567%,15217,27891,45237,33.6383933505759%,61.655282180516%,0.641862245649165,0.682235035694673,0.647002876496242,33959,36420,43108
3192,50,WYOMING,LINCOLN,1184,5415,6845,17.2972972972973%,79.108838568298%,1105,6779,8875,12.4507042253521%,76.3830985915493%,1509,8643,10525,14.3372921615202%,82.1187648456057%,0.82057887558721,0.859842719431761,0.851359338061466,6599,7884,10152
3193,50,WYOMING,NATRONA,8646,18439,28388,30.4565309285614%,64.9535014794984%,6577,23552,33348,19.7223221782416%,70.6249250329855%,8530,25271,35391,24.1021728688085%,71.4051595038287%,0.680782721063319,0.781705333731621,0.747640602349043,27085,30129,33801
3194,50,WYOMING,NIOBRARA,190,888,1127,16.8589174800355%,78.793256433008%,115,1116,1314,8.75190258751903%,84.9315068493151%,155,1118,1322,11.7246596066566%,84.5688350983358%,0.823747680890538,0.906580016246954,0.878240377062058,1078,1231,1273
3195,50,WYOMING,PARK,2424,9884,12836,18.8843876597071%,77.0021813649112%,2535,11115,15095,16.7936402782378%,73.6336535276582%,3410,12813,16815,20.2795123401725%,76.199821587868%,0.803054923626909,0.814285714285714,0.789804598409665,12308,13650,16223
3196,50,WYOMING,PLATTE,1249,2925,4373,28.561628172879%,66.8877201006174%,719,3437,4529,15.8754691984986%,75.8887171561051%,890,3898,4963,17.9327019947612%,78.5412049163812%,0.700766650694777,0.826997112608277,0.814118629908104,4174,4156,4788
3197,50,WYOMING,SHERIDAN,3330,8424,12236,27.2147760706113%,68.8460281137627%,2927,10266,14510,20.1722949689869%,70.7512060647829%,4043,11843,16546,24.4349087392723%,71.5762117732382%,0.716692189892803,0.778139922686273,0.745499181669394,11754,13193,15886
3198,50,WYOMING,SUBLETTE,458,2624,3216,14.2412935323383%,81.592039800995%,644,3409,4390,14.6697038724374%,77.6537585421412%,882,3957,5000,17.64%,79.14%,0.851395197923426,0.841105354058722,0.817730936143831,3082,4053,4839
3199,50,WYOMING,SWEETWATER,5521,9425,15691,35.1857752851953%,60.06628003314%,3231,12154,17130,18.861646234676%,70.9515469935785%,3823,12229,16698,22.8949574799377%,73.2363157264343%,0.630603505954771,0.789990250243744,0.761836531273362,14946,15385,16052
3200,50,WYOMING,TETON,4019,5454,10431,38.5293835682101%,52.2864538395168%,7314,3921,12627,57.9234972677596%,31.0525065336184%,9848,4341,14787,66.5990396970312%,29.3568675187665%,0.57574158133643,0.348998664886515,0.305941222073437,9473,11235,14189
3201,50,WYOMING,UINTA,1650,5469,7418,22.2431922351038%,73.7260717174441%,1202,6154,8470,14.1912632821724%,72.6564344746163%,1591,7496,9459,16.8199598266202%,79.2472777249181%,0.768225874420565,0.836595976073953,0.82491471332673,7119,7356,9087
3202,50,WYOMING,WASHAKIE,806,3138,4051,19.8963218958282%,77.4623549740805%,532,2911,3814,13.9486103828002%,76.3240692186681%,651,3245,4032,16.1458333333333%,80.4811507936508%,0.795638945233266,0.845483589892536,0.832905544147844,3944,3443,3896
3203,50,WYOMING,WESTON,449,2521,3060,14.6732026143791%,82.3856209150327%,299,3033,3526,8.47986386840613%,86.0181508791832%,360,3107,3560,10.1123595505618%,87.2752808988764%,0.848821548821549,0.910264105642257,0.896163830400923,2970,3332,3467
